dep;jour;n_dose1;n_complet;n_rappel;n_cum_dose1;n_cum_complet;n_cum_rappel;couv_dose1;couv_complet;couv_rappel
01;2020-12-27;0;0;0;0;0;0;0.0;0.0;0.0
01;2020-12-28;0;0;0;0;0;0;0.0;0.0;0.0
01;2020-12-29;0;0;0;0;0;0;0.0;0.0;0.0
01;2020-12-30;0;0;0;0;0;0;0.0;0.0;0.0
01;2020-12-31;0;0;0;0;0;0;0.0;0.0;0.0
01;2021-01-01;0;0;0;0;0;0;0.0;0.0;0.0
01;2021-01-02;0;0;0;0;0;0;0.0;0.0;0.0
01;2021-01-03;0;0;0;0;0;0;0.0;0.0;0.0
01;2021-01-04;0;0;0;0;0;0;0.0;0.0;0.0
01;2021-01-05;10;2;0;10;2;0;0.0;0.0;0.0
01;2021-01-06;21;0;0;31;2;0;0.0;0.0;0.0
01;2021-01-07;112;0;0;143;2;0;0.0;0.0;0.0
01;2021-01-08;234;1;0;377;3;0;0.1;0.0;0.0
01;2021-01-09;30;1;0;407;4;0;0.1;0.0;0.0
01;2021-01-10;0;0;0;407;4;0;0.1;0.0;0.0
01;2021-01-11;224;0;0;631;4;0;0.1;0.0;0.0
01;2021-01-12;408;1;0;1039;5;0;0.2;0.0;0.0
01;2021-01-13;534;1;0;1573;6;0;0.3;0.0;0.0
01;2021-01-14;637;6;0;2210;12;0;0.4;0.0;0.0
01;2021-01-15;536;5;0;2746;17;0;0.5;0.0;0.0
01;2021-01-16;222;0;0;2968;17;0;0.5;0.0;0.0
01;2021-01-17;127;0;0;3095;17;0;0.6;0.0;0.0
01;2021-01-18;529;5;0;3624;22;0;0.7;0.0;0.0
01;2021-01-19;1103;3;0;4727;25;0;0.9;0.0;0.0
01;2021-01-20;1348;5;0;6075;30;0;1.1;0.0;0.0
01;2021-01-21;1225;9;0;7300;39;0;1.3;0.0;0.0
01;2021-01-22;828;3;0;8128;42;0;1.5;0.0;0.0
01;2021-01-23;283;2;0;8411;44;0;1.5;0.0;0.0
01;2021-01-24;72;1;0;8483;45;0;1.5;0.0;0.0
01;2021-01-25;635;2;0;9118;47;0;1.6;0.0;0.0
01;2021-01-26;814;5;0;9932;52;0;1.8;0.0;0.0
01;2021-01-27;664;15;0;10596;67;0;1.9;0.0;0.0
01;2021-01-28;753;81;0;11349;148;0;2.0;0.0;0.0
01;2021-01-29;690;140;0;12039;288;0;2.2;0.1;0.0
01;2021-01-30;229;14;0;12268;302;0;2.2;0.1;0.0
01;2021-01-31;57;0;0;12325;302;0;2.2;0.1;0.0
01;2021-02-01;522;130;0;12847;432;0;2.3;0.1;0.0
01;2021-02-02;528;230;0;13375;662;0;2.4;0.1;0.0
01;2021-02-03;450;325;0;13825;987;0;2.5;0.2;0.0
01;2021-02-04;548;484;0;14373;1471;0;2.6;0.3;0.0
01;2021-02-05;472;337;0;14845;1808;0;2.7;0.3;0.0
01;2021-02-06;265;139;0;15110;1947;0;2.7;0.4;0.0
01;2021-02-07;6;103;0;15116;2050;0;2.7;0.4;0.0
01;2021-02-08;553;469;0;15669;2519;0;2.8;0.5;0.0
01;2021-02-09;810;907;0;16479;3426;0;3.0;0.6;0.0
01;2021-02-10;889;760;0;17368;4186;0;3.1;0.8;0.0
01;2021-02-11;852;881;0;18220;5067;0;3.3;0.9;0.0
01;2021-02-12;701;608;0;18921;5675;0;3.4;1.0;0.0
01;2021-02-13;201;175;0;19122;5850;0;3.4;1.1;0.0
01;2021-02-14;6;12;0;19128;5862;0;3.4;1.1;0.0
01;2021-02-15;447;534;0;19575;6396;0;3.5;1.2;0.0
01;2021-02-16;656;499;0;20231;6895;0;3.6;1.2;0.0
01;2021-02-17;534;390;0;20765;7285;0;3.7;1.3;0.0
01;2021-02-18;610;637;0;21375;7922;0;3.8;1.4;0.0
01;2021-02-19;601;331;0;21976;8253;0;4.0;1.5;0.0
01;2021-02-20;170;137;0;22146;8390;0;4.0;1.5;0.0
01;2021-02-21;2;0;0;22148;8390;0;4.0;1.5;0.0
01;2021-02-22;462;639;0;22610;9029;0;4.1;1.6;0.0
01;2021-02-23;484;667;0;23094;9696;0;4.2;1.7;0.0
01;2021-02-24;448;534;0;23542;10230;0;4.2;1.8;0.0
01;2021-02-25;838;690;0;24380;10920;0;4.4;2.0;0.0
01;2021-02-26;967;584;0;25347;11504;0;4.6;2.1;0.0
01;2021-02-27;449;111;0;25796;11615;0;4.6;2.1;0.0
01;2021-02-28;29;8;0;25825;11623;0;4.6;2.1;0.0
01;2021-03-01;651;504;0;26476;12127;0;4.8;2.2;0.0
01;2021-03-02;1065;590;0;27541;12717;0;5.0;2.3;0.0
01;2021-03-03;1071;669;0;28612;13386;0;5.1;2.4;0.0
01;2021-03-04;1380;664;0;29992;14050;0;5.4;2.5;0.0
01;2021-03-05;1518;549;0;31510;14599;0;5.7;2.6;0.0
01;2021-03-06;873;118;0;32383;14717;0;5.8;2.6;0.0
01;2021-03-07;97;3;0;32480;14720;0;5.8;2.6;0.0
01;2021-03-08;846;729;0;33326;15449;0;6.0;2.8;0.0
01;2021-03-09;1517;655;0;34843;16104;0;6.3;2.9;0.0
01;2021-03-10;1318;632;0;36161;16736;0;6.5;3.0;0.0
01;2021-03-11;1918;719;0;38079;17455;0;6.9;3.1;0.0
01;2021-03-12;2331;750;0;40410;18205;0;7.3;3.3;0.0
01;2021-03-13;1683;97;0;42093;18302;0;7.6;3.3;0.0
01;2021-03-14;280;59;0;42373;18361;0;7.6;3.3;0.0
01;2021-03-15;1278;473;0;43651;18834;0;7.9;3.4;0.0
01;2021-03-16;1224;557;0;44875;19391;0;8.1;3.5;0.0
01;2021-03-17;1110;361;0;45985;19752;0;8.3;3.6;0.0
01;2021-03-18;1491;551;0;47476;20303;0;8.5;3.7;0.0
01;2021-03-19;1890;582;0;49366;20885;0;8.9;3.8;0.0
01;2021-03-20;1448;109;0;50814;20994;0;9.1;3.8;0.0
01;2021-03-21;148;12;0;50962;21006;0;9.2;3.8;0.0
01;2021-03-22;1639;533;0;52601;21539;0;9.5;3.9;0.0
01;2021-03-23;2324;655;0;54925;22194;0;9.9;4.0;0.0
01;2021-03-24;1732;486;0;56657;22680;0;10.2;4.1;0.0
01;2021-03-25;3015;661;0;59672;23341;0;10.7;4.2;0.0
01;2021-03-26;3035;590;0;62707;23931;0;11.3;4.3;0.0
01;2021-03-27;1345;144;0;64052;24075;0;11.5;4.3;0.0
01;2021-03-28;79;9;0;64131;24084;0;11.5;4.3;0.0
01;2021-03-29;1932;648;0;66063;24732;0;11.9;4.4;0.0
01;2021-03-30;2539;830;0;68602;25562;0;12.3;4.6;0.0
01;2021-03-31;1970;808;0;70572;26370;0;12.7;4.7;0.0
01;2021-04-01;2718;944;0;73290;27314;0;13.2;4.9;0.0
01;2021-04-02;2920;835;0;76210;28149;0;13.7;5.1;0.0
01;2021-04-03;1356;215;0;77566;28364;0;14.0;5.1;0.0
01;2021-04-04;247;34;0;77813;28398;0;14.0;5.1;0.0
01;2021-04-05;1315;85;0;79128;28483;0;14.2;5.1;0.0
01;2021-04-06;2781;962;0;81909;29445;0;14.7;5.3;0.0
01;2021-04-07;2737;910;0;84646;30355;0;15.2;5.5;0.0
01;2021-04-08;3378;1203;0;88024;31558;0;15.8;5.7;0.0
01;2021-04-09;4031;1506;0;92055;33064;0;16.6;5.9;0.0
01;2021-04-10;1749;360;0;93804;33424;0;16.9;6.0;0.0
01;2021-04-11;156;109;0;93960;33533;0;16.9;6.0;0.0
01;2021-04-12;2728;1341;0;96688;34874;0;17.4;6.3;0.0
01;2021-04-13;2885;1548;0;99573;36422;0;17.9;6.6;0.0
01;2021-04-14;3035;1289;0;102608;37711;0;18.5;6.8;0.0
01;2021-04-15;3139;1551;0;105747;39262;0;19.0;7.1;0.0
01;2021-04-16;2980;1606;0;108727;40868;0;19.6;7.4;0.0
01;2021-04-17;1747;724;0;110474;41592;0;19.9;7.5;0.0
01;2021-04-18;166;61;0;110640;41653;0;19.9;7.5;0.0
01;2021-04-19;2240;1666;0;112880;43319;0;20.3;7.8;0.0
01;2021-04-20;2635;1668;0;115515;44987;0;20.8;8.1;0.0
01;2021-04-21;2724;1519;0;118239;46506;0;21.3;8.4;0.0
01;2021-04-22;2929;1768;0;121168;48274;0;21.8;8.7;0.0
01;2021-04-23;2859;1605;0;124027;49879;0;22.3;9.0;0.0
01;2021-04-24;1337;591;0;125364;50470;0;22.6;9.1;0.0
01;2021-04-25;142;30;0;125506;50500;0;22.6;9.1;0.0
01;2021-04-26;2113;1806;0;127619;52306;0;23.0;9.4;0.0
01;2021-04-27;2653;1656;0;130272;53962;0;23.4;9.7;0.0
01;2021-04-28;2643;1597;0;132915;55559;0;23.9;10.0;0.0
01;2021-04-29;2960;1884;0;135875;57443;0;24.4;10.3;0.0
01;2021-04-30;3278;2398;0;139153;59841;0;25.0;10.8;0.0
01;2021-05-01;1368;793;0;140521;60634;0;25.3;10.9;0.0
01;2021-05-02;673;297;0;141194;60931;0;25.4;11.0;0.0
01;2021-05-03;2572;2655;0;143766;63586;0;25.9;11.4;0.0
01;2021-05-04;2713;2813;0;146479;66399;0;26.4;11.9;0.0
01;2021-05-05;3080;2590;0;149559;68989;0;26.9;12.4;0.0
01;2021-05-06;3494;2734;0;153053;71723;0;27.5;12.9;0.0
01;2021-05-07;3629;2890;0;156682;74613;0;28.2;13.4;0.0
01;2021-05-08;1569;940;0;158251;75553;0;28.5;13.6;0.0
01;2021-05-09;1164;253;0;159415;75806;0;28.7;13.6;0.0
01;2021-05-10;2869;3073;0;162284;78879;0;29.2;14.2;0.0
01;2021-05-11;3992;3136;0;166276;82015;0;29.9;14.8;0.0
01;2021-05-12;4068;3121;0;170344;85136;0;30.6;15.3;0.0
01;2021-05-13;3540;1413;0;173884;86549;0;31.3;15.6;0.0
01;2021-05-14;4456;2403;0;178340;88952;0;32.1;16.0;0.0
01;2021-05-15;3040;1445;0;181380;90397;0;32.6;16.3;0.0
01;2021-05-16;1560;223;0;182940;90620;0;32.9;16.3;0.0
01;2021-05-17;3660;2589;0;186600;93209;0;33.6;16.8;0.0
01;2021-05-18;4286;2227;0;190886;95436;0;34.3;17.2;0.0
01;2021-05-19;4440;2069;0;195326;97505;0;35.1;17.5;0.0
01;2021-05-20;4563;2209;0;199889;99714;0;36.0;17.9;0.0
01;2021-05-21;4489;2379;0;204378;102093;0;36.8;18.4;0.0
01;2021-05-22;3198;1029;0;207576;103122;0;37.3;18.6;0.0
01;2021-05-23;1014;136;0;208590;103258;0;37.5;18.6;0.0
01;2021-05-24;2519;472;0;211109;103730;0;38.0;18.7;0.0
01;2021-05-25;3510;2565;0;214619;106295;0;38.6;19.1;0.0
01;2021-05-26;3619;2384;0;218238;108679;0;39.3;19.6;0.0
01;2021-05-27;3955;2334;0;222193;111013;0;40.0;20.0;0.0
01;2021-05-28;3726;2858;0;225919;113871;0;40.6;20.5;0.0
01;2021-05-29;2825;1525;0;228744;115396;0;41.2;20.8;0.0
01;2021-05-30;720;278;0;229464;115674;0;41.3;20.8;0.0
01;2021-05-31;2918;2564;0;232382;118238;0;41.8;21.3;0.0
01;2021-06-01;3307;2781;0;235689;121019;0;42.4;21.8;0.0
01;2021-06-02;3498;2369;0;239187;123388;0;43.0;22.2;0.0
01;2021-06-03;4089;2624;0;243276;126012;0;43.8;22.7;0.0
01;2021-06-04;4837;3578;0;248113;129590;0;44.6;23.3;0.0
01;2021-06-05;3435;1684;0;251548;131274;0;45.3;23.6;0.0
01;2021-06-06;1099;202;0;252647;131476;0;45.5;23.7;0.0
01;2021-06-07;3970;3071;0;256617;134547;0;46.2;24.2;0.0
01;2021-06-08;4461;3059;0;261078;137606;0;47.0;24.8;0.0
01;2021-06-09;3688;2679;0;264766;140285;0;47.6;25.2;0.0
01;2021-06-10;3647;2482;0;268413;142767;0;48.3;25.7;0.0
01;2021-06-11;4031;3708;0;272444;146475;0;49.0;26.4;0.0
01;2021-06-12;2812;2149;0;275256;148624;0;49.5;26.7;0.0
01;2021-06-13;543;615;0;275799;149239;0;49.6;26.9;0.0
01;2021-06-14;2667;3362;0;278466;152601;0;50.1;27.5;0.0
01;2021-06-15;2734;3646;0;281200;156247;0;50.6;28.1;0.0
01;2021-06-16;2941;3619;0;284141;159866;0;51.1;28.8;0.0
01;2021-06-17;2696;3674;0;286837;163540;0;51.6;29.4;0.0
01;2021-06-18;3285;4647;0;290122;168187;0;52.2;30.3;0.0
01;2021-06-19;2186;2645;0;292308;170832;0;52.6;30.7;0.0
01;2021-06-20;532;823;0;292840;171655;0;52.7;30.9;0.0
01;2021-06-21;2041;4050;0;294881;175705;0;53.1;31.6;0.0
01;2021-06-22;1876;4424;0;296757;180129;0;53.4;32.4;0.0
01;2021-06-23;1949;3996;0;298706;184125;0;53.7;33.1;0.0
01;2021-06-24;1891;4010;0;300597;188135;0;54.1;33.8;0.0
01;2021-06-25;2254;5055;0;302851;193190;0;54.5;34.8;0.0
01;2021-06-26;1339;3033;0;304190;196223;0;54.7;35.3;0.0
01;2021-06-27;357;853;0;304547;197076;0;54.8;35.5;0.0
01;2021-06-28;1540;4535;0;306087;201611;0;55.1;36.3;0.0
01;2021-06-29;1659;4427;0;307746;206038;0;55.4;37.1;0.0
01;2021-06-30;1712;4704;0;309458;210742;0;55.7;37.9;0.0
01;2021-07-01;1917;4457;0;311375;215199;0;56.0;38.7;0.0
01;2021-07-02;2087;5223;0;313462;220422;0;56.4;39.7;0.0
01;2021-07-03;1153;3444;0;314615;223866;0;56.6;40.3;0.0
01;2021-07-04;352;891;0;314967;224757;0;56.7;40.4;0.0
01;2021-07-05;1932;4474;0;316899;229231;0;57.0;41.2;0.0
01;2021-07-06;1553;4779;0;318452;234010;0;57.3;42.1;0.0
01;2021-07-07;2126;4056;0;320578;238066;0;57.7;42.8;0.0
01;2021-07-08;1916;4001;0;322494;242067;0;58.0;43.6;0.0
01;2021-07-09;2291;5020;0;324785;247087;0;58.4;44.5;0.0
01;2021-07-10;1306;3509;0;326091;250596;0;58.7;45.1;0.0
01;2021-07-11;406;752;0;326497;251348;0;58.7;45.2;0.0
01;2021-07-12;1792;4783;0;328289;256131;0;59.1;46.1;0.0
01;2021-07-13;2505;5169;0;330794;261300;0;59.5;47.0;0.0
01;2021-07-14;672;749;0;331466;262049;0;59.6;47.1;0.0
01;2021-07-15;3374;5243;0;334840;267292;0;60.2;48.1;0.0
01;2021-07-16;4201;5756;0;339041;273048;0;61.0;49.1;0.0
01;2021-07-17;2412;3531;0;341453;276579;0;61.4;49.8;0.0
01;2021-07-18;607;1118;0;342060;277697;0;61.5;50.0;0.0
01;2021-07-19;3125;4781;0;345185;282478;0;62.1;50.8;0.0
01;2021-07-20;3762;4767;0;348947;287245;0;62.8;51.7;0.0
01;2021-07-21;4281;4583;0;353228;291828;0;63.6;52.5;0.0
01;2021-07-22;4538;4331;0;357766;296159;0;64.4;53.3;0.0
01;2021-07-23;4461;5203;0;362227;301362;0;65.2;54.2;0.0
01;2021-07-24;2649;3186;0;364876;304548;0;65.6;54.8;0.0
01;2021-07-25;451;531;0;365327;305079;0;65.7;54.9;0.0
01;2021-07-26;3863;4019;0;369190;309098;0;66.4;55.6;0.0
01;2021-07-27;4619;3532;0;373809;312630;0;67.3;56.2;0.0
01;2021-07-28;4575;3392;0;378384;316022;0;68.1;56.9;0.0
01;2021-07-29;5173;3067;0;383557;319089;0;69.0;57.4;0.0
01;2021-07-30;5080;4062;0;388637;323151;0;69.9;58.1;0.0
01;2021-07-31;3597;2123;0;392234;325274;0;70.6;58.5;0.0
01;2021-08-01;821;408;0;393055;325682;0;70.7;58.6;0.0
01;2021-08-02;3666;3029;1;396721;328711;1;71.4;59.1;0.0
01;2021-08-03;3744;2880;0;400465;331591;1;72.1;59.7;0.0
01;2021-08-04;3433;2247;0;403898;333838;1;72.7;60.1;0.0
01;2021-08-05;2931;2792;0;406829;336630;1;73.2;60.6;0.0
01;2021-08-06;3287;3593;0;410116;340223;1;73.8;61.2;0.0
01;2021-08-07;1987;1879;0;412103;342102;1;74.1;61.6;0.0
01;2021-08-08;512;328;0;412615;342430;1;74.2;61.6;0.0
01;2021-08-09;1769;3158;0;414384;345588;1;74.6;62.2;0.0
01;2021-08-10;2055;2993;0;416439;348581;1;74.9;62.7;0.0
01;2021-08-11;1970;3028;0;418409;351609;1;75.3;63.3;0.0
01;2021-08-12;1961;3321;0;420370;354930;1;75.6;63.9;0.0
01;2021-08-13;2146;3389;0;422516;358319;1;76.0;64.5;0.0
01;2021-08-14;1453;2210;0;423969;360529;1;76.3;64.9;0.0
01;2021-08-15;98;259;0;424067;360788;1;76.3;64.9;0.0
01;2021-08-16;1296;3512;0;425363;364300;1;76.5;65.5;0.0
01;2021-08-17;1630;3172;0;426993;367472;1;76.8;66.1;0.0
01;2021-08-18;1384;3239;0;428377;370711;1;77.1;66.7;0.0
01;2021-08-19;1368;2835;0;429745;373546;1;77.3;67.2;0.0
01;2021-08-20;1604;4272;0;431349;377818;1;77.6;68.0;0.0
01;2021-08-21;847;2605;0;432196;380423;1;77.8;68.4;0.0
01;2021-08-22;90;125;0;432286;380548;1;77.8;68.5;0.0
01;2021-08-23;1180;3779;0;433466;384327;1;78.0;69.1;0.0
01;2021-08-24;1371;3850;0;434837;388177;1;78.2;69.8;0.0
01;2021-08-25;1222;3715;0;436059;391892;1;78.5;70.5;0.0
01;2021-08-26;1663;3303;0;437722;395195;1;78.8;71.1;0.0
01;2021-08-27;1634;4350;0;439356;399545;1;79.0;71.9;0.0
01;2021-08-28;926;2714;0;440282;402259;1;79.2;72.4;0.0
01;2021-08-29;75;484;0;440357;402743;1;79.2;72.5;0.0
01;2021-08-30;1241;3494;27;441598;406237;28;79.5;73.1;0.0
01;2021-08-31;1206;2694;71;442804;408931;99;79.7;73.6;0.0
01;2021-09-01;1213;2277;205;444017;411208;304;79.9;74.0;0.1
01;2021-09-02;981;1900;302;444998;413108;606;80.1;74.3;0.1
01;2021-09-03;1235;2716;255;446233;415824;861;80.3;74.8;0.2
01;2021-09-04;778;2184;88;447011;418008;949;80.4;75.2;0.2
01;2021-09-05;185;246;32;447196;418254;981;80.5;75.3;0.2
01;2021-09-06;675;1320;381;447871;419574;1362;80.6;75.5;0.2
01;2021-09-07;611;1265;255;448482;420839;1617;80.7;75.7;0.3
01;2021-09-08;863;1621;250;449345;422460;1867;80.8;76.0;0.3
01;2021-09-09;764;1217;225;450109;423677;2092;81.0;76.2;0.4
01;2021-09-10;1052;1794;363;451161;425471;2455;81.2;76.6;0.4
01;2021-09-11;686;1465;68;451847;426936;2523;81.3;76.8;0.5
01;2021-09-12;42;96;5;451889;427032;2528;81.3;76.8;0.5
01;2021-09-13;616;1174;357;452505;428206;2885;81.4;77.0;0.5
01;2021-09-14;615;1048;516;453120;429254;3401;81.5;77.2;0.6
01;2021-09-15;777;1530;458;453897;430784;3859;81.7;77.5;0.7
01;2021-09-16;564;987;480;454461;431771;4339;81.8;77.7;0.8
01;2021-09-17;727;1569;508;455188;433340;4847;81.9;78.0;0.9
01;2021-09-18;362;1219;56;455550;434559;4903;82.0;78.2;0.9
01;2021-09-19;47;104;16;455597;434663;4919;82.0;78.2;0.9
01;2021-09-20;363;716;503;455960;435379;5422;82.0;78.3;1.0
01;2021-09-21;408;808;692;456368;436187;6114;82.1;78.5;1.1
01;2021-09-22;366;1105;480;456734;437292;6594;82.2;78.7;1.2
01;2021-09-23;343;776;474;457077;438068;7068;82.2;78.8;1.3
01;2021-09-24;406;1076;410;457483;439144;7478;82.3;79.0;1.3
01;2021-09-25;277;967;82;457760;440111;7560;82.4;79.2;1.4
01;2021-09-26;19;115;3;457779;440226;7563;82.4;79.2;1.4
01;2021-09-27;195;603;201;457974;440829;7764;82.4;79.3;1.4
01;2021-09-28;318;1141;548;458292;441970;8312;82.5;79.5;1.5
01;2021-09-29;450;1329;457;458742;443299;8769;82.5;79.8;1.6
01;2021-09-30;374;809;446;459116;444108;9215;82.6;79.9;1.7
01;2021-10-01;546;1200;521;459662;445308;9736;82.7;80.1;1.8
01;2021-10-02;414;1239;178;460076;446547;9914;82.8;80.3;1.8
01;2021-10-03;27;62;13;460103;446609;9927;82.8;80.4;1.8
01;2021-10-04;229;565;380;460332;447174;10307;82.8;80.5;1.9
01;2021-10-05;245;546;538;460577;447720;10845;82.9;80.6;2.0
01;2021-10-06;402;802;498;460979;448522;11343;82.9;80.7;2.0
01;2021-10-07;236;514;506;461215;449036;11849;83.0;80.8;2.1
01;2021-10-08;390;776;585;461605;449812;12434;83.1;80.9;2.2
01;2021-10-09;343;676;269;461948;450488;12703;83.1;81.1;2.3
01;2021-10-10;12;28;2;461960;450516;12705;83.1;81.1;2.3
01;2021-10-11;208;478;541;462168;450994;13246;83.2;81.1;2.4
01;2021-10-12;202;390;538;462370;451384;13784;83.2;81.2;2.5
01;2021-10-13;368;589;819;462738;451973;14603;83.3;81.3;2.6
01;2021-10-14;191;578;508;462929;452551;15111;83.3;81.4;2.7
01;2021-10-15;385;561;765;463314;453112;15876;83.4;81.5;2.9
01;2021-10-16;293;446;318;463607;453558;16194;83.4;81.6;2.9
01;2021-10-17;10;30;1;463617;453588;16195;83.4;81.6;2.9
01;2021-10-18;171;264;662;463788;453852;16857;83.4;81.7;3.0
01;2021-10-19;129;301;633;463917;454153;17490;83.5;81.7;3.1
01;2021-10-20;231;474;932;464148;454627;18422;83.5;81.8;3.3
01;2021-10-21;104;376;623;464252;455003;19045;83.5;81.9;3.4
01;2021-10-22;161;540;766;464413;455543;19811;83.6;82.0;3.6
01;2021-10-23;112;463;375;464525;456006;20186;83.6;82.0;3.6
01;2021-10-24;5;7;8;464530;456013;20194;83.6;82.0;3.6
01;2021-10-25;146;242;781;464676;456255;20975;83.6;82.1;3.8
01;2021-10-26;96;186;640;464772;456441;21615;83.6;82.1;3.9
01;2021-10-27;190;393;906;464962;456834;22521;83.7;82.2;4.1
01;2021-10-28;95;173;598;465057;457007;23119;83.7;82.2;4.2
01;2021-10-29;144;315;897;465201;457322;24016;83.7;82.3;4.3
01;2021-10-30;100;346;470;465301;457668;24486;83.7;82.3;4.4
01;2021-10-31;3;11;12;465304;457679;24498;83.7;82.3;4.4
01;2021-11-01;10;11;7;465314;457690;24505;83.7;82.3;4.4
01;2021-11-02;68;184;636;465382;457874;25141;83.7;82.4;4.5
01;2021-11-03;166;391;1307;465548;458265;26448;83.8;82.5;4.8
01;2021-11-04;93;152;816;465641;458417;27264;83.8;82.5;4.9
01;2021-11-05;150;311;1125;465791;458728;28389;83.8;82.5;5.1
01;2021-11-06;89;297;684;465880;459025;29073;83.8;82.6;5.2
01;2021-11-07;1;14;8;465881;459039;29081;83.8;82.6;5.2
01;2021-11-08;99;228;1378;465980;459267;30459;83.8;82.6;5.5
01;2021-11-09;81;192;1294;466061;459459;31753;83.9;82.7;5.7
01;2021-11-10;190;303;1957;466251;459762;33710;83.9;82.7;6.1
01;2021-11-11;10;11;47;466261;459773;33757;83.9;82.7;6.1
01;2021-11-12;107;203;1528;466368;459976;35285;83.9;82.8;6.3
01;2021-11-13;139;162;1117;466507;460138;36402;83.9;82.8;6.5
01;2021-11-14;6;12;18;466513;460150;36420;83.9;82.8;6.6
01;2021-11-15;83;118;1674;466596;460268;38094;83.9;82.8;6.9
01;2021-11-16;89;158;1721;466685;460426;39815;84.0;82.8;7.2
01;2021-11-17;156;279;2384;466841;460705;42199;84.0;82.9;7.6
01;2021-11-18;93;140;1719;466934;460845;43918;84.0;82.9;7.9
01;2021-11-19;150;245;2258;467084;461090;46176;84.0;83.0;8.3
01;2021-11-20;159;152;1295;467243;461242;47471;84.1;83.0;8.5
01;2021-11-21;4;20;12;467247;461262;47483;84.1;83.0;8.5
01;2021-11-22;75;131;2140;467322;461393;49623;84.1;83.0;8.9
01;2021-11-23;111;113;2257;467433;461506;51880;84.1;83.0;9.3
01;2021-11-24;231;250;2819;467664;461756;54699;84.1;83.1;9.8
01;2021-11-25;98;120;2329;467762;461876;57028;84.2;83.1;10.3
01;2021-11-26;158;183;3632;467920;462059;60660;84.2;83.1;10.9
01;2021-11-27;168;190;2273;468088;462249;62933;84.2;83.2;11.3
01;2021-11-28;4;8;498;468092;462257;63431;84.2;83.2;11.4
01;2021-11-29;91;142;3979;468183;462399;67410;84.2;83.2;12.1
01;2021-11-30;87;117;3856;468270;462516;71266;84.3;83.2;12.8
01;2021-12-01;86;172;3420;468356;462688;74686;84.3;83.2;13.4
01;2021-12-02;88;109;4383;468444;462797;79069;84.3;83.3;14.2
01;2021-12-03;117;185;5636;468561;462982;84705;84.3;83.3;15.2
01;2021-12-04;85;176;3015;468646;463158;87720;84.3;83.3;15.8
01;2021-12-05;15;18;1044;468661;463176;88764;84.3;83.3;16.0
01;2021-12-06;88;131;5169;468749;463307;93933;84.3;83.4;16.9
01;2021-12-07;123;148;6677;468872;463455;100610;84.4;83.4;18.1
01;2021-12-08;103;209;5275;468975;463664;105885;84.4;83.4;19.1
01;2021-12-09;97;121;6111;469072;463785;111996;84.4;83.4;20.2
01;2021-12-10;134;196;7066;469206;463981;119062;84.4;83.5;21.4
01;2021-12-11;86;150;3747;469292;464131;122809;84.4;83.5;22.1
01;2021-12-12;15;19;1055;469307;464150;123864;84.4;83.5;22.3
01;2021-12-13;89;136;7035;469396;464286;130899;84.5;83.5;23.6
01;2021-12-14;132;191;8618;469528;464477;139517;84.5;83.6;25.1
01;2021-12-15;125;222;7601;469653;464699;147118;84.5;83.6;26.5
01;2021-12-16;114;145;8157;469767;464844;155275;84.5;83.6;27.9
01;2021-12-17;130;226;8563;469897;465070;163838;84.5;83.7;29.5
01;2021-12-18;130;185;4663;470027;465255;168501;84.6;83.7;30.3
01;2021-12-19;21;41;1690;470048;465296;170191;84.6;83.7;30.6
02;2020-12-27;1;0;0;1;0;0;0.0;0.0;0.0
02;2020-12-28;0;0;0;1;0;0;0.0;0.0;0.0
02;2020-12-29;0;0;0;1;0;0;0.0;0.0;0.0
02;2020-12-30;0;0;0;1;0;0;0.0;0.0;0.0
02;2020-12-31;0;0;0;1;0;0;0.0;0.0;0.0
02;2021-01-01;0;0;0;1;0;0;0.0;0.0;0.0
02;2021-01-02;0;0;0;1;0;0;0.0;0.0;0.0
02;2021-01-03;0;0;0;1;0;0;0.0;0.0;0.0
02;2021-01-04;1;0;0;2;0;0;0.0;0.0;0.0
02;2021-01-05;2;0;0;4;0;0;0.0;0.0;0.0
02;2021-01-06;25;0;0;29;0;0;0.0;0.0;0.0
02;2021-01-07;262;2;0;291;2;0;0.1;0.0;0.0
02;2021-01-08;502;2;0;793;4;0;0.2;0.0;0.0
02;2021-01-09;77;0;0;870;4;0;0.2;0.0;0.0
02;2021-01-10;52;0;0;922;4;0;0.2;0.0;0.0
02;2021-01-11;267;0;0;1189;4;0;0.3;0.0;0.0
02;2021-01-12;356;1;0;1545;5;0;0.3;0.0;0.0
02;2021-01-13;458;4;0;2003;9;0;0.4;0.0;0.0
02;2021-01-14;654;9;0;2657;18;0;0.6;0.0;0.0
02;2021-01-15;614;7;0;3271;25;0;0.7;0.0;0.0
02;2021-01-16;315;4;0;3586;29;0;0.8;0.0;0.0
02;2021-01-17;56;0;0;3642;29;0;0.8;0.0;0.0
02;2021-01-18;757;8;0;4399;37;0;1.0;0.0;0.0
02;2021-01-19;935;5;0;5334;42;0;1.2;0.0;0.0
02;2021-01-20;1320;7;0;6654;49;0;1.5;0.0;0.0
02;2021-01-21;2337;12;0;8991;61;0;2.0;0.0;0.0
02;2021-01-22;1375;6;0;10366;67;0;2.3;0.0;0.0
02;2021-01-23;296;3;0;10662;70;0;2.4;0.0;0.0
02;2021-01-24;61;1;0;10723;71;0;2.4;0.0;0.0
02;2021-01-25;430;13;0;11153;84;0;2.5;0.0;0.0
02;2021-01-26;648;18;0;11801;102;0;2.6;0.0;0.0
02;2021-01-27;188;4;0;11989;106;0;2.7;0.0;0.0
02;2021-01-28;112;229;0;12101;335;0;2.7;0.1;0.0
02;2021-01-29;142;416;0;12243;751;0;2.7;0.2;0.0
02;2021-01-30;13;16;0;12256;767;0;2.7;0.2;0.0
02;2021-01-31;1;10;0;12257;777;0;2.7;0.2;0.0
02;2021-02-01;18;208;0;12275;985;0;2.7;0.2;0.0
02;2021-02-02;71;307;0;12346;1292;0;2.7;0.3;0.0
02;2021-02-03;142;331;0;12488;1623;0;2.8;0.4;0.0
02;2021-02-04;255;363;0;12743;1986;0;2.8;0.4;0.0
02;2021-02-05;234;415;0;12977;2401;0;2.9;0.5;0.0
02;2021-02-06;65;162;0;13042;2563;0;2.9;0.6;0.0
02;2021-02-07;8;1;0;13050;2564;0;2.9;0.6;0.0
02;2021-02-08;297;428;0;13347;2992;0;3.0;0.7;0.0
02;2021-02-09;328;667;0;13675;3659;0;3.0;0.8;0.0
02;2021-02-10;464;992;0;14139;4651;0;3.1;1.0;0.0
02;2021-02-11;882;1671;0;15021;6322;0;3.3;1.4;0.0
02;2021-02-12;834;1007;0;15855;7329;0;3.5;1.6;0.0
02;2021-02-13;280;157;0;16135;7486;0;3.6;1.7;0.0
02;2021-02-14;1;3;0;16136;7489;0;3.6;1.7;0.0
02;2021-02-15;338;680;0;16474;8169;0;3.7;1.8;0.0
02;2021-02-16;423;551;0;16897;8720;0;3.8;1.9;0.0
02;2021-02-17;501;621;0;17398;9341;0;3.9;2.1;0.0
02;2021-02-18;521;452;0;17919;9793;0;4.0;2.2;0.0
02;2021-02-19;441;558;0;18360;10351;0;4.1;2.3;0.0
02;2021-02-20;365;226;0;18725;10577;0;4.2;2.4;0.0
02;2021-02-21;31;19;0;18756;10596;0;4.2;2.4;0.0
02;2021-02-22;368;335;0;19124;10931;0;4.3;2.4;0.0
02;2021-02-23;444;372;0;19568;11303;0;4.4;2.5;0.0
02;2021-02-24;608;175;0;20176;11478;0;4.5;2.6;0.0
02;2021-02-25;883;183;0;21059;11661;0;4.7;2.6;0.0
02;2021-02-26;835;113;0;21894;11774;0;4.9;2.6;0.0
02;2021-02-27;455;24;0;22349;11798;0;5.0;2.6;0.0
02;2021-02-28;49;1;0;22398;11799;0;5.0;2.6;0.0
02;2021-03-01;665;33;0;23063;11832;0;5.1;2.6;0.0
02;2021-03-02;999;162;0;24062;11994;0;5.4;2.7;0.0
02;2021-03-03;768;206;0;24830;12200;0;5.5;2.7;0.0
02;2021-03-04;1189;628;0;26019;12828;0;5.8;2.9;0.0
02;2021-03-05;1099;511;0;27118;13339;0;6.0;3.0;0.0
02;2021-03-06;2178;118;0;29296;13457;0;6.5;3.0;0.0
02;2021-03-07;1497;56;0;30793;13513;0;6.8;3.0;0.0
02;2021-03-08;610;363;0;31403;13876;0;7.0;3.1;0.0
02;2021-03-09;1015;418;0;32418;14294;0;7.2;3.2;0.0
02;2021-03-10;926;453;0;33344;14747;0;7.4;3.3;0.0
02;2021-03-11;1368;388;0;34712;15135;0;7.7;3.4;0.0
02;2021-03-12;1767;405;0;36479;15540;0;8.1;3.5;0.0
02;2021-03-13;2654;243;0;39133;15783;0;8.7;3.5;0.0
02;2021-03-14;1390;46;0;40523;15829;0;9.0;3.5;0.0
02;2021-03-15;636;407;0;41159;16236;0;9.2;3.6;0.0
02;2021-03-16;883;411;0;42042;16647;0;9.4;3.7;0.0
02;2021-03-17;789;466;0;42831;17113;0;9.5;3.8;0.0
02;2021-03-18;691;638;0;43522;17751;0;9.7;3.9;0.0
02;2021-03-19;1249;305;0;44771;18056;0;10.0;4.0;0.0
02;2021-03-20;2472;164;0;47243;18220;0;10.5;4.1;0.0
02;2021-03-21;1406;78;0;48649;18298;0;10.8;4.1;0.0
02;2021-03-22;801;483;0;49450;18781;0;11.0;4.2;0.0
02;2021-03-23;1270;557;0;50720;19338;0;11.3;4.3;0.0
02;2021-03-24;1674;516;0;52394;19854;0;11.7;4.4;0.0
02;2021-03-25;1836;607;0;54230;20461;0;12.1;4.6;0.0
02;2021-03-26;2508;501;0;56738;20962;0;12.6;4.7;0.0
02;2021-03-27;2525;158;0;59263;21120;0;13.2;4.7;0.0
02;2021-03-28;692;21;0;59955;21141;0;13.3;4.7;0.0
02;2021-03-29;1118;853;0;61073;21994;0;13.6;4.9;0.0
02;2021-03-30;1632;838;0;62705;22832;0;13.9;5.1;0.0
02;2021-03-31;1401;733;0;64106;23565;0;14.3;5.2;0.0
02;2021-04-01;1408;871;0;65514;24436;0;14.6;5.4;0.0
02;2021-04-02;1351;1212;0;66865;25648;0;14.9;5.7;0.0
02;2021-04-03;2644;869;0;69509;26517;0;15.5;5.9;0.0
02;2021-04-04;729;241;0;70238;26758;0;15.6;6.0;0.0
02;2021-04-05;1534;133;0;71772;26891;0;16.0;6.0;0.0
02;2021-04-06;1561;868;0;73333;27759;0;16.3;6.2;0.0
02;2021-04-07;1861;802;0;75194;28561;0;16.7;6.4;0.0
02;2021-04-08;1981;1143;0;77175;29704;0;17.2;6.6;0.0
02;2021-04-09;2573;1141;0;79748;30845;0;17.7;6.9;0.0
02;2021-04-10;2556;1213;0;82304;32058;0;18.3;7.1;0.0
02;2021-04-11;498;421;0;82802;32479;0;18.4;7.2;0.0
02;2021-04-12;1836;645;0;84638;33124;0;18.8;7.4;0.0
02;2021-04-13;1705;946;0;86343;34070;0;19.2;7.6;0.0
02;2021-04-14;2727;1005;0;89070;35075;0;19.8;7.8;0.0
02;2021-04-15;2740;869;0;91810;35944;0;20.4;8.0;0.0
02;2021-04-16;2590;1184;0;94400;37128;0;21.0;8.3;0.0
02;2021-04-17;1922;2130;0;96322;39258;0;21.4;8.7;0.0
02;2021-04-18;272;786;0;96594;40044;0;21.5;8.9;0.0
02;2021-04-19;1228;690;0;97822;40734;0;21.8;9.1;0.0
02;2021-04-20;1718;842;0;99540;41576;0;22.1;9.2;0.0
02;2021-04-21;1664;1094;0;101204;42670;0;22.5;9.5;0.0
02;2021-04-22;1883;841;0;103087;43511;0;22.9;9.7;0.0
02;2021-04-23;2075;1443;0;105162;44954;0;23.4;10.0;0.0
02;2021-04-24;1722;1677;0;106884;46631;0;23.8;10.4;0.0
02;2021-04-25;480;303;0;107364;46934;0;23.9;10.4;0.0
02;2021-04-26;1400;675;0;108764;47609;0;24.2;10.6;0.0
02;2021-04-27;1782;1176;0;110546;48785;0;24.6;10.9;0.0
02;2021-04-28;1785;1490;0;112331;50275;0;25.0;11.2;0.0
02;2021-04-29;2012;1271;0;114343;51546;0;25.4;11.5;0.0
02;2021-04-30;2840;1690;0;117183;53236;0;26.1;11.8;0.0
02;2021-05-01;2208;1245;0;119391;54481;0;26.6;12.1;0.0
02;2021-05-02;1926;548;0;121317;55029;0;27.0;12.2;0.0
02;2021-05-03;2362;1040;0;123679;56069;0;27.5;12.5;0.0
02;2021-05-04;1746;1393;0;125425;57462;0;27.9;12.8;0.0
02;2021-05-05;2629;1934;0;128054;59396;0;28.5;13.2;0.0
02;2021-05-06;2535;1924;0;130589;61320;0;29.0;13.6;0.0
02;2021-05-07;2674;2293;0;133263;63613;0;29.6;14.2;0.0
02;2021-05-08;2939;1068;0;136202;64681;0;30.3;14.4;0.0
02;2021-05-09;1907;445;0;138109;65126;0;30.7;14.5;0.0
02;2021-05-10;2537;1630;0;140646;66756;0;31.3;14.8;0.0
02;2021-05-11;3148;1664;0;143794;68420;0;32.0;15.2;0.0
02;2021-05-12;2939;1778;0;146733;70198;0;32.6;15.6;0.0
02;2021-05-13;3047;1013;0;149780;71211;0;33.3;15.8;0.0
02;2021-05-14;3690;1326;0;153470;72537;0;34.1;16.1;0.0
02;2021-05-15;4409;1205;0;157879;73742;0;35.1;16.4;0.0
02;2021-05-16;2861;222;0;160740;73964;0;35.8;16.5;0.0
02;2021-05-17;2416;774;0;163156;74738;0;36.3;16.6;0.0
02;2021-05-18;3032;1063;0;166188;75801;0;37.0;16.9;0.0
02;2021-05-19;3064;1111;0;169252;76912;0;37.6;17.1;0.0
02;2021-05-20;3672;1302;0;172924;78214;0;38.5;17.4;0.0
02;2021-05-21;3819;1167;0;176743;79381;0;39.3;17.7;0.0
02;2021-05-22;5287;1045;0;182030;80426;0;40.5;17.9;0.0
02;2021-05-23;2584;250;0;184614;80676;0;41.1;17.9;0.0
02;2021-05-24;3267;541;0;187881;81217;0;41.8;18.1;0.0
02;2021-05-25;2317;1278;0;190198;82495;0;42.3;18.4;0.0
02;2021-05-26;3107;1562;0;193305;84057;0;43.0;18.7;0.0
02;2021-05-27;3769;1580;0;197074;85637;0;43.8;19.0;0.0
02;2021-05-28;3631;1738;0;200705;87375;0;44.6;19.4;0.0
02;2021-05-29;3977;1642;0;204682;89017;0;45.5;19.8;0.0
02;2021-05-30;1368;201;0;206050;89218;0;45.8;19.8;0.0
02;2021-05-31;2573;1277;0;208623;90495;0;46.4;20.1;0.0
02;2021-06-01;3001;1913;0;211624;92408;0;47.1;20.6;0.0
02;2021-06-02;3292;1786;0;214916;94194;0;47.8;21.0;0.0
02;2021-06-03;3077;1953;0;217993;96147;0;48.5;21.4;0.0
02;2021-06-04;3356;2155;0;221349;98302;0;49.2;21.9;0.0
02;2021-06-05;3314;1855;0;224663;100157;0;50.0;22.3;0.0
02;2021-06-06;1585;278;0;226248;100435;0;50.3;22.3;0.0
02;2021-06-07;1827;1646;0;228075;102081;0;50.7;22.7;0.0
02;2021-06-08;2189;1972;0;230264;104053;0;51.2;23.1;0.0
02;2021-06-09;2238;1897;0;232502;105950;0;51.7;23.6;0.0
02;2021-06-10;2155;2080;0;234657;108030;0;52.2;24.0;0.0
02;2021-06-11;2300;3230;0;236957;111260;0;52.7;24.7;0.0
02;2021-06-12;2237;2809;0;239194;114069;0;53.2;25.4;0.0
02;2021-06-13;634;1455;0;239828;115524;0;53.3;25.7;0.0
02;2021-06-14;1117;2618;0;240945;118142;0;53.6;26.3;0.0
02;2021-06-15;1705;2697;0;242650;120839;0;54.0;26.9;0.0
02;2021-06-16;1595;2993;0;244245;123832;0;54.3;27.5;0.0
02;2021-06-17;1886;3161;0;246131;126993;0;54.7;28.2;0.0
02;2021-06-18;2319;3826;0;248450;130819;0;55.3;29.1;0.0
02;2021-06-19;1796;3908;0;250246;134727;0;55.7;30.0;0.0
02;2021-06-20;615;1559;0;250861;136286;0;55.8;30.3;0.0
02;2021-06-21;851;3348;0;251712;139634;0;56.0;31.1;0.0
02;2021-06-22;1235;3847;2;252947;143481;2;56.3;31.9;0.0
02;2021-06-23;1403;3731;0;254350;147212;2;56.6;32.7;0.0
02;2021-06-24;1414;3312;0;255764;150524;2;56.9;33.5;0.0
02;2021-06-25;1462;4863;0;257226;155387;2;57.2;34.6;0.0
02;2021-06-26;1322;4441;0;258548;159828;2;57.5;35.6;0.0
02;2021-06-27;563;2342;0;259111;162170;2;57.6;36.1;0.0
02;2021-06-28;902;3267;0;260013;165437;2;57.8;36.8;0.0
02;2021-06-29;1000;3235;0;261013;168672;2;58.1;37.5;0.0
02;2021-06-30;1447;3424;0;262460;172096;2;58.4;38.3;0.0
02;2021-07-01;1370;3768;0;263830;175864;2;58.7;39.1;0.0
02;2021-07-02;1426;5190;0;265256;181054;2;59.0;40.3;0.0
02;2021-07-03;1043;5793;0;266299;186847;2;59.2;41.6;0.0
02;2021-07-04;528;2300;0;266827;189147;2;59.4;42.1;0.0
02;2021-07-05;690;3992;0;267517;193139;2;59.5;43.0;0.0
02;2021-07-06;870;3352;1;268387;196491;3;59.7;43.7;0.0
02;2021-07-07;1405;3855;2;269792;200346;5;60.0;44.6;0.0
02;2021-07-08;1548;3951;0;271340;204297;5;60.4;45.4;0.0
02;2021-07-09;1411;4359;0;272751;208656;5;60.7;46.4;0.0
02;2021-07-10;1382;4484;0;274133;213140;5;61.0;47.4;0.0
02;2021-07-11;491;1865;0;274624;215005;5;61.1;47.8;0.0
02;2021-07-12;1446;3806;0;276070;218811;5;61.4;48.7;0.0
02;2021-07-13;2212;3851;0;278282;222662;5;61.9;49.5;0.0
02;2021-07-14;1527;1630;0;279809;224292;5;62.2;49.9;0.0
02;2021-07-15;2867;3799;0;282676;228091;5;62.9;50.7;0.0
02;2021-07-16;3294;4484;0;285970;232575;5;63.6;51.7;0.0
02;2021-07-17;3441;4272;0;289411;236847;5;64.4;52.7;0.0
02;2021-07-18;1716;1511;0;291127;238358;5;64.8;53.0;0.0
02;2021-07-19;3240;3134;0;294367;241492;5;65.5;53.7;0.0
02;2021-07-20;3545;3501;0;297912;244993;5;66.3;54.5;0.0
02;2021-07-21;3947;3123;0;301859;248116;5;67.1;55.2;0.0
02;2021-07-22;3541;2986;0;305400;251102;5;67.9;55.9;0.0
02;2021-07-23;3487;3693;0;308887;254795;5;68.7;56.7;0.0
02;2021-07-24;4234;3575;0;313121;258370;5;69.7;57.5;0.0
02;2021-07-25;1937;1004;0;315058;259374;5;70.1;57.7;0.0
02;2021-07-26;3777;2277;0;318835;261651;5;70.9;58.2;0.0
02;2021-07-27;3825;2330;0;322660;263981;5;71.8;58.7;0.0
02;2021-07-28;3523;2310;0;326183;266291;5;72.6;59.2;0.0
02;2021-07-29;2996;2342;0;329179;268633;5;73.2;59.8;0.0
02;2021-07-30;3541;2485;0;332720;271118;5;74.0;60.3;0.0
02;2021-07-31;4076;2333;0;336796;273451;5;74.9;60.8;0.0
02;2021-08-01;1443;668;0;338239;274119;5;75.2;61.0;0.0
02;2021-08-02;2321;1684;0;340560;275803;5;75.8;61.3;0.0
02;2021-08-03;2894;2044;0;343454;277847;5;76.4;61.8;0.0
02;2021-08-04;2961;1833;0;346415;279680;5;77.1;62.2;0.0
02;2021-08-05;2227;2397;0;348642;282077;5;77.6;62.7;0.0
02;2021-08-06;2393;2828;0;351035;284905;5;78.1;63.4;0.0
02;2021-08-07;2730;2800;0;353765;287705;5;78.7;64.0;0.0
02;2021-08-08;1010;1346;0;354775;289051;5;78.9;64.3;0.0
02;2021-08-09;1948;2696;0;356723;291747;5;79.3;64.9;0.0
02;2021-08-10;1974;2652;0;358697;294399;5;79.8;65.5;0.0
02;2021-08-11;1760;2253;0;360457;296652;5;80.2;66.0;0.0
02;2021-08-12;1390;2400;0;361847;299052;5;80.5;66.5;0.0
02;2021-08-13;1738;2949;0;363585;302001;5;80.9;67.2;0.0
02;2021-08-14;1802;3619;0;365387;305620;5;81.3;68.0;0.0
02;2021-08-15;207;572;0;365594;306192;5;81.3;68.1;0.0
02;2021-08-16;1334;3709;0;366928;309901;5;81.6;68.9;0.0
02;2021-08-17;1496;2989;0;368424;312890;5;82.0;69.6;0.0
02;2021-08-18;1611;3209;0;370035;316099;5;82.3;70.3;0.0
02;2021-08-19;1201;3339;0;371236;319438;5;82.6;71.1;0.0
02;2021-08-20;1264;3142;0;372500;322580;5;82.9;71.8;0.0
02;2021-08-21;1494;4030;0;373994;326610;5;83.2;72.7;0.0
02;2021-08-22;401;1550;0;374395;328160;5;83.3;73.0;0.0
02;2021-08-23;1124;3162;0;375519;331322;5;83.5;73.7;0.0
02;2021-08-24;963;2495;0;376482;333817;5;83.7;74.3;0.0
02;2021-08-25;1074;2835;0;377556;336652;5;84.0;74.9;0.0
02;2021-08-26;957;2617;0;378513;339269;5;84.2;75.5;0.0
02;2021-08-27;1016;2826;0;379529;342095;5;84.4;76.1;0.0
02;2021-08-28;1271;3586;0;380800;345681;5;84.7;76.9;0.0
02;2021-08-29;318;1172;0;381118;346853;5;84.8;77.2;0.0
02;2021-08-30;950;2640;44;382068;349493;49;85.0;77.7;0.0
02;2021-08-31;875;2297;97;382943;351790;146;85.2;78.3;0.0
02;2021-09-01;740;1661;146;383683;353451;292;85.3;78.6;0.1
02;2021-09-02;673;1721;171;384356;355172;463;85.5;79.0;0.1
02;2021-09-03;679;1891;193;385035;357063;656;85.6;79.4;0.1
02;2021-09-04;872;2973;90;385907;360036;746;85.8;80.1;0.2
02;2021-09-05;229;456;72;386136;360492;818;85.9;80.2;0.2
02;2021-09-06;447;997;157;386583;361489;975;86.0;80.4;0.2
02;2021-09-07;453;1301;218;387036;362790;1193;86.1;80.7;0.3
02;2021-09-08;518;1776;160;387554;364566;1353;86.2;81.1;0.3
02;2021-09-09;434;1230;165;387988;365796;1518;86.3;81.4;0.3
02;2021-09-10;575;1415;212;388563;367211;1730;86.4;81.7;0.4
02;2021-09-11;746;2225;176;389309;369436;1906;86.6;82.2;0.4
02;2021-09-12;98;288;18;389407;369724;1924;86.6;82.2;0.4
02;2021-09-13;439;970;280;389846;370694;2204;86.7;82.5;0.5
02;2021-09-14;440;889;356;390286;371583;2560;86.8;82.7;0.6
02;2021-09-15;444;1360;572;390730;372943;3132;86.9;83.0;0.7
02;2021-09-16;445;844;412;391175;373787;3544;87.0;83.1;0.8
02;2021-09-17;578;979;463;391753;374766;4007;87.1;83.4;0.9
02;2021-09-18;550;2034;229;392303;376800;4236;87.3;83.8;0.9
02;2021-09-19;76;241;27;392379;377041;4263;87.3;83.9;0.9
02;2021-09-20;293;635;484;392672;377676;4747;87.3;84.0;1.1
02;2021-09-21;277;638;504;392949;378314;5251;87.4;84.2;1.2
02;2021-09-22;351;938;533;393300;379252;5784;87.5;84.4;1.3
02;2021-09-23;263;577;522;393563;379829;6306;87.5;84.5;1.4
02;2021-09-24;282;730;383;393845;380559;6689;87.6;84.7;1.5
02;2021-09-25;313;1204;301;394158;381763;6990;87.7;84.9;1.6
02;2021-09-26;38;159;13;394196;381922;7003;87.7;85.0;1.6
02;2021-09-27;169;393;420;394365;382315;7423;87.7;85.0;1.7
02;2021-09-28;165;386;455;394530;382701;7878;87.8;85.1;1.8
02;2021-09-29;227;460;529;394757;383161;8407;87.8;85.2;1.9
02;2021-09-30;232;473;458;394989;383634;8865;87.9;85.3;2.0
02;2021-10-01;354;671;507;395343;384305;9372;87.9;85.5;2.1
02;2021-10-02;392;875;323;395735;385180;9695;88.0;85.7;2.2
02;2021-10-03;33;69;23;395768;385249;9718;88.0;85.7;2.2
02;2021-10-04;157;386;529;395925;385635;10247;88.1;85.8;2.3
02;2021-10-05;176;332;402;396101;385967;10649;88.1;85.9;2.4
02;2021-10-06;253;437;532;396354;386404;11181;88.2;86.0;2.5
02;2021-10-07;219;431;588;396573;386835;11769;88.2;86.0;2.6
02;2021-10-08;309;595;691;396882;387430;12460;88.3;86.2;2.8
02;2021-10-09;313;700;498;397195;388130;12958;88.4;86.3;2.9
02;2021-10-10;31;67;23;397226;388197;12981;88.4;86.4;2.9
02;2021-10-11;177;324;414;397403;388521;13395;88.4;86.4;3.0
02;2021-10-12;140;295;509;397543;388816;13904;88.4;86.5;3.1
02;2021-10-13;237;401;662;397780;389217;14566;88.5;86.6;3.2
02;2021-10-14;210;319;566;397990;389536;15132;88.5;86.6;3.4
02;2021-10-15;282;430;763;398272;389966;15895;88.6;86.7;3.5
02;2021-10-16;307;409;495;398579;390375;16390;88.7;86.8;3.6
02;2021-10-17;15;31;10;398594;390406;16400;88.7;86.8;3.6
02;2021-10-18;158;241;566;398752;390647;16966;88.7;86.9;3.8
02;2021-10-19;121;227;419;398873;390874;17385;88.7;86.9;3.9
02;2021-10-20;259;293;886;399132;391167;18271;88.8;87.0;4.1
02;2021-10-21;151;248;611;399283;391415;18882;88.8;87.1;4.2
02;2021-10-22;293;414;988;399576;391829;19870;88.9;87.2;4.4
02;2021-10-23;226;382;446;399802;392211;20316;88.9;87.2;4.5
02;2021-10-24;6;8;11;399808;392219;20327;88.9;87.2;4.5
02;2021-10-25;147;216;721;399955;392435;21048;89.0;87.3;4.7
02;2021-10-26;80;150;600;400035;392585;21648;89.0;87.3;4.8
02;2021-10-27;168;251;839;400203;392836;22487;89.0;87.4;5.0
02;2021-10-28;159;207;719;400362;393043;23206;89.1;87.4;5.2
02;2021-10-29;270;376;1080;400632;393419;24286;89.1;87.5;5.4
02;2021-10-30;140;288;483;400772;393707;24769;89.1;87.6;5.5
02;2021-10-31;11;15;33;400783;393722;24802;89.2;87.6;5.5
02;2021-11-01;14;13;9;400797;393735;24811;89.2;87.6;5.5
02;2021-11-02;133;194;697;400930;393929;25508;89.2;87.6;5.7
02;2021-11-03;218;285;1043;401148;394214;26551;89.2;87.7;5.9
02;2021-11-04;140;231;746;401288;394445;27297;89.3;87.7;6.1
02;2021-11-05;203;318;1227;401491;394763;28524;89.3;87.8;6.3
02;2021-11-06;151;237;496;401642;395000;29020;89.3;87.9;6.5
02;2021-11-07;23;28;101;401665;395028;29121;89.3;87.9;6.5
02;2021-11-08;102;140;839;401767;395168;29960;89.4;87.9;6.7
02;2021-11-09;114;162;1147;401881;395330;31107;89.4;87.9;6.9
02;2021-11-10;175;281;1458;402056;395611;32565;89.4;88.0;7.2
02;2021-11-11;8;20;72;402064;395631;32637;89.4;88.0;7.3
02;2021-11-12;220;320;1539;402284;395951;34176;89.5;88.1;7.6
02;2021-11-13;174;271;1038;402458;396222;35214;89.5;88.1;7.8
02;2021-11-14;9;9;87;402467;396231;35301;89.5;88.1;7.9
02;2021-11-15;96;138;1174;402563;396369;36475;89.5;88.2;8.1
02;2021-11-16;118;120;1278;402681;396489;37753;89.6;88.2;8.4
02;2021-11-17;219;234;1617;402900;396723;39370;89.6;88.2;8.8
02;2021-11-18;144;201;1840;403044;396924;41210;89.7;88.3;9.2
02;2021-11-19;242;268;1978;403286;397192;43188;89.7;88.4;9.6
02;2021-11-20;175;192;923;403461;397384;44111;89.7;88.4;9.8
02;2021-11-21;7;10;69;403468;397394;44180;89.7;88.4;9.8
02;2021-11-22;164;103;1412;403632;397497;45592;89.8;88.4;10.1
02;2021-11-23;136;114;1279;403768;397611;46871;89.8;88.4;10.4
02;2021-11-24;184;218;1663;403952;397829;48534;89.9;88.5;10.8
02;2021-11-25;171;157;1852;404123;397986;50386;89.9;88.5;11.2
02;2021-11-26;241;239;3318;404364;398225;53704;89.9;88.6;11.9
02;2021-11-27;231;179;2504;404595;398404;56208;90.0;88.6;12.5
02;2021-11-28;40;24;1597;404635;398428;57805;90.0;88.6;12.9
02;2021-11-29;102;110;2650;404737;398538;60455;90.0;88.7;13.4
02;2021-11-30;140;144;3558;404877;398682;64013;90.1;88.7;14.2
02;2021-12-01;149;184;3731;405026;398866;67744;90.1;88.7;15.1
02;2021-12-02;135;80;4163;405161;398946;71907;90.1;88.7;16.0
02;2021-12-03;171;207;5215;405332;399153;77122;90.2;88.8;17.2
02;2021-12-04;134;172;4323;405466;399325;81445;90.2;88.8;18.1
02;2021-12-05;21;20;1097;405487;399345;82542;90.2;88.8;18.4
02;2021-12-06;113;119;3773;405600;399464;86315;90.2;88.9;19.2
02;2021-12-07;132;127;4583;405732;399591;90898;90.3;88.9;20.2
02;2021-12-08;138;164;5293;405870;399755;96191;90.3;88.9;21.4
02;2021-12-09;147;189;4986;406017;399944;101177;90.3;89.0;22.5
02;2021-12-10;183;245;6025;406200;400189;107202;90.4;89.0;23.8
02;2021-12-11;147;202;4968;406347;400391;112170;90.4;89.1;25.0
02;2021-12-12;58;20;1703;406405;400411;113873;90.4;89.1;25.3
02;2021-12-13;111;139;4773;406516;400550;118646;90.4;89.1;26.4
02;2021-12-14;139;167;5480;406655;400717;124126;90.5;89.1;27.6
02;2021-12-15;121;207;5221;406776;400924;129347;90.5;89.2;28.8
02;2021-12-16;162;215;6169;406938;401139;135516;90.5;89.2;30.1
02;2021-12-17;165;258;7067;407103;401397;142583;90.6;89.3;31.7
02;2021-12-18;180;230;4992;407283;401627;147575;90.6;89.3;32.8
02;2021-12-19;77;29;1842;407360;401656;149417;90.6;89.3;33.2
03;2020-12-27;0;0;0;0;0;0;0.0;0.0;0.0
03;2020-12-28;1;0;0;1;0;0;0.0;0.0;0.0
03;2020-12-29;0;0;0;1;0;0;0.0;0.0;0.0
03;2020-12-30;1;0;0;2;0;0;0.0;0.0;0.0
03;2020-12-31;0;0;0;2;0;0;0.0;0.0;0.0
03;2021-01-01;0;0;0;2;0;0;0.0;0.0;0.0
03;2021-01-02;0;0;0;2;0;0;0.0;0.0;0.0
03;2021-01-03;0;0;0;2;0;0;0.0;0.0;0.0
03;2021-01-04;0;0;0;2;0;0;0.0;0.0;0.0
03;2021-01-05;1;0;0;3;0;0;0.0;0.0;0.0
03;2021-01-06;12;0;0;15;0;0;0.0;0.0;0.0
03;2021-01-07;73;0;0;88;0;0;0.0;0.0;0.0
03;2021-01-08;141;1;0;229;1;0;0.1;0.0;0.0
03;2021-01-09;113;0;0;342;1;0;0.1;0.0;0.0
03;2021-01-10;4;0;0;346;1;0;0.1;0.0;0.0
03;2021-01-11;411;1;0;757;2;0;0.3;0.0;0.0
03;2021-01-12;607;1;0;1364;3;0;0.5;0.0;0.0
03;2021-01-13;743;2;0;2107;5;0;0.7;0.0;0.0
03;2021-01-14;837;5;0;2944;10;0;1.0;0.0;0.0
03;2021-01-15;374;3;0;3318;13;0;1.1;0.0;0.0
03;2021-01-16;260;0;0;3578;13;0;1.2;0.0;0.0
03;2021-01-17;37;0;0;3615;13;0;1.2;0.0;0.0
03;2021-01-18;874;1;0;4489;14;0;1.5;0.0;0.0
03;2021-01-19;1190;2;0;5679;16;0;1.9;0.0;0.0
03;2021-01-20;1327;3;0;7006;19;0;2.4;0.0;0.0
03;2021-01-21;1202;3;0;8208;22;0;2.8;0.0;0.0
03;2021-01-22;1108;5;0;9316;27;0;3.2;0.0;0.0
03;2021-01-23;449;1;0;9765;28;0;3.3;0.0;0.0
03;2021-01-24;1;0;0;9766;28;0;3.3;0.0;0.0
03;2021-01-25;214;0;0;9980;28;0;3.4;0.0;0.0
03;2021-01-26;739;14;0;10719;42;0;3.7;0.0;0.0
03;2021-01-27;703;10;0;11422;52;0;3.9;0.0;0.0
03;2021-01-28;1014;56;0;12436;108;0;4.2;0.0;0.0
03;2021-01-29;823;78;0;13259;186;0;4.5;0.1;0.0
03;2021-01-30;556;6;0;13815;192;0;4.7;0.1;0.0
03;2021-01-31;0;1;0;13815;193;0;4.7;0.1;0.0
03;2021-02-01;176;82;0;13991;275;0;4.8;0.1;0.0
03;2021-02-02;731;263;0;14722;538;0;5.0;0.2;0.0
03;2021-02-03;972;455;0;15694;993;0;5.3;0.3;0.0
03;2021-02-04;1514;647;0;17208;1640;0;5.9;0.6;0.0
03;2021-02-05;884;307;0;18092;1947;0;6.2;0.7;0.0
03;2021-02-06;146;15;0;18238;1962;0;6.2;0.7;0.0
03;2021-02-07;2;0;0;18240;1962;0;6.2;0.7;0.0
03;2021-02-08;145;63;0;18385;2025;0;6.3;0.7;0.0
03;2021-02-09;587;431;0;18972;2456;0;6.5;0.8;0.0
03;2021-02-10;490;416;0;19462;2872;0;6.6;1.0;0.0
03;2021-02-11;934;529;0;20396;3401;0;7.0;1.2;0.0
03;2021-02-12;1042;565;0;21438;3966;0;7.3;1.4;0.0
03;2021-02-13;125;160;0;21563;4126;0;7.4;1.4;0.0
03;2021-02-14;4;4;0;21567;4130;0;7.4;1.4;0.0
03;2021-02-15;301;856;0;21868;4986;0;7.5;1.7;0.0
03;2021-02-16;546;1132;0;22414;6118;0;7.6;2.1;0.0
03;2021-02-17;431;1305;0;22845;7423;0;7.8;2.5;0.0
03;2021-02-18;344;1240;0;23189;8663;0;7.9;3.0;0.0
03;2021-02-19;492;767;0;23681;9430;0;8.1;3.2;0.0
03;2021-02-20;115;181;0;23796;9611;0;8.1;3.3;0.0
03;2021-02-21;2;1;0;23798;9612;0;8.1;3.3;0.0
03;2021-02-22;170;210;0;23968;9822;0;8.2;3.3;0.0
03;2021-02-23;657;836;0;24625;10658;0;8.4;3.6;0.0
03;2021-02-24;582;974;0;25207;11632;0;8.6;4.0;0.0
03;2021-02-25;1046;1758;0;26253;13390;0;8.9;4.6;0.0
03;2021-02-26;780;1292;0;27033;14682;0;9.2;5.0;0.0
03;2021-02-27;97;247;0;27130;14929;0;9.2;5.1;0.0
03;2021-02-28;1;16;0;27131;14945;0;9.2;5.1;0.0
03;2021-03-01;186;243;0;27317;15188;0;9.3;5.2;0.0
03;2021-03-02;784;663;0;28101;15851;0;9.6;5.4;0.0
03;2021-03-03;859;454;0;28960;16305;0;9.9;5.6;0.0
03;2021-03-04;1490;583;0;30450;16888;0;10.4;5.8;0.0
03;2021-03-05;1064;714;0;31514;17602;0;10.7;6.0;0.0
03;2021-03-06;895;117;0;32409;17719;0;11.0;6.0;0.0
03;2021-03-07;14;2;0;32423;17721;0;11.1;6.0;0.0
03;2021-03-08;249;249;0;32672;17970;0;11.1;6.1;0.0
03;2021-03-09;942;448;0;33614;18418;0;11.5;6.3;0.0
03;2021-03-10;924;541;0;34538;18959;0;11.8;6.5;0.0
03;2021-03-11;1615;666;0;36153;19625;0;12.3;6.7;0.0
03;2021-03-12;1256;841;0;37409;20466;0;12.8;7.0;0.0
03;2021-03-13;859;112;0;38268;20578;0;13.0;7.0;0.0
03;2021-03-14;12;7;0;38280;20585;0;13.0;7.0;0.0
03;2021-03-15;301;205;0;38581;20790;0;13.2;7.1;0.0
03;2021-03-16;647;405;0;39228;21195;0;13.4;7.2;0.0
03;2021-03-17;1278;420;0;40506;21615;0;13.8;7.4;0.0
03;2021-03-18;1680;405;0;42186;22020;0;14.4;7.5;0.0
03;2021-03-19;1657;347;0;43843;22367;0;14.9;7.6;0.0
03;2021-03-20;303;29;0;44146;22396;0;15.0;7.6;0.0
03;2021-03-21;4;0;0;44150;22396;0;15.0;7.6;0.0
03;2021-03-22;258;392;0;44408;22788;0;15.1;7.8;0.0
03;2021-03-23;1308;361;0;45716;23149;0;15.6;7.9;0.0
03;2021-03-24;1809;337;0;47525;23486;0;16.2;8.0;0.0
03;2021-03-25;2320;545;0;49845;24031;0;17.0;8.2;0.0
03;2021-03-26;2267;437;0;52112;24468;0;17.8;8.3;0.0
03;2021-03-27;818;28;0;52930;24496;0;18.0;8.4;0.0
03;2021-03-28;14;35;0;52944;24531;0;18.0;8.4;0.0
03;2021-03-29;677;176;0;53621;24707;0;18.3;8.4;0.0
03;2021-03-30;1897;452;0;55518;25159;0;18.9;8.6;0.0
03;2021-03-31;1052;925;0;56570;26084;0;19.3;8.9;0.0
03;2021-04-01;1413;1094;0;57983;27178;0;19.8;9.3;0.0
03;2021-04-02;1711;629;0;59694;27807;0;20.3;9.5;0.0
03;2021-04-03;375;109;0;60069;27916;0;20.5;9.5;0.0
03;2021-04-04;32;0;0;60101;27916;0;20.5;9.5;0.0
03;2021-04-05;40;15;0;60141;27931;0;20.5;9.5;0.0
03;2021-04-06;1123;431;0;61264;28362;0;20.9;9.7;0.0
03;2021-04-07;1571;532;0;62835;28894;0;21.4;9.8;0.0
03;2021-04-08;2130;541;0;64965;29435;0;22.1;10.0;0.0
03;2021-04-09;2047;1105;0;67012;30540;0;22.8;10.4;0.0
03;2021-04-10;952;87;0;67964;30627;0;23.2;10.4;0.0
03;2021-04-11;364;11;0;68328;30638;0;23.3;10.4;0.0
03;2021-04-12;1013;253;0;69341;30891;0;23.6;10.5;0.0
03;2021-04-13;1832;963;0;71173;31854;0;24.3;10.9;0.0
03;2021-04-14;2192;1167;0;73365;33021;0;25.0;11.3;0.0
03;2021-04-15;2536;1366;0;75901;34387;0;25.9;11.7;0.0
03;2021-04-16;2670;1175;0;78571;35562;0;26.8;12.1;0.0
03;2021-04-17;1055;419;0;79626;35981;0;27.1;12.3;0.0
03;2021-04-18;26;7;0;79652;35988;0;27.2;12.3;0.0
03;2021-04-19;1164;609;0;80816;36597;0;27.5;12.5;0.0
03;2021-04-20;1704;1272;0;82520;37869;0;28.1;12.9;0.0
03;2021-04-21;1148;1266;0;83668;39135;0;28.5;13.3;0.0
03;2021-04-22;1659;1004;0;85327;40139;0;29.1;13.7;0.0
03;2021-04-23;2372;1283;0;87699;41422;0;29.9;14.1;0.0
03;2021-04-24;1257;921;0;88956;42343;0;30.3;14.4;0.0
03;2021-04-25;370;25;0;89326;42368;0;30.4;14.4;0.0
03;2021-04-26;1301;496;0;90627;42864;0;30.9;14.6;0.0
03;2021-04-27;1686;1580;0;92313;44444;0;31.5;15.1;0.0
03;2021-04-28;1880;1172;0;94193;45616;0;32.1;15.5;0.0
03;2021-04-29;2276;1211;0;96469;46827;0;32.9;16.0;0.0
03;2021-04-30;1819;834;0;98288;47661;0;33.5;16.2;0.0
03;2021-05-01;450;492;0;98738;48153;0;33.7;16.4;0.0
03;2021-05-02;28;12;0;98766;48165;0;33.7;16.4;0.0
03;2021-05-03;1800;789;0;100566;48954;0;34.3;16.7;0.0
03;2021-05-04;2655;1657;0;103221;50611;0;35.2;17.3;0.0
03;2021-05-05;2409;1323;0;105630;51934;0;36.0;17.7;0.0
03;2021-05-06;2850;1929;0;108480;53863;0;37.0;18.4;0.0
03;2021-05-07;4320;1754;0;112800;55617;0;38.5;19.0;0.0
03;2021-05-08;562;344;0;113362;55961;0;38.6;19.1;0.0
03;2021-05-09;56;366;0;113418;56327;0;38.7;19.2;0.0
03;2021-05-10;1751;1504;0;115169;57831;0;39.3;19.7;0.0
03;2021-05-11;3431;1855;0;118600;59686;0;40.4;20.3;0.0
03;2021-05-12;2584;1473;0;121184;61159;0;41.3;20.8;0.0
03;2021-05-13;3434;349;0;124618;61508;0;42.5;21.0;0.0
03;2021-05-14;3131;1642;0;127749;63150;0;43.5;21.5;0.0
03;2021-05-15;1706;472;0;129455;63622;0;44.1;21.7;0.0
03;2021-05-16;508;54;0;129963;63676;0;44.3;21.7;0.0
03;2021-05-17;1219;879;0;131182;64555;0;44.7;22.0;0.0
03;2021-05-18;2870;1492;0;134052;66047;0;45.7;22.5;0.0
03;2021-05-19;2361;932;0;136413;66979;0;46.5;22.8;0.0
03;2021-05-20;2970;1080;0;139383;68059;0;47.5;23.2;0.0
03;2021-05-21;3551;1260;0;142934;69319;0;48.7;23.6;0.0
03;2021-05-22;1741;350;0;144675;69669;0;49.3;23.7;0.0
03;2021-05-23;599;67;0;145274;69736;0;49.5;23.8;0.0
03;2021-05-24;1937;157;0;147211;69893;0;50.2;23.8;0.0
03;2021-05-25;2758;1652;0;149969;71545;0;51.1;24.4;0.0
03;2021-05-26;1966;1034;0;151935;72579;0;51.8;24.7;0.0
03;2021-05-27;2646;1165;0;154581;73744;0;52.7;25.1;0.0
03;2021-05-28;3115;2197;0;157696;75941;0;53.8;25.9;0.0
03;2021-05-29;1312;595;0;159008;76536;0;54.2;26.1;0.0
03;2021-05-30;173;27;0;159181;76563;0;54.3;26.1;0.0
03;2021-05-31;679;597;0;159860;77160;0;54.5;26.3;0.0
03;2021-06-01;2079;2293;0;161939;79453;0;55.2;27.1;0.0
03;2021-06-02;1425;1706;0;163364;81159;0;55.7;27.7;0.0
03;2021-06-03;1873;2588;0;165237;83747;0;56.3;28.5;0.0
03;2021-06-04;1538;2438;0;166775;86185;0;56.8;29.4;0.0
03;2021-06-05;911;1108;0;167686;87293;0;57.2;29.8;0.0
03;2021-06-06;78;23;0;167764;87316;0;57.2;29.8;0.0
03;2021-06-07;633;1822;0;168397;89138;0;57.4;30.4;0.0
03;2021-06-08;1384;2479;0;169781;91617;0;57.9;31.2;0.0
03;2021-06-09;1127;1783;0;170908;93400;0;58.3;31.8;0.0
03;2021-06-10;1226;2022;0;172134;95422;0;58.7;32.5;0.0
03;2021-06-11;1297;3223;0;173431;98645;0;59.1;33.6;0.0
03;2021-06-12;728;830;0;174159;99475;0;59.4;33.9;0.0
03;2021-06-13;42;28;0;174201;99503;0;59.4;33.9;0.0
03;2021-06-14;426;2003;0;174627;101506;0;59.5;34.6;0.0
03;2021-06-15;1169;3534;0;175796;105040;0;59.9;35.8;0.0
03;2021-06-16;772;2656;0;176568;107696;0;60.2;36.7;0.0
03;2021-06-17;1010;3058;0;177578;110754;0;60.5;37.8;0.0
03;2021-06-18;1052;3648;0;178630;114402;0;60.9;39.0;0.0
03;2021-06-19;571;1369;0;179201;115771;0;61.1;39.5;0.0
03;2021-06-20;29;26;0;179230;115797;0;61.1;39.5;0.0
03;2021-06-21;450;2358;0;179680;118155;0;61.2;40.3;0.0
03;2021-06-22;881;3588;0;180561;121743;0;61.5;41.5;0.0
03;2021-06-23;598;2796;0;181159;124539;0;61.8;42.5;0.0
03;2021-06-24;834;3508;0;181993;128047;0;62.0;43.6;0.0
03;2021-06-25;852;3451;0;182845;131498;0;62.3;44.8;0.0
03;2021-06-26;480;1812;0;183325;133310;0;62.5;45.4;0.0
03;2021-06-27;58;488;0;183383;133798;0;62.5;45.6;0.0
03;2021-06-28;604;1865;0;183987;135663;0;62.7;46.2;0.0
03;2021-06-29;973;3140;0;184960;138803;0;63.0;47.3;0.0
03;2021-06-30;773;2842;0;185733;141645;0;63.3;48.3;0.0
03;2021-07-01;905;2756;0;186638;144401;0;63.6;49.2;0.0
03;2021-07-02;877;3629;0;187515;148030;0;63.9;50.5;0.0
03;2021-07-03;450;1640;0;187965;149670;0;64.1;51.0;0.0
03;2021-07-04;35;294;0;188000;149964;0;64.1;51.1;0.0
03;2021-07-05;719;2073;0;188719;152037;0;64.3;51.8;0.0
03;2021-07-06;1073;3185;0;189792;155222;0;64.7;52.9;0.0
03;2021-07-07;789;2276;0;190581;157498;0;65.0;53.7;0.0
03;2021-07-08;942;2765;0;191523;160263;0;65.3;54.6;0.0
03;2021-07-09;1212;3035;0;192735;163298;0;65.7;55.7;0.0
03;2021-07-10;406;1470;0;193141;164768;0;65.8;56.2;0.0
03;2021-07-11;73;387;0;193214;165155;0;65.9;56.3;0.0
03;2021-07-12;833;1241;0;194047;166396;0;66.1;56.7;0.0
03;2021-07-13;2217;2923;0;196264;169319;0;66.9;57.7;0.0
03;2021-07-14;231;84;0;196495;169403;0;67.0;57.7;0.0
03;2021-07-15;2244;2207;0;198739;171610;0;67.7;58.5;0.0
03;2021-07-16;2331;2032;0;201070;173642;0;68.5;59.2;0.0
03;2021-07-17;916;1381;0;201986;175023;0;68.9;59.7;0.0
03;2021-07-18;82;21;0;202068;175044;0;68.9;59.7;0.0
03;2021-07-19;2080;1259;0;204148;176303;0;69.6;60.1;0.0
03;2021-07-20;2696;2825;0;206844;179128;0;70.5;61.1;0.0
03;2021-07-21;2709;1312;0;209553;180440;0;71.4;61.5;0.0
03;2021-07-22;2493;1730;0;212046;182170;0;72.3;62.1;0.0
03;2021-07-23;2730;1182;0;214776;183352;0;73.2;62.5;0.0
03;2021-07-24;647;540;0;215423;183892;0;73.4;62.7;0.0
03;2021-07-25;100;42;0;215523;183934;0;73.5;62.7;0.0
03;2021-07-26;1806;1438;0;217329;185372;0;74.1;63.2;0.0
03;2021-07-27;2912;1914;0;220241;187286;0;75.1;63.8;0.0
03;2021-07-28;2333;995;0;222574;188281;0;75.9;64.2;0.0
03;2021-07-29;2142;1349;0;224716;189630;0;76.6;64.6;0.0
03;2021-07-30;1930;1251;0;226646;190881;0;77.3;65.1;0.0
03;2021-07-31;832;737;0;227478;191618;0;77.5;65.3;0.0
03;2021-08-01;55;31;0;227533;191649;0;77.6;65.3;0.0
03;2021-08-02;1513;1459;0;229046;193108;0;78.1;65.8;0.0
03;2021-08-03;1975;2481;0;231021;195589;0;78.7;66.7;0.0
03;2021-08-04;1824;838;0;232845;196427;0;79.4;67.0;0.0
03;2021-08-05;1232;1652;0;234077;198079;0;79.8;67.5;0.0
03;2021-08-06;1260;977;0;235337;199056;0;80.2;67.9;0.0
03;2021-08-07;564;536;0;235901;199592;0;80.4;68.0;0.0
03;2021-08-08;82;72;0;235983;199664;0;80.4;68.1;0.0
03;2021-08-09;659;1317;0;236642;200981;0;80.7;68.5;0.0
03;2021-08-10;1567;2983;0;238209;203964;0;81.2;69.5;0.0
03;2021-08-11;1211;2123;0;239420;206087;0;81.6;70.2;0.0
03;2021-08-12;1044;2869;0;240464;208956;0;82.0;71.2;0.0
03;2021-08-13;813;1147;0;241277;210103;0;82.2;71.6;0.0
03;2021-08-14;387;594;0;241664;210697;0;82.4;71.8;0.0
03;2021-08-15;17;98;0;241681;210795;0;82.4;71.9;0.0
03;2021-08-16;677;2387;0;242358;213182;0;82.6;72.7;0.0
03;2021-08-17;1006;2793;0;243364;215975;0;83.0;73.6;0.0
03;2021-08-18;1093;1948;0;244457;217923;0;83.3;74.3;0.0
03;2021-08-19;924;2519;0;245381;220442;0;83.6;75.1;0.0
03;2021-08-20;724;1187;0;246105;221629;0;83.9;75.5;0.0
03;2021-08-21;395;722;0;246500;222351;0;84.0;75.8;0.0
03;2021-08-22;23;34;0;246523;222385;0;84.0;75.8;0.0
03;2021-08-23;714;2061;0;247237;224446;0;84.3;76.5;0.0
03;2021-08-24;841;2128;0;248078;226574;0;84.6;77.2;0.0
03;2021-08-25;833;1721;0;248911;228295;0;84.8;77.8;0.0
03;2021-08-26;528;1321;0;249439;229616;0;85.0;78.3;0.0
03;2021-08-27;455;1548;0;249894;231164;0;85.2;78.8;0.0
03;2021-08-28;216;620;0;250110;231784;0;85.3;79.0;0.0
03;2021-08-29;11;17;0;250121;231801;0;85.3;79.0;0.0
03;2021-08-30;711;1330;22;250832;233131;22;85.5;79.5;0.0
03;2021-08-31;683;1863;107;251515;234994;129;85.7;80.1;0.0
03;2021-09-01;571;1266;218;252086;236260;347;85.9;80.5;0.1
03;2021-09-02;450;1001;146;252536;237261;493;86.1;80.9;0.2
03;2021-09-03;481;1095;134;253017;238356;627;86.2;81.2;0.2
03;2021-09-04;251;601;27;253268;238957;654;86.3;81.5;0.2
03;2021-09-05;12;34;3;253280;238991;657;86.3;81.5;0.2
03;2021-09-06;313;689;417;253593;239680;1074;86.4;81.7;0.4
03;2021-09-07;566;1093;467;254159;240773;1541;86.6;82.1;0.5
03;2021-09-08;384;1201;305;254543;241974;1846;86.8;82.5;0.6
03;2021-09-09;242;611;292;254785;242585;2138;86.8;82.7;0.7
03;2021-09-10;409;912;326;255194;243497;2464;87.0;83.0;0.8
03;2021-09-11;199;601;42;255393;244098;2506;87.1;83.2;0.9
03;2021-09-12;7;19;2;255400;244117;2508;87.1;83.2;0.9
03;2021-09-13;272;602;314;255672;244719;2822;87.2;83.4;1.0
03;2021-09-14;410;882;526;256082;245601;3348;87.3;83.7;1.1
03;2021-09-15;337;958;386;256419;246559;3734;87.4;84.0;1.3
03;2021-09-16;199;547;421;256618;247106;4155;87.5;84.2;1.4
03;2021-09-17;166;383;335;256784;247489;4490;87.5;84.4;1.5
03;2021-09-18;143;323;103;256927;247812;4593;87.6;84.5;1.6
03;2021-09-19;3;19;0;256930;247831;4593;87.6;84.5;1.6
03;2021-09-20;181;420;422;257111;248251;5015;87.6;84.6;1.7
03;2021-09-21;238;671;673;257349;248922;5688;87.7;84.9;1.9
03;2021-09-22;258;659;656;257607;249581;6344;87.8;85.1;2.2
03;2021-09-23;159;424;630;257766;250005;6974;87.9;85.2;2.4
03;2021-09-24;146;349;302;257912;250354;7276;87.9;85.3;2.5
03;2021-09-25;61;267;44;257973;250621;7320;87.9;85.4;2.5
03;2021-09-26;2;2;0;257975;250623;7320;87.9;85.4;2.5
03;2021-09-27;120;336;287;258095;250959;7607;88.0;85.5;2.6
03;2021-09-28;170;582;694;258265;251541;8301;88.0;85.7;2.8
03;2021-09-29;193;461;602;258458;252002;8903;88.1;85.9;3.0
03;2021-09-30;119;235;467;258577;252237;9370;88.1;86.0;3.2
03;2021-10-01;164;477;326;258741;252714;9696;88.2;86.1;3.3
03;2021-10-02;89;191;136;258830;252905;9832;88.2;86.2;3.4
03;2021-10-03;0;1;6;258830;252906;9838;88.2;86.2;3.4
03;2021-10-04;51;117;228;258881;253023;10066;88.2;86.2;3.4
03;2021-10-05;158;369;622;259039;253392;10688;88.3;86.4;3.6
03;2021-10-06;258;496;756;259297;253888;11444;88.4;86.5;3.9
03;2021-10-07;95;201;540;259392;254089;11984;88.4;86.6;4.1
03;2021-10-08;136;283;501;259528;254372;12485;88.5;86.7;4.3
03;2021-10-09;105;173;229;259633;254545;12714;88.5;86.8;4.3
03;2021-10-10;6;8;72;259639;254553;12786;88.5;86.8;4.4
03;2021-10-11;168;275;569;259807;254828;13355;88.6;86.9;4.6
03;2021-10-12;166;274;711;259973;255102;14066;88.6;87.0;4.8
03;2021-10-13;243;364;755;260216;255466;14821;88.7;87.1;5.1
03;2021-10-14;90;159;578;260306;255625;15399;88.7;87.1;5.2
03;2021-10-15;97;188;308;260403;255813;15707;88.8;87.2;5.4
03;2021-10-16;72;100;149;260475;255913;15856;88.8;87.2;5.4
03;2021-10-17;2;2;4;260477;255915;15860;88.8;87.2;5.4
03;2021-10-18;71;121;369;260548;256036;16229;88.8;87.3;5.5
03;2021-10-19;91;136;547;260639;256172;16776;88.8;87.3;5.7
03;2021-10-20;165;320;1044;260804;256492;17820;88.9;87.4;6.1
03;2021-10-21;68;102;732;260872;256594;18552;88.9;87.5;6.3
03;2021-10-22;93;183;578;260965;256777;19130;89.0;87.5;6.5
03;2021-10-23;25;91;152;260990;256868;19282;89.0;87.6;6.6
03;2021-10-24;3;1;10;260993;256869;19292;89.0;87.6;6.6
03;2021-10-25;61;56;486;261054;256925;19778;89.0;87.6;6.7
03;2021-10-26;69;116;457;261123;257041;20235;89.0;87.6;6.9
03;2021-10-27;129;263;1285;261252;257304;21520;89.1;87.7;7.3
03;2021-10-28;70;94;690;261322;257398;22210;89.1;87.7;7.6
03;2021-10-29;59;117;491;261381;257515;22701;89.1;87.8;7.7
03;2021-10-30;28;58;149;261409;257573;22850;89.1;87.8;7.8
03;2021-10-31;0;2;5;261409;257575;22855;89.1;87.8;7.8
03;2021-11-01;8;20;34;261417;257595;22889;89.1;87.8;7.8
03;2021-11-02;57;133;643;261474;257728;23532;89.1;87.9;8.0
03;2021-11-03;141;314;1319;261615;258042;24851;89.2;88.0;8.5
03;2021-11-04;46;117;896;261661;258159;25747;89.2;88.0;8.8
03;2021-11-05;79;122;771;261740;258281;26518;89.2;88.0;9.0
03;2021-11-06;20;72;243;261760;258353;26761;89.2;88.1;9.1
03;2021-11-07;1;4;16;261761;258357;26777;89.2;88.1;9.1
03;2021-11-08;40;101;652;261801;258458;27429;89.2;88.1;9.3
03;2021-11-09;58;96;975;261859;258554;28404;89.3;88.1;9.7
03;2021-11-10;145;235;2032;262004;258789;30436;89.3;88.2;10.4
03;2021-11-11;3;5;44;262007;258794;30480;89.3;88.2;10.4
03;2021-11-12;38;96;655;262045;258890;31135;89.3;88.2;10.6
03;2021-11-13;21;23;344;262066;258913;31479;89.3;88.3;10.7
03;2021-11-14;1;5;9;262067;258918;31488;89.3;88.3;10.7
03;2021-11-15;41;63;853;262108;258981;32341;89.3;88.3;11.0
03;2021-11-16;60;82;1244;262168;259063;33585;89.4;88.3;11.4
03;2021-11-17;149;179;1984;262317;259242;35569;89.4;88.4;12.1
03;2021-11-18;69;74;1679;262386;259316;37248;89.4;88.4;12.7
03;2021-11-19;103;116;1455;262489;259432;38703;89.5;88.4;13.2
03;2021-11-20;46;37;570;262535;259469;39273;89.5;88.4;13.4
03;2021-11-21;0;4;16;262535;259473;39289;89.5;88.4;13.4
03;2021-11-22;57;31;935;262592;259504;40224;89.5;88.5;13.7
03;2021-11-23;59;44;1243;262651;259548;41467;89.5;88.5;14.1
03;2021-11-24;136;134;2006;262787;259682;43473;89.6;88.5;14.8
03;2021-11-25;69;66;1796;262856;259748;45269;89.6;88.5;15.4
03;2021-11-26;88;97;1919;262944;259845;47188;89.6;88.6;16.1
03;2021-11-27;32;39;657;262976;259884;47845;89.6;88.6;16.3
03;2021-11-28;1;3;37;262977;259887;47882;89.6;88.6;16.3
03;2021-11-29;42;59;1637;263019;259946;49519;89.7;88.6;16.9
03;2021-11-30;79;72;3143;263098;260018;52662;89.7;88.6;18.0
03;2021-12-01;78;124;3130;263176;260142;55792;89.7;88.7;19.0
03;2021-12-02;53;42;3673;263229;260184;59465;89.7;88.7;20.3
03;2021-12-03;66;60;3142;263295;260244;62607;89.8;88.7;21.3
03;2021-12-04;50;33;1658;263345;260277;64265;89.8;88.7;21.9
03;2021-12-05;1;3;75;263346;260280;64340;89.8;88.7;21.9
03;2021-12-06;39;50;2897;263385;260330;67237;89.8;88.7;22.9
03;2021-12-07;69;77;4307;263454;260407;71544;89.8;88.8;24.4
03;2021-12-08;51;145;3858;263505;260552;75402;89.8;88.8;25.7
03;2021-12-09;79;73;4350;263584;260625;79752;89.8;88.8;27.2
03;2021-12-10;78;110;5119;263662;260735;84871;89.9;88.9;28.9
03;2021-12-11;36;40;2196;263698;260775;87067;89.9;88.9;29.7
03;2021-12-12;2;5;102;263700;260780;87169;89.9;88.9;29.7
03;2021-12-13;56;69;3374;263756;260849;90543;89.9;88.9;30.9
03;2021-12-14;82;87;5053;263838;260936;95596;89.9;88.9;32.6
03;2021-12-15;66;139;4946;263904;261075;100542;90.0;89.0;34.3
03;2021-12-16;65;93;5473;263969;261168;106015;90.0;89.0;36.1
03;2021-12-17;87;129;4774;264056;261297;110789;90.0;89.1;37.8
03;2021-12-18;57;50;2568;264113;261347;113357;90.0;89.1;38.6
03;2021-12-19;14;8;502;264127;261355;113859;90.0;89.1;38.8
04;2020-12-27;0;0;0;0;0;0;0.0;0.0;0.0
04;2020-12-28;0;0;0;0;0;0;0.0;0.0;0.0
04;2020-12-29;0;0;0;0;0;0;0.0;0.0;0.0
04;2020-12-30;0;0;0;0;0;0;0.0;0.0;0.0
04;2020-12-31;0;0;0;0;0;0;0.0;0.0;0.0
04;2021-01-01;0;0;0;0;0;0;0.0;0.0;0.0
04;2021-01-02;0;0;0;0;0;0;0.0;0.0;0.0
04;2021-01-03;0;0;0;0;0;0;0.0;0.0;0.0
04;2021-01-04;1;0;0;1;0;0;0.0;0.0;0.0
04;2021-01-05;3;0;0;4;0;0;0.0;0.0;0.0
04;2021-01-06;1;0;0;5;0;0;0.0;0.0;0.0
04;2021-01-07;53;0;0;58;0;0;0.0;0.0;0.0
04;2021-01-08;91;0;0;149;0;0;0.1;0.0;0.0
04;2021-01-09;29;0;0;178;0;0;0.1;0.0;0.0
04;2021-01-10;0;0;0;178;0;0;0.1;0.0;0.0
04;2021-01-11;75;0;0;253;0;0;0.2;0.0;0.0
04;2021-01-12;356;0;0;609;0;0;0.4;0.0;0.0
04;2021-01-13;209;2;0;818;2;0;0.6;0.0;0.0
04;2021-01-14;95;4;0;913;6;0;0.6;0.0;0.0
04;2021-01-15;172;4;0;1085;10;0;0.7;0.0;0.0
04;2021-01-16;80;2;0;1165;12;0;0.8;0.0;0.0
04;2021-01-17;14;0;0;1179;12;0;0.8;0.0;0.0
04;2021-01-18;223;5;0;1402;17;0;1.0;0.0;0.0
04;2021-01-19;446;4;0;1848;21;0;1.3;0.0;0.0
04;2021-01-20;531;9;0;2379;30;0;1.6;0.0;0.0
04;2021-01-21;531;3;0;2910;33;0;2.0;0.0;0.0
04;2021-01-22;541;1;0;3451;34;0;2.4;0.0;0.0
04;2021-01-23;95;1;0;3546;35;0;2.4;0.0;0.0
04;2021-01-24;0;0;0;3546;35;0;2.4;0.0;0.0
04;2021-01-25;225;0;0;3771;35;0;2.6;0.0;0.0
04;2021-01-26;584;2;0;4355;37;0;3.0;0.0;0.0
04;2021-01-27;449;1;0;4804;38;0;3.3;0.0;0.0
04;2021-01-28;565;22;0;5369;60;0;3.7;0.0;0.0
04;2021-01-29;326;65;0;5695;125;0;3.9;0.1;0.0
04;2021-01-30;49;28;0;5744;153;0;4.0;0.1;0.0
04;2021-01-31;1;3;0;5745;156;0;4.0;0.1;0.0
04;2021-02-01;251;126;0;5996;282;0;4.1;0.2;0.0
04;2021-02-02;513;208;0;6509;490;0;4.5;0.3;0.0
04;2021-02-03;296;134;0;6805;624;0;4.7;0.4;0.0
04;2021-02-04;302;65;0;7107;689;0;4.9;0.5;0.0
04;2021-02-05;352;192;0;7459;881;0;5.1;0.6;0.0
04;2021-02-06;33;74;0;7492;955;0;5.2;0.7;0.0
04;2021-02-07;3;12;0;7495;967;0;5.2;0.7;0.0
04;2021-02-08;159;74;0;7654;1041;0;5.3;0.7;0.0
04;2021-02-09;155;147;0;7809;1188;0;5.4;0.8;0.0
04;2021-02-10;253;177;0;8062;1365;0;5.6;0.9;0.0
04;2021-02-11;321;279;0;8383;1644;0;5.8;1.1;0.0
04;2021-02-12;286;309;0;8669;1953;0;6.0;1.3;0.0
04;2021-02-13;22;88;0;8691;2041;0;6.0;1.4;0.0
04;2021-02-14;0;1;0;8691;2042;0;6.0;1.4;0.0
04;2021-02-15;29;149;0;8720;2191;0;6.0;1.5;0.0
04;2021-02-16;79;455;0;8799;2646;0;6.1;1.8;0.0
04;2021-02-17;64;388;0;8863;3034;0;6.1;2.1;0.0
04;2021-02-18;56;547;0;8919;3581;0;6.1;2.5;0.0
04;2021-02-19;61;327;0;8980;3908;0;6.2;2.7;0.0
04;2021-02-20;7;59;0;8987;3967;0;6.2;2.7;0.0
04;2021-02-21;0;0;0;8987;3967;0;6.2;2.7;0.0
04;2021-02-22;15;284;0;9002;4251;0;6.2;2.9;0.0
04;2021-02-23;29;528;0;9031;4779;0;6.2;3.3;0.0
04;2021-02-24;43;400;0;9074;5179;0;6.2;3.6;0.0
04;2021-02-25;71;327;0;9145;5506;0;6.3;3.8;0.0
04;2021-02-26;206;299;0;9351;5805;0;6.4;4.0;0.0
04;2021-02-27;158;64;0;9509;5869;0;6.5;4.0;0.0
04;2021-02-28;0;0;0;9509;5869;0;6.5;4.0;0.0
04;2021-03-01;24;79;0;9533;5948;0;6.6;4.1;0.0
04;2021-03-02;141;45;0;9674;5993;0;6.7;4.1;0.0
04;2021-03-03;354;553;0;10028;6546;0;6.9;4.5;0.0
04;2021-03-04;212;439;0;10240;6985;0;7.0;4.8;0.0
04;2021-03-05;247;304;0;10487;7289;0;7.2;5.0;0.0
04;2021-03-06;849;61;0;11336;7350;0;7.8;5.1;0.0
04;2021-03-07;468;24;0;11804;7374;0;8.1;5.1;0.0
04;2021-03-08;62;87;0;11866;7461;0;8.2;5.1;0.0
04;2021-03-09;215;208;0;12081;7669;0;8.3;5.3;0.0
04;2021-03-10;400;302;0;12481;7971;0;8.6;5.5;0.0
04;2021-03-11;488;325;0;12969;8296;0;8.9;5.7;0.0
04;2021-03-12;681;207;0;13650;8503;0;9.4;5.9;0.0
04;2021-03-13;994;56;0;14644;8559;0;10.1;5.9;0.0
04;2021-03-14;412;7;0;15056;8566;0;10.4;5.9;0.0
04;2021-03-15;115;14;0;15171;8580;0;10.4;5.9;0.0
04;2021-03-16;88;15;0;15259;8595;0;10.5;5.9;0.0
04;2021-03-17;541;87;0;15800;8682;0;10.9;6.0;0.0
04;2021-03-18;786;34;0;16586;8716;0;11.4;6.0;0.0
04;2021-03-19;719;40;0;17305;8756;0;11.9;6.0;0.0
04;2021-03-20;150;4;0;17455;8760;0;12.0;6.0;0.0
04;2021-03-21;2;0;0;17457;8760;0;12.0;6.0;0.0
04;2021-03-22;151;19;0;17608;8779;0;12.1;6.0;0.0
04;2021-03-23;264;17;0;17872;8796;0;12.3;6.1;0.0
04;2021-03-24;1006;40;0;18878;8836;0;13.0;6.1;0.0
04;2021-03-25;1218;60;0;20096;8896;0;13.8;6.1;0.0
04;2021-03-26;1394;77;0;21490;8973;0;14.8;6.2;0.0
04;2021-03-27;240;17;0;21730;8990;0;15.0;6.2;0.0
04;2021-03-28;11;0;0;21741;8990;0;15.0;6.2;0.0
04;2021-03-29;663;27;0;22404;9017;0;15.4;6.2;0.0
04;2021-03-30;1035;143;0;23439;9160;0;16.1;6.3;0.0
04;2021-03-31;1260;113;0;24699;9273;0;17.0;6.4;0.0
04;2021-04-01;1054;134;0;25753;9407;0;17.7;6.5;0.0
04;2021-04-02;1120;127;0;26873;9534;0;18.5;6.6;0.0
04;2021-04-03;219;29;0;27092;9563;0;18.7;6.6;0.0
04;2021-04-04;11;4;0;27103;9567;0;18.7;6.6;0.0
04;2021-04-05;44;4;0;27147;9571;0;18.7;6.6;0.0
04;2021-04-06;895;153;0;28042;9724;0;19.3;6.7;0.0
04;2021-04-07;840;431;0;28882;10155;0;19.9;7.0;0.0
04;2021-04-08;876;636;0;29758;10791;0;20.5;7.4;0.0
04;2021-04-09;672;424;0;30430;11215;0;20.9;7.7;0.0
04;2021-04-10;238;160;0;30668;11375;0;21.1;7.8;0.0
04;2021-04-11;134;51;0;30802;11426;0;21.2;7.9;0.0
04;2021-04-12;604;127;0;31406;11553;0;21.6;8.0;0.0
04;2021-04-13;1050;238;0;32456;11791;0;22.3;8.1;0.0
04;2021-04-14;911;494;0;33367;12285;0;23.0;8.5;0.0
04;2021-04-15;833;641;0;34200;12926;0;23.5;8.9;0.0
04;2021-04-16;781;468;0;34981;13394;0;24.1;9.2;0.0
04;2021-04-17;217;86;0;35198;13480;0;24.2;9.3;0.0
04;2021-04-18;11;15;0;35209;13495;0;24.2;9.3;0.0
04;2021-04-19;356;296;0;35565;13791;0;24.5;9.5;0.0
04;2021-04-20;892;435;0;36457;14226;0;25.1;9.8;0.0
04;2021-04-21;630;717;0;37087;14943;0;25.5;10.3;0.0
04;2021-04-22;659;773;0;37746;15716;0;26.0;10.8;0.0
04;2021-04-23;676;535;0;38422;16251;0;26.5;11.2;0.0
04;2021-04-24;147;68;0;38569;16319;0;26.6;11.2;0.0
04;2021-04-25;5;8;0;38574;16327;0;26.6;11.2;0.0
04;2021-04-26;201;617;0;38775;16944;0;26.7;11.7;0.0
04;2021-04-27;388;882;0;39163;17826;0;27.0;12.3;0.0
04;2021-04-28;457;1012;0;39620;18838;0;27.3;13.0;0.0
04;2021-04-29;667;1025;0;40287;19863;0;27.7;13.7;0.0
04;2021-04-30;489;814;0;40776;20677;0;28.1;14.2;0.0
04;2021-05-01;96;25;0;40872;20702;0;28.1;14.3;0.0
04;2021-05-02;19;116;0;40891;20818;0;28.2;14.3;0.0
04;2021-05-03;193;545;0;41084;21363;0;28.3;14.7;0.0
04;2021-05-04;534;810;0;41618;22173;0;28.7;15.3;0.0
04;2021-05-05;474;881;0;42092;23054;0;29.0;15.9;0.0
04;2021-05-06;1048;559;0;43140;23613;0;29.7;16.3;0.0
04;2021-05-07;664;707;0;43804;24320;0;30.2;16.7;0.0
04;2021-05-08;87;78;0;43891;24398;0;30.2;16.8;0.0
04;2021-05-09;14;6;0;43905;24404;0;30.2;16.8;0.0
04;2021-05-10;486;359;0;44391;24763;0;30.6;17.0;0.0
04;2021-05-11;1158;851;0;45549;25614;0;31.4;17.6;0.0
04;2021-05-12;1358;680;0;46907;26294;0;32.3;18.1;0.0
04;2021-05-13;400;116;0;47307;26410;0;32.6;18.2;0.0
04;2021-05-14;491;300;0;47798;26710;0;32.9;18.4;0.0
04;2021-05-15;204;128;0;48002;26838;0;33.0;18.5;0.0
04;2021-05-16;50;8;0;48052;26846;0;33.1;18.5;0.0
04;2021-05-17;220;310;0;48272;27156;0;33.2;18.7;0.0
04;2021-05-18;451;923;0;48723;28079;0;33.5;19.3;0.0
04;2021-05-19;791;657;0;49514;28736;0;34.1;19.8;0.0
04;2021-05-20;1189;574;0;50703;29310;0;34.9;20.2;0.0
04;2021-05-21;909;765;0;51612;30075;0;35.5;20.7;0.0
04;2021-05-22;167;130;0;51779;30205;0;35.6;20.8;0.0
04;2021-05-23;24;6;0;51803;30211;0;35.7;20.8;0.0
04;2021-05-24;76;41;0;51879;30252;0;35.7;20.8;0.0
04;2021-05-25;854;549;0;52733;30801;0;36.3;21.2;0.0
04;2021-05-26;1017;757;0;53750;31558;0;37.0;21.7;0.0
04;2021-05-27;1279;607;0;55029;32165;0;37.9;22.1;0.0
04;2021-05-28;1073;650;0;56102;32815;0;38.6;22.6;0.0
04;2021-05-29;149;366;0;56251;33181;0;38.7;22.8;0.0
04;2021-05-30;15;8;0;56266;33189;0;38.7;22.8;0.0
04;2021-05-31;509;443;0;56775;33632;0;39.1;23.2;0.0
04;2021-06-01;727;614;0;57502;34246;0;39.6;23.6;0.0
04;2021-06-02;933;1017;0;58435;35263;0;40.2;24.3;0.0
04;2021-06-03;1127;772;0;59562;36035;0;41.0;24.8;0.0
04;2021-06-04;1007;790;0;60569;36825;0;41.7;25.4;0.0
04;2021-06-05;184;212;0;60753;37037;0;41.8;25.5;0.0
04;2021-06-06;23;27;0;60776;37064;0;41.8;25.5;0.0
04;2021-06-07;587;368;0;61363;37432;0;42.2;25.8;0.0
04;2021-06-08;791;581;0;62154;38013;0;42.8;26.2;0.0
04;2021-06-09;1084;683;0;63238;38696;0;43.5;26.6;0.0
04;2021-06-10;1050;578;0;64288;39274;0;44.3;27.0;0.0
04;2021-06-11;872;661;0;65160;39935;0;44.9;27.5;0.0
04;2021-06-12;255;167;0;65415;40102;0;45.0;27.6;0.0
04;2021-06-13;18;10;0;65433;40112;0;45.0;27.6;0.0
04;2021-06-14;468;385;0;65901;40497;0;45.4;27.9;0.0
04;2021-06-15;621;939;0;66522;41436;0;45.8;28.5;0.0
04;2021-06-16;904;740;0;67426;42176;0;46.4;29.0;0.0
04;2021-06-17;862;891;0;68288;43067;0;47.0;29.6;0.0
04;2021-06-18;713;859;0;69001;43926;0;47.5;30.2;0.0
04;2021-06-19;100;161;0;69101;44087;0;47.6;30.4;0.0
04;2021-06-20;12;22;0;69113;44109;0;47.6;30.4;0.0
04;2021-06-21;295;635;0;69408;44744;0;47.8;30.8;0.0
04;2021-06-22;374;1276;0;69782;46020;0;48.0;31.7;0.0
04;2021-06-23;432;1257;0;70214;47277;0;48.3;32.5;0.0
04;2021-06-24;699;793;0;70913;48070;0;48.8;33.1;0.0
04;2021-06-25;444;693;0;71357;48763;0;49.1;33.6;0.0
04;2021-06-26;79;241;0;71436;49004;0;49.2;33.7;0.0
04;2021-06-27;10;25;0;71446;49029;0;49.2;33.8;0.0
04;2021-06-28;160;416;0;71606;49445;0;49.3;34.0;0.0
04;2021-06-29;363;856;0;71969;50301;0;49.5;34.6;0.0
04;2021-06-30;493;1105;0;72462;51406;0;49.9;35.4;0.0
04;2021-07-01;522;1158;0;72984;52564;0;50.2;36.2;0.0
04;2021-07-02;497;1096;0;73481;53660;0;50.6;36.9;0.0
04;2021-07-03;90;221;0;73571;53881;0;50.6;37.1;0.0
04;2021-07-04;14;28;0;73585;53909;0;50.7;37.1;0.0
04;2021-07-05;155;417;0;73740;54326;0;50.8;37.4;0.0
04;2021-07-06;441;1349;0;74181;55675;0;51.1;38.3;0.0
04;2021-07-07;472;1268;0;74653;56943;0;51.4;39.2;0.0
04;2021-07-08;625;1206;0;75278;58149;0;51.8;40.0;0.0
04;2021-07-09;554;1078;0;75832;59227;0;52.2;40.8;0.0
04;2021-07-10;122;215;0;75954;59442;0;52.3;40.9;0.0
04;2021-07-11;15;46;0;75969;59488;0;52.3;41.0;0.0
04;2021-07-12;154;708;0;76123;60196;0;52.4;41.4;0.0
04;2021-07-13;746;1463;0;76869;61659;0;52.9;42.4;0.0
04;2021-07-14;91;81;0;76960;61740;0;53.0;42.5;0.0
04;2021-07-15;997;1501;0;77957;63241;0;53.7;43.5;0.0
04;2021-07-16;1049;1140;0;79006;64381;0;54.4;44.3;0.0
04;2021-07-17;455;276;0;79461;64657;0;54.7;44.5;0.0
04;2021-07-18;121;42;0;79582;64699;0;54.8;44.5;0.0
04;2021-07-19;512;694;0;80094;65393;0;55.1;45.0;0.0
04;2021-07-20;1187;1323;0;81281;66716;0;56.0;45.9;0.0
04;2021-07-21;948;1089;0;82229;67805;0;56.6;46.7;0.0
04;2021-07-22;1327;1189;0;83556;68994;0;57.5;47.5;0.0
04;2021-07-23;1149;1096;0;84705;70090;0;58.3;48.3;0.0
04;2021-07-24;594;250;0;85299;70340;0;58.7;48.4;0.0
04;2021-07-25;55;30;0;85354;70370;0;58.8;48.4;0.0
04;2021-07-26;516;637;0;85870;71007;0;59.1;48.9;0.0
04;2021-07-27;1232;927;0;87102;71934;0;60.0;49.5;0.0
04;2021-07-28;1117;989;0;88219;72923;0;60.7;50.2;0.0
04;2021-07-29;1366;1082;0;89585;74005;0;61.7;50.9;0.0
04;2021-07-30;1166;820;0;90751;74825;0;62.5;51.5;0.0
04;2021-07-31;293;193;0;91044;75018;0;62.7;51.6;0.0
04;2021-08-01;55;27;0;91099;75045;0;62.7;51.7;0.0
04;2021-08-02;254;175;0;91353;75220;0;62.9;51.8;0.0
04;2021-08-03;1155;934;0;92508;76154;0;63.7;52.4;0.0
04;2021-08-04;1076;714;0;93584;76868;0;64.4;52.9;0.0
04;2021-08-05;975;561;0;94559;77429;0;65.1;53.3;0.0
04;2021-08-06;576;461;0;95135;77890;0;65.5;53.6;0.0
04;2021-08-07;206;228;0;95341;78118;0;65.6;53.8;0.0
04;2021-08-08;44;25;0;95385;78143;0;65.7;53.8;0.0
04;2021-08-09;204;222;0;95589;78365;0;65.8;53.9;0.0
04;2021-08-10;588;844;0;96177;79209;0;66.2;54.5;0.0
04;2021-08-11;1071;911;0;97248;80120;0;66.9;55.2;0.0
04;2021-08-12;977;1078;0;98225;81198;0;67.6;55.9;0.0
04;2021-08-13;486;438;0;98711;81636;0;68.0;56.2;0.0
04;2021-08-14;144;161;0;98855;81797;0;68.1;56.3;0.0
04;2021-08-15;16;21;0;98871;81818;0;68.1;56.3;0.0
04;2021-08-16;203;306;0;99074;82124;0;68.2;56.5;0.0
04;2021-08-17;456;969;0;99530;83093;0;68.5;57.2;0.0
04;2021-08-18;643;1269;0;100173;84362;0;69.0;58.1;0.0
04;2021-08-19;606;1247;0;100779;85609;0;69.4;58.9;0.0
04;2021-08-20;716;1353;0;101495;86962;0;69.9;59.9;0.0
04;2021-08-21;107;213;0;101602;87175;0;69.9;60.0;0.0
04;2021-08-22;13;47;0;101615;87222;0;70.0;60.0;0.0
04;2021-08-23;105;226;0;101720;87448;0;70.0;60.2;0.0
04;2021-08-24;589;1317;0;102309;88765;0;70.4;61.1;0.0
04;2021-08-25;581;1136;0;102890;89901;0;70.8;61.9;0.0
04;2021-08-26;427;1053;0;103317;90954;0;71.1;62.6;0.0
04;2021-08-27;428;940;0;103745;91894;0;71.4;63.3;0.0
04;2021-08-28;147;284;0;103892;92178;0;71.5;63.5;0.0
04;2021-08-29;31;43;0;103923;92221;0;71.5;63.5;0.0
04;2021-08-30;131;342;8;104054;92563;8;71.6;63.7;0.0
04;2021-08-31;494;922;27;104548;93485;35;72.0;64.4;0.0
04;2021-09-01;492;1134;50;105040;94619;85;72.3;65.1;0.1
04;2021-09-02;322;838;80;105362;95457;165;72.5;65.7;0.1
04;2021-09-03;292;770;56;105654;96227;221;72.7;66.2;0.2
04;2021-09-04;151;282;14;105805;96509;235;72.8;66.4;0.2
04;2021-09-05;26;17;0;105831;96526;235;72.9;66.5;0.2
04;2021-09-06;98;202;6;105929;96728;241;72.9;66.6;0.2
04;2021-09-07;345;770;194;106274;97498;435;73.2;67.1;0.3
04;2021-09-08;331;728;153;106605;98226;588;73.4;67.6;0.4
04;2021-09-09;304;607;205;106909;98833;793;73.6;68.0;0.5
04;2021-09-10;281;674;128;107190;99507;921;73.8;68.5;0.6
04;2021-09-11;105;185;39;107295;99692;960;73.9;68.6;0.7
04;2021-09-12;8;20;3;107303;99712;963;73.9;68.6;0.7
04;2021-09-13;108;117;33;107411;99829;996;73.9;68.7;0.7
04;2021-09-14;319;535;307;107730;100364;1303;74.2;69.1;0.9
04;2021-09-15;282;631;345;108012;100995;1648;74.4;69.5;1.1
04;2021-09-16;273;446;296;108285;101441;1944;74.5;69.8;1.3
04;2021-09-17;186;492;145;108471;101933;2089;74.7;70.2;1.4
04;2021-09-18;54;160;61;108525;102093;2150;74.7;70.3;1.5
04;2021-09-19;7;18;1;108532;102111;2151;74.7;70.3;1.5
04;2021-09-20;85;89;37;108617;102200;2188;74.8;70.4;1.5
04;2021-09-21;170;522;285;108787;102722;2473;74.9;70.7;1.7
04;2021-09-22;147;626;213;108934;103348;2686;75.0;71.1;1.8
04;2021-09-23;163;319;214;109097;103667;2900;75.1;71.4;2.0
04;2021-09-24;157;433;153;109254;104100;3053;75.2;71.7;2.1
04;2021-09-25;47;137;105;109301;104237;3158;75.2;71.8;2.2
04;2021-09-26;4;21;4;109305;104258;3162;75.2;71.8;2.2
04;2021-09-27;33;98;17;109338;104356;3179;75.3;71.8;2.2
04;2021-09-28;120;255;220;109458;104611;3399;75.4;72.0;2.3
04;2021-09-29;135;354;206;109593;104965;3605;75.4;72.3;2.5
04;2021-09-30;108;236;154;109701;105201;3759;75.5;72.4;2.6
04;2021-10-01;158;206;124;109859;105407;3883;75.6;72.6;2.7
04;2021-10-02;70;158;82;109929;105565;3965;75.7;72.7;2.7
04;2021-10-03;0;5;0;109929;105570;3965;75.7;72.7;2.7
04;2021-10-04;49;71;22;109978;105641;3987;75.7;72.7;2.7
04;2021-10-05;159;311;269;110137;105952;4256;75.8;72.9;2.9
04;2021-10-06;164;307;195;110301;106259;4451;75.9;73.2;3.1
04;2021-10-07;99;248;212;110400;106507;4663;76.0;73.3;3.2
04;2021-10-08;123;185;181;110523;106692;4844;76.1;73.5;3.3
04;2021-10-09;38;106;70;110561;106798;4914;76.1;73.5;3.4
04;2021-10-10;5;6;0;110566;106804;4914;76.1;73.5;3.4
04;2021-10-11;45;124;70;110611;106928;4984;76.1;73.6;3.4
04;2021-10-12;111;169;310;110722;107097;5294;76.2;73.7;3.6
04;2021-10-13;151;249;271;110873;107346;5565;76.3;73.9;3.8
04;2021-10-14;82;177;211;110955;107523;5776;76.4;74.0;4.0
04;2021-10-15;80;147;244;111035;107670;6020;76.4;74.1;4.1
04;2021-10-16;37;74;87;111072;107744;6107;76.5;74.2;4.2
04;2021-10-17;1;4;0;111073;107748;6107;76.5;74.2;4.2
04;2021-10-18;64;104;111;111137;107852;6218;76.5;74.2;4.3
04;2021-10-19;71;174;319;111208;108026;6537;76.6;74.4;4.5
04;2021-10-20;111;185;352;111319;108211;6889;76.6;74.5;4.7
04;2021-10-21;53;111;287;111372;108322;7176;76.7;74.6;4.9
04;2021-10-22;70;115;181;111442;108437;7357;76.7;74.7;5.1
04;2021-10-23;55;65;138;111497;108502;7495;76.8;74.7;5.2
04;2021-10-24;3;8;3;111500;108510;7498;76.8;74.7;5.2
04;2021-10-25;35;40;42;111535;108550;7540;76.8;74.7;5.2
04;2021-10-26;72;89;300;111607;108639;7840;76.8;74.8;5.4
04;2021-10-27;107;187;477;111714;108826;8317;76.9;74.9;5.7
04;2021-10-28;69;73;317;111783;108899;8634;77.0;75.0;5.9
04;2021-10-29;61;81;183;111844;108980;8817;77.0;75.0;6.1
04;2021-10-30;59;57;194;111903;109037;9011;77.0;75.1;6.2
04;2021-10-31;3;11;11;111906;109048;9022;77.0;75.1;6.2
04;2021-11-01;17;9;15;111923;109057;9037;77.1;75.1;6.2
04;2021-11-02;59;66;294;111982;109123;9331;77.1;75.1;6.4
04;2021-11-03;78;134;388;112060;109257;9719;77.1;75.2;6.7
04;2021-11-04;55;83;413;112115;109340;10132;77.2;75.3;7.0
04;2021-11-05;72;125;467;112187;109465;10599;77.2;75.4;7.3
04;2021-11-06;44;56;238;112231;109521;10837;77.3;75.4;7.5
04;2021-11-07;23;17;7;112254;109538;10844;77.3;75.4;7.5
04;2021-11-08;35;44;147;112289;109582;10991;77.3;75.4;7.6
04;2021-11-09;59;95;463;112348;109677;11454;77.3;75.5;7.9
04;2021-11-10;86;130;570;112434;109807;12024;77.4;75.6;8.3
04;2021-11-11;11;13;11;112445;109820;12035;77.4;75.6;8.3
04;2021-11-12;63;78;377;112508;109898;12412;77.5;75.7;8.5
04;2021-11-13;29;46;206;112537;109944;12618;77.5;75.7;8.7
04;2021-11-14;3;9;17;112540;109953;12635;77.5;75.7;8.7
04;2021-11-15;51;48;290;112591;110001;12925;77.5;75.7;8.9
04;2021-11-16;49;82;584;112640;110083;13509;77.5;75.8;9.3
04;2021-11-17;84;92;576;112724;110175;14085;77.6;75.8;9.7
04;2021-11-18;73;74;632;112797;110249;14717;77.7;75.9;10.1
04;2021-11-19;89;106;634;112886;110355;15351;77.7;76.0;10.6
04;2021-11-20;70;63;353;112956;110418;15704;77.8;76.0;10.8
04;2021-11-21;4;9;13;112960;110427;15717;77.8;76.0;10.8
04;2021-11-22;39;44;329;112999;110471;16046;77.8;76.1;11.0
04;2021-11-23;54;64;739;113053;110535;16785;77.8;76.1;11.6
04;2021-11-24;93;96;788;113146;110631;17573;77.9;76.2;12.1
04;2021-11-25;77;60;857;113223;110691;18430;77.9;76.2;12.7
04;2021-11-26;99;74;1051;113322;110765;19481;78.0;76.3;13.4
04;2021-11-27;58;64;479;113380;110829;19960;78.1;76.3;13.7
04;2021-11-28;2;15;27;113382;110844;19987;78.1;76.3;13.8
04;2021-11-29;61;63;876;113443;110907;20863;78.1;76.4;14.4
04;2021-11-30;99;75;1481;113542;110982;22344;78.2;76.4;15.4
04;2021-12-01;101;130;1268;113643;111112;23612;78.2;76.5;16.3
04;2021-12-02;59;62;1452;113702;111174;25064;78.3;76.5;17.3
04;2021-12-03;51;81;1303;113753;111255;26367;78.3;76.6;18.2
04;2021-12-04;69;76;944;113822;111331;27311;78.4;76.6;18.8
04;2021-12-05;8;8;152;113830;111339;27463;78.4;76.7;18.9
04;2021-12-06;51;72;715;113881;111411;28178;78.4;76.7;19.4
04;2021-12-07;84;85;1838;113965;111496;30016;78.5;76.8;20.7
04;2021-12-08;94;93;1907;114059;111589;31923;78.5;76.8;22.0
04;2021-12-09;85;70;1611;114144;111659;33534;78.6;76.9;23.1
04;2021-12-10;81;84;1436;114225;111743;34970;78.6;76.9;24.1
04;2021-12-11;66;66;1081;114291;111809;36051;78.7;77.0;24.8
04;2021-12-12;10;13;202;114301;111822;36253;78.7;77.0;25.0
04;2021-12-13;62;66;869;114363;111888;37122;78.7;77.0;25.6
04;2021-12-14;89;114;1782;114452;112002;38904;78.8;77.1;26.8
04;2021-12-15;106;126;2029;114558;112128;40933;78.9;77.2;28.2
04;2021-12-16;87;90;1824;114645;112218;42757;78.9;77.3;29.4
04;2021-12-17;106;122;1696;114751;112340;44453;79.0;77.3;30.6
04;2021-12-18;58;71;923;114809;112411;45376;79.0;77.4;31.2
04;2021-12-19;14;11;111;114823;112422;45487;79.0;77.4;31.3
05;2020-12-27;0;0;0;0;0;0;0.0;0.0;0.0
05;2020-12-28;1;0;0;1;0;0;0.0;0.0;0.0
05;2020-12-29;1;0;0;2;0;0;0.0;0.0;0.0
05;2020-12-30;2;0;0;4;0;0;0.0;0.0;0.0
05;2020-12-31;0;0;0;4;0;0;0.0;0.0;0.0
05;2021-01-01;1;0;0;5;0;0;0.0;0.0;0.0
05;2021-01-02;2;0;0;7;0;0;0.0;0.0;0.0
05;2021-01-03;2;0;0;9;0;0;0.0;0.0;0.0
05;2021-01-04;1;0;0;10;0;0;0.0;0.0;0.0
05;2021-01-05;1;0;0;11;0;0;0.0;0.0;0.0
05;2021-01-06;22;0;0;33;0;0;0.0;0.0;0.0
05;2021-01-07;127;0;0;160;0;0;0.1;0.0;0.0
05;2021-01-08;126;1;0;286;1;0;0.2;0.0;0.0
05;2021-01-09;28;0;0;314;1;0;0.3;0.0;0.0
05;2021-01-10;0;0;0;314;1;0;0.3;0.0;0.0
05;2021-01-11;45;0;0;359;1;0;0.3;0.0;0.0
05;2021-01-12;106;0;0;465;1;0;0.4;0.0;0.0
05;2021-01-13;146;0;0;611;1;0;0.5;0.0;0.0
05;2021-01-14;166;0;0;777;1;0;0.6;0.0;0.0
05;2021-01-15;126;2;0;903;3;0;0.7;0.0;0.0
05;2021-01-16;18;0;0;921;3;0;0.7;0.0;0.0
05;2021-01-17;0;0;0;921;3;0;0.7;0.0;0.0
05;2021-01-18;215;3;0;1136;6;0;0.9;0.0;0.0
05;2021-01-19;232;0;0;1368;6;0;1.1;0.0;0.0
05;2021-01-20;214;1;0;1582;7;0;1.3;0.0;0.0
05;2021-01-21;251;0;0;1833;7;0;1.5;0.0;0.0
05;2021-01-22;189;1;0;2022;8;0;1.6;0.0;0.0
05;2021-01-23;112;0;0;2134;8;0;1.7;0.0;0.0
05;2021-01-24;2;0;0;2136;8;0;1.7;0.0;0.0
05;2021-01-25;295;0;0;2431;8;0;2.0;0.0;0.0
05;2021-01-26;452;1;0;2883;9;0;2.3;0.0;0.0
05;2021-01-27;357;5;0;3240;14;0;2.6;0.0;0.0
05;2021-01-28;347;54;0;3587;68;0;2.9;0.1;0.0
05;2021-01-29;350;88;0;3937;156;0;3.2;0.1;0.0
05;2021-01-30;95;8;0;4032;164;0;3.3;0.1;0.0
05;2021-01-31;3;0;0;4035;164;0;3.3;0.1;0.0
05;2021-02-01;175;28;0;4210;192;0;3.4;0.2;0.0
05;2021-02-02;183;127;0;4393;319;0;3.5;0.3;0.0
05;2021-02-03;202;77;0;4595;396;0;3.7;0.3;0.0
05;2021-02-04;192;125;0;4787;521;0;3.9;0.4;0.0
05;2021-02-05;175;106;0;4962;627;0;4.0;0.5;0.0
05;2021-02-06;74;24;0;5036;651;0;4.1;0.5;0.0
05;2021-02-07;0;6;0;5036;657;0;4.1;0.5;0.0
05;2021-02-08;85;124;0;5121;781;0;4.1;0.6;0.0
05;2021-02-09;100;123;0;5221;904;0;4.2;0.7;0.0
05;2021-02-10;81;171;0;5302;1075;0;4.3;0.9;0.0
05;2021-02-11;90;138;0;5392;1213;0;4.4;1.0;0.0
05;2021-02-12;88;137;0;5480;1350;0;4.4;1.1;0.0
05;2021-02-13;77;30;0;5557;1380;0;4.5;1.1;0.0
05;2021-02-14;1;0;0;5558;1380;0;4.5;1.1;0.0
05;2021-02-15;94;187;0;5652;1567;0;4.6;1.3;0.0
05;2021-02-16;113;276;0;5765;1843;0;4.7;1.5;0.0
05;2021-02-17;133;220;0;5898;2063;0;4.8;1.7;0.0
05;2021-02-18;152;284;0;6050;2347;0;4.9;1.9;0.0
05;2021-02-19;158;299;0;6208;2646;0;5.0;2.1;0.0
05;2021-02-20;34;88;0;6242;2734;0;5.0;2.2;0.0
05;2021-02-21;0;0;0;6242;2734;0;5.0;2.2;0.0
05;2021-02-22;66;244;0;6308;2978;0;5.1;2.4;0.0
05;2021-02-23;19;222;0;6327;3200;0;5.1;2.6;0.0
05;2021-02-24;30;183;0;6357;3383;0;5.1;2.7;0.0
05;2021-02-25;75;176;0;6432;3559;0;5.2;2.9;0.0
05;2021-02-26;166;206;0;6598;3765;0;5.3;3.0;0.0
05;2021-02-27;73;156;0;6671;3921;0;5.4;3.2;0.0
05;2021-02-28;10;0;0;6681;3921;0;5.4;3.2;0.0
05;2021-03-01;98;155;0;6779;4076;0;5.5;3.3;0.0
05;2021-03-02;100;192;0;6879;4268;0;5.6;3.4;0.0
05;2021-03-03;125;218;0;7004;4486;0;5.7;3.6;0.0
05;2021-03-04;257;171;0;7261;4657;0;5.9;3.8;0.0
05;2021-03-05;560;188;0;7821;4845;0;6.3;3.9;0.0
05;2021-03-06;654;60;0;8475;4905;0;6.8;4.0;0.0
05;2021-03-07;482;24;0;8957;4929;0;7.2;4.0;0.0
05;2021-03-08;518;137;0;9475;5066;0;7.7;4.1;0.0
05;2021-03-09;516;153;0;9991;5219;0;8.1;4.2;0.0
05;2021-03-10;508;143;0;10499;5362;0;8.5;4.3;0.0
05;2021-03-11;372;134;0;10871;5496;0;8.8;4.4;0.0
05;2021-03-12;450;93;0;11321;5589;0;9.1;4.5;0.0
05;2021-03-13;766;101;0;12087;5690;0;9.8;4.6;0.0
05;2021-03-14;645;12;0;12732;5702;0;10.3;4.6;0.0
05;2021-03-15;339;119;0;13071;5821;0;10.6;4.7;0.0
05;2021-03-16;154;144;0;13225;5965;0;10.7;4.8;0.0
05;2021-03-17;260;126;0;13485;6091;0;10.9;4.9;0.0
05;2021-03-18;352;44;0;13837;6135;0;11.2;5.0;0.0
05;2021-03-19;448;60;0;14285;6195;0;11.5;5.0;0.0
05;2021-03-20;172;34;0;14457;6229;0;11.7;5.0;0.0
05;2021-03-21;1;0;0;14458;6229;0;11.7;5.0;0.0
05;2021-03-22;697;51;0;15155;6280;0;12.2;5.1;0.0
05;2021-03-23;772;22;0;15927;6302;0;12.9;5.1;0.0
05;2021-03-24;770;90;0;16697;6392;0;13.5;5.2;0.0
05;2021-03-25;874;75;0;17571;6467;0;14.2;5.2;0.0
05;2021-03-26;997;56;0;18568;6523;0;15.0;5.3;0.0
05;2021-03-27;457;41;0;19025;6564;0;15.4;5.3;0.0
05;2021-03-28;19;0;0;19044;6564;0;15.4;5.3;0.0
05;2021-03-29;857;62;0;19901;6626;0;16.1;5.4;0.0
05;2021-03-30;1083;87;0;20984;6713;0;16.9;5.4;0.0
05;2021-03-31;773;256;0;21757;6969;0;17.6;5.6;0.0
05;2021-04-01;845;241;0;22602;7210;0;18.3;5.8;0.0
05;2021-04-02;631;370;0;23233;7580;0;18.8;6.1;0.0
05;2021-04-03;508;182;0;23741;7762;0;19.2;6.3;0.0
05;2021-04-04;314;61;0;24055;7823;0;19.4;6.3;0.0
05;2021-04-05;133;12;0;24188;7835;0;19.5;6.3;0.0
05;2021-04-06;600;266;0;24788;8101;0;20.0;6.5;0.0
05;2021-04-07;761;326;0;25549;8427;0;20.6;6.8;0.0
05;2021-04-08;690;339;0;26239;8766;0;21.2;7.1;0.0
05;2021-04-09;834;406;0;27073;9172;0;21.9;7.4;0.0
05;2021-04-10;665;382;0;27738;9554;0;22.4;7.7;0.0
05;2021-04-11;188;161;0;27926;9715;0;22.6;7.8;0.0
05;2021-04-12;681;259;0;28607;9974;0;23.1;8.1;0.0
05;2021-04-13;848;254;0;29455;10228;0;23.8;8.3;0.0
05;2021-04-14;647;324;0;30102;10552;0;24.3;8.5;0.0
05;2021-04-15;729;370;0;30831;10922;0;24.9;8.8;0.0
05;2021-04-16;721;404;0;31552;11326;0;25.5;9.1;0.0
05;2021-04-17;607;234;0;32159;11560;0;26.0;9.3;0.0
05;2021-04-18;293;22;0;32452;11582;0;26.2;9.4;0.0
05;2021-04-19;330;503;0;32782;12085;0;26.5;9.8;0.0
05;2021-04-20;461;617;0;33243;12702;0;26.8;10.3;0.0
05;2021-04-21;467;609;0;33710;13311;0;27.2;10.7;0.0
05;2021-04-22;397;544;0;34107;13855;0;27.5;11.2;0.0
05;2021-04-23;514;644;0;34621;14499;0;28.0;11.7;0.0
05;2021-04-24;315;372;0;34936;14871;0;28.2;12.0;0.0
05;2021-04-25;269;31;0;35205;14902;0;28.4;12.0;0.0
05;2021-04-26;351;666;0;35556;15568;0;28.7;12.6;0.0
05;2021-04-27;636;702;0;36192;16270;0;29.2;13.1;0.0
05;2021-04-28;463;685;0;36655;16955;0;29.6;13.7;0.0
05;2021-04-29;686;693;0;37341;17648;0;30.2;14.3;0.0
05;2021-04-30;528;703;0;37869;18351;0;30.6;14.8;0.0
05;2021-05-01;150;92;0;38019;18443;0;30.7;14.9;0.0
05;2021-05-02;260;104;0;38279;18547;0;30.9;15.0;0.0
05;2021-05-03;453;456;0;38732;19003;0;31.3;15.3;0.0
05;2021-05-04;395;490;0;39127;19493;0;31.6;15.7;0.0
05;2021-05-05;486;645;0;39613;20138;0;32.0;16.3;0.0
05;2021-05-06;646;699;0;40259;20837;0;32.5;16.8;0.0
05;2021-05-07;581;753;0;40840;21590;0;33.0;17.4;0.0
05;2021-05-08;476;175;0;41316;21765;0;33.4;17.6;0.0
05;2021-05-09;207;62;0;41523;21827;0;33.5;17.6;0.0
05;2021-05-10;527;675;0;42050;22502;0;34.0;18.2;0.0
05;2021-05-11;656;896;0;42706;23398;0;34.5;18.9;0.0
05;2021-05-12;658;701;0;43364;24099;0;35.0;19.5;0.0
05;2021-05-13;891;111;0;44255;24210;0;35.7;19.6;0.0
05;2021-05-14;735;473;0;44990;24683;0;36.3;19.9;0.0
05;2021-05-15;976;314;0;45966;24997;0;37.1;20.2;0.0
05;2021-05-16;226;58;0;46192;25055;0;37.3;20.2;0.0
05;2021-05-17;499;411;0;46691;25466;0;37.7;20.6;0.0
05;2021-05-18;510;398;0;47201;25864;0;38.1;20.9;0.0
05;2021-05-19;700;449;0;47901;26313;0;38.7;21.3;0.0
05;2021-05-20;765;451;0;48666;26764;0;39.3;21.6;0.0
05;2021-05-21;689;513;0;49355;27277;0;39.9;22.0;0.0
05;2021-05-22;580;226;0;49935;27503;0;40.3;22.2;0.0
05;2021-05-23;278;59;0;50213;27562;0;40.6;22.3;0.0
05;2021-05-24;494;153;0;50707;27715;0;41.0;22.4;0.0
05;2021-05-25;553;483;0;51260;28198;0;41.4;22.8;0.0
05;2021-05-26;702;369;0;51962;28567;0;42.0;23.1;0.0
05;2021-05-27;803;558;0;52765;29125;0;42.6;23.5;0.0
05;2021-05-28;663;681;0;53428;29806;0;43.1;24.1;0.0
05;2021-05-29;511;506;0;53939;30312;0;43.6;24.5;0.0
05;2021-05-30;200;80;0;54139;30392;0;43.7;24.5;0.0
05;2021-05-31;559;493;0;54698;30885;0;44.2;24.9;0.0
05;2021-06-01;579;582;0;55277;31467;0;44.6;25.4;0.0
05;2021-06-02;657;668;0;55934;32135;0;45.2;26.0;0.0
05;2021-06-03;719;645;0;56653;32780;0;45.8;26.5;0.0
05;2021-06-04;958;791;0;57611;33571;0;46.5;27.1;0.0
05;2021-06-05;768;474;0;58379;34045;0;47.1;27.5;0.0
05;2021-06-06;194;84;0;58573;34129;0;47.3;27.6;0.0
05;2021-06-07;561;812;0;59134;34941;0;47.8;28.2;0.0
05;2021-06-08;653;641;0;59787;35582;0;48.3;28.7;0.0
05;2021-06-09;625;748;0;60412;36330;0;48.8;29.3;0.0
05;2021-06-10;557;697;0;60969;37027;0;49.2;29.9;0.0
05;2021-06-11;723;721;0;61692;37748;0;49.8;30.5;0.0
05;2021-06-12;552;464;0;62244;38212;0;50.3;30.9;0.0
05;2021-06-13;109;96;0;62353;38308;0;50.4;30.9;0.0
05;2021-06-14;359;631;0;62712;38939;0;50.6;31.4;0.0
05;2021-06-15;521;869;0;63233;39808;0;51.1;32.1;0.0
05;2021-06-16;429;666;0;63662;40474;0;51.4;32.7;0.0
05;2021-06-17;364;782;0;64026;41256;0;51.7;33.3;0.0
05;2021-06-18;397;724;0;64423;41980;0;52.0;33.9;0.0
05;2021-06-19;363;572;0;64786;42552;0;52.3;34.4;0.0
05;2021-06-20;54;89;0;64840;42641;0;52.4;34.4;0.0
05;2021-06-21;292;639;0;65132;43280;0;52.6;35.0;0.0
05;2021-06-22;316;791;0;65448;44071;0;52.9;35.6;0.0
05;2021-06-23;341;742;0;65789;44813;0;53.1;36.2;0.0
05;2021-06-24;380;960;0;66169;45773;0;53.4;37.0;0.0
05;2021-06-25;200;841;0;66369;46614;0;53.6;37.6;0.0
05;2021-06-26;251;1011;0;66620;47625;0;53.8;38.5;0.0
05;2021-06-27;111;162;0;66731;47787;0;53.9;38.6;0.0
05;2021-06-28;230;746;0;66961;48533;0;54.1;39.2;0.0
05;2021-06-29;227;756;0;67188;49289;0;54.3;39.8;0.0
05;2021-06-30;329;772;0;67517;50061;0;54.5;40.4;0.0
05;2021-07-01;362;742;0;67879;50803;0;54.8;41.0;0.0
05;2021-07-02;364;870;0;68243;51673;0;55.1;41.7;0.0
05;2021-07-03;269;699;0;68512;52372;0;55.3;42.3;0.0
05;2021-07-04;146;149;0;68658;52521;0;55.4;42.4;0.0
05;2021-07-05;236;723;0;68894;53244;0;55.6;43.0;0.0
05;2021-07-06;314;795;0;69208;54039;0;55.9;43.6;0.0
05;2021-07-07;354;742;0;69562;54781;0;56.2;44.2;0.0
05;2021-07-08;386;786;0;69948;55567;0;56.5;44.9;0.0
05;2021-07-09;370;931;0;70318;56498;0;56.8;45.6;0.0
05;2021-07-10;262;643;0;70580;57141;0;57.0;46.1;0.0
05;2021-07-11;148;120;0;70728;57261;0;57.1;46.2;0.0
05;2021-07-12;336;921;0;71064;58182;0;57.4;47.0;0.0
05;2021-07-13;421;789;0;71485;58971;0;57.7;47.6;0.0
05;2021-07-14;611;249;0;72096;59220;0;58.2;47.8;0.0
05;2021-07-15;649;920;0;72745;60140;0;58.7;48.6;0.0
05;2021-07-16;871;1297;0;73616;61437;0;59.5;49.6;0.0
05;2021-07-17;533;1133;0;74149;62570;0;59.9;50.5;0.0
05;2021-07-18;243;126;0;74392;62696;0;60.1;50.6;0.0
05;2021-07-19;462;697;0;74854;63393;0;60.5;51.2;0.0
05;2021-07-20;635;712;0;75489;64105;0;61.0;51.8;0.0
05;2021-07-21;743;743;0;76232;64848;0;61.6;52.4;0.0
05;2021-07-22;741;787;0;76973;65635;0;62.2;53.0;0.0
05;2021-07-23;1201;1032;0;78174;66667;0;63.1;53.8;0.0
05;2021-07-24;700;677;0;78874;67344;0;63.7;54.4;0.0
05;2021-07-25;252;121;0;79126;67465;0;63.9;54.5;0.0
05;2021-07-26;593;501;0;79719;67966;0;64.4;54.9;0.0
05;2021-07-27;898;574;0;80617;68540;0;65.1;55.4;0.0
05;2021-07-28;1214;577;0;81831;69117;0;66.1;55.8;0.0
05;2021-07-29;1090;583;0;82921;69700;0;67.0;56.3;0.0
05;2021-07-30;825;527;0;83746;70227;0;67.6;56.7;0.0
05;2021-07-31;632;428;0;84378;70655;0;68.1;57.1;0.0
05;2021-08-01;164;146;0;84542;70801;0;68.3;57.2;0.0
05;2021-08-02;657;380;0;85199;71181;0;68.8;57.5;0.0
05;2021-08-03;671;483;0;85870;71664;0;69.3;57.9;0.0
05;2021-08-04;754;577;0;86624;72241;0;70.0;58.3;0.0
05;2021-08-05;816;577;0;87440;72818;0;70.6;58.8;0.0
05;2021-08-06;722;650;0;88162;73468;0;71.2;59.3;0.0
05;2021-08-07;492;467;0;88654;73935;0;71.6;59.7;0.0
05;2021-08-08;175;212;0;88829;74147;0;71.7;59.9;0.0
05;2021-08-09;589;637;0;89418;74784;0;72.2;60.4;0.0
05;2021-08-10;561;531;0;89979;75315;0;72.7;60.8;0.0
05;2021-08-11;582;619;0;90561;75934;0;73.1;61.3;0.0
05;2021-08-12;639;577;0;91200;76511;0;73.7;61.8;0.0
05;2021-08-13;519;704;0;91719;77215;0;74.1;62.4;0.0
05;2021-08-14;327;598;0;92046;77813;0;74.3;62.8;0.0
05;2021-08-15;145;165;0;92191;77978;0;74.5;63.0;0.0
05;2021-08-16;378;805;0;92569;78783;0;74.8;63.6;0.0
05;2021-08-17;364;714;0;92933;79497;0;75.1;64.2;0.0
05;2021-08-18;374;796;0;93307;80293;0;75.4;64.8;0.0
05;2021-08-19;420;773;0;93727;81066;0;75.7;65.5;0.0
05;2021-08-20;403;905;0;94130;81971;0;76.0;66.2;0.0
05;2021-08-21;278;659;0;94408;82630;0;76.2;66.7;0.0
05;2021-08-22;102;224;0;94510;82854;0;76.3;66.9;0.0
05;2021-08-23;280;697;0;94790;83551;0;76.6;67.5;0.0
05;2021-08-24;347;636;0;95137;84187;0;76.8;68.0;0.0
05;2021-08-25;370;792;0;95507;84979;0;77.1;68.6;0.0
05;2021-08-26;272;723;0;95779;85702;0;77.4;69.2;0.0
05;2021-08-27;296;811;0;96075;86513;0;77.6;69.9;0.0
05;2021-08-28;211;551;0;96286;87064;0;77.8;70.3;0.0
05;2021-08-29;60;231;0;96346;87295;0;77.8;70.5;0.0
05;2021-08-30;231;695;20;96577;87990;20;78.0;71.1;0.0
05;2021-08-31;245;647;20;96822;88637;40;78.2;71.6;0.0
05;2021-09-01;289;545;69;97111;89182;109;78.4;72.0;0.1
05;2021-09-02;251;568;84;97362;89750;193;78.6;72.5;0.2
05;2021-09-03;233;501;76;97595;90251;269;78.8;72.9;0.2
05;2021-09-04;189;530;52;97784;90781;321;79.0;73.3;0.3
05;2021-09-05;54;147;19;97838;90928;340;79.0;73.4;0.3
05;2021-09-06;155;284;88;97993;91212;428;79.1;73.7;0.3
05;2021-09-07;196;441;107;98189;91653;535;79.3;74.0;0.4
05;2021-09-08;190;487;66;98379;92140;601;79.5;74.4;0.5
05;2021-09-09;179;400;81;98558;92540;682;79.6;74.7;0.6
05;2021-09-10;182;313;113;98740;92853;795;79.7;75.0;0.6
05;2021-09-11;131;409;17;98871;93262;812;79.8;75.3;0.7
05;2021-09-12;34;98;2;98905;93360;814;79.9;75.4;0.7
05;2021-09-13;155;269;131;99060;93629;945;80.0;75.6;0.8
05;2021-09-14;227;279;115;99287;93908;1060;80.2;75.8;0.9
05;2021-09-15;180;363;173;99467;94271;1233;80.3;76.1;1.0
05;2021-09-16;171;249;140;99638;94520;1373;80.5;76.3;1.1
05;2021-09-17;138;308;135;99776;94828;1508;80.6;76.6;1.2
05;2021-09-18;99;324;61;99875;95152;1569;80.7;76.8;1.3
05;2021-09-19;14;36;12;99889;95188;1581;80.7;76.9;1.3
05;2021-09-20;65;163;87;99954;95351;1668;80.7;77.0;1.3
05;2021-09-21;84;212;95;100038;95563;1763;80.8;77.2;1.4
05;2021-09-22;108;264;72;100146;95827;1835;80.9;77.4;1.5
05;2021-09-23;98;227;112;100244;96054;1947;81.0;77.6;1.6
05;2021-09-24;93;267;101;100337;96321;2048;81.0;77.8;1.7
05;2021-09-25;87;221;30;100424;96542;2078;81.1;78.0;1.7
05;2021-09-26;13;30;15;100437;96572;2093;81.1;78.0;1.7
05;2021-09-27;63;140;66;100500;96712;2159;81.2;78.1;1.7
05;2021-09-28;68;152;80;100568;96864;2239;81.2;78.2;1.8
05;2021-09-29;88;189;76;100656;97053;2315;81.3;78.4;1.9
05;2021-09-30;62;109;163;100718;97162;2478;81.3;78.5;2.0
05;2021-10-01;180;225;149;100898;97387;2627;81.5;78.6;2.1
05;2021-10-02;85;157;65;100983;97544;2692;81.6;78.8;2.2
05;2021-10-03;18;32;15;101001;97576;2707;81.6;78.8;2.2
05;2021-10-04;94;148;116;101095;97724;2823;81.6;78.9;2.3
05;2021-10-05;77;182;128;101172;97906;2951;81.7;79.1;2.4
05;2021-10-06;91;159;218;101263;98065;3169;81.8;79.2;2.6
05;2021-10-07;68;122;136;101331;98187;3305;81.8;79.3;2.7
05;2021-10-08;128;170;147;101459;98357;3452;81.9;79.4;2.8
05;2021-10-09;66;157;120;101525;98514;3572;82.0;79.6;2.9
05;2021-10-10;14;24;3;101539;98538;3575;82.0;79.6;2.9
05;2021-10-11;64;99;214;101603;98637;3789;82.1;79.7;3.1
05;2021-10-12;59;113;119;101662;98750;3908;82.1;79.8;3.2
05;2021-10-13;82;137;180;101744;98887;4088;82.2;79.9;3.3
05;2021-10-14;65;107;138;101809;98994;4226;82.2;79.9;3.4
05;2021-10-15;58;103;112;101867;99097;4338;82.3;80.0;3.5
05;2021-10-16;80;153;141;101947;99250;4479;82.3;80.2;3.6
05;2021-10-17;8;13;17;101955;99263;4496;82.3;80.2;3.6
05;2021-10-18;48;96;270;102003;99359;4766;82.4;80.2;3.8
05;2021-10-19;52;96;236;102055;99455;5002;82.4;80.3;4.0
05;2021-10-20;62;116;391;102117;99571;5393;82.5;80.4;4.4
05;2021-10-21;47;72;233;102164;99643;5626;82.5;80.5;4.5
05;2021-10-22;45;87;145;102209;99730;5771;82.5;80.5;4.7
05;2021-10-23;85;97;213;102294;99827;5984;82.6;80.6;4.8
05;2021-10-24;12;16;38;102306;99843;6022;82.6;80.6;4.9
05;2021-10-25;57;97;247;102363;99940;6269;82.7;80.7;5.1
05;2021-10-26;44;48;245;102407;99988;6514;82.7;80.8;5.3
05;2021-10-27;82;98;435;102489;100086;6949;82.8;80.8;5.6
05;2021-10-28;42;51;247;102531;100137;7196;82.8;80.9;5.8
05;2021-10-29;55;71;259;102586;100208;7455;82.8;80.9;6.0
05;2021-10-30;59;90;274;102645;100298;7729;82.9;81.0;6.2
05;2021-10-31;10;10;57;102655;100308;7786;82.9;81.0;6.3
05;2021-11-01;15;13;19;102670;100321;7805;82.9;81.0;6.3
05;2021-11-02;80;82;284;102750;100403;8089;83.0;81.1;6.5
05;2021-11-03;66;69;297;102816;100472;8386;83.0;81.1;6.8
05;2021-11-04;33;49;230;102849;100521;8616;83.1;81.2;7.0
05;2021-11-05;72;81;328;102921;100602;8944;83.1;81.2;7.2
05;2021-11-06;38;93;286;102959;100695;9230;83.1;81.3;7.5
05;2021-11-07;17;9;36;102976;100704;9266;83.2;81.3;7.5
05;2021-11-08;49;59;297;103025;100763;9563;83.2;81.4;7.7
05;2021-11-09;55;61;491;103080;100824;10054;83.2;81.4;8.1
05;2021-11-10;93;103;813;103173;100927;10867;83.3;81.5;8.8
05;2021-11-11;16;17;106;103189;100944;10973;83.3;81.5;8.9
05;2021-11-12;54;72;326;103243;101016;11299;83.4;81.6;9.1
05;2021-11-13;57;87;352;103300;101103;11651;83.4;81.7;9.4
05;2021-11-14;17;21;55;103317;101124;11706;83.4;81.7;9.5
05;2021-11-15;41;56;382;103358;101180;12088;83.5;81.7;9.8
05;2021-11-16;86;61;632;103444;101241;12720;83.5;81.8;10.3
05;2021-11-17;65;83;477;103509;101324;13197;83.6;81.8;10.7
05;2021-11-18;76;43;428;103585;101367;13625;83.7;81.9;11.0
05;2021-11-19;64;59;505;103649;101426;14130;83.7;81.9;11.4
05;2021-11-20;87;78;428;103736;101504;14558;83.8;82.0;11.8
05;2021-11-21;13;12;53;103749;101516;14611;83.8;82.0;11.8
05;2021-11-22;68;54;387;103817;101570;14998;83.8;82.0;12.1
05;2021-11-23;106;68;727;103923;101638;15725;83.9;82.1;12.7
05;2021-11-24;61;72;562;103984;101710;16287;84.0;82.1;13.2
05;2021-11-25;71;70;570;104055;101780;16857;84.0;82.2;13.6
05;2021-11-26;101;70;691;104156;101850;17548;84.1;82.3;14.2
05;2021-11-27;86;67;777;104242;101917;18325;84.2;82.3;14.8
05;2021-11-28;14;29;169;104256;101946;18494;84.2;82.3;14.9
05;2021-11-29;86;66;791;104342;102012;19285;84.3;82.4;15.6
05;2021-11-30;117;75;1322;104459;102087;20607;84.4;82.4;16.6
05;2021-12-01;114;119;1573;104573;102206;22180;84.5;82.5;17.9
05;2021-12-02;89;70;1115;104662;102276;23295;84.5;82.6;18.8
05;2021-12-03;90;98;1295;104752;102374;24590;84.6;82.7;19.9
05;2021-12-04;87;85;1040;104839;102459;25630;84.7;82.7;20.7
05;2021-12-05;15;23;308;104854;102482;25938;84.7;82.8;20.9
05;2021-12-06;52;60;802;104906;102542;26740;84.7;82.8;21.6
05;2021-12-07;120;107;1812;105026;102649;28552;84.8;82.9;23.1
05;2021-12-08;82;95;1309;105108;102744;29861;84.9;83.0;24.1
05;2021-12-09;88;94;1551;105196;102838;31412;85.0;83.1;25.4
05;2021-12-10;99;82;1359;105295;102920;32771;85.0;83.1;26.5
05;2021-12-11;100;100;1047;105395;103020;33818;85.1;83.2;27.3
05;2021-12-12;18;12;219;105413;103032;34037;85.1;83.2;27.5
05;2021-12-13;69;92;1089;105482;103124;35126;85.2;83.3;28.4
05;2021-12-14;71;138;1825;105553;103262;36951;85.2;83.4;29.8
05;2021-12-15;113;98;1691;105666;103360;38642;85.3;83.5;31.2
05;2021-12-16;71;90;1528;105737;103450;40170;85.4;83.5;32.4
05;2021-12-17;76;104;1418;105813;103554;41588;85.5;83.6;33.6
05;2021-12-18;80;98;1039;105893;103652;42627;85.5;83.7;34.4
05;2021-12-19;23;24;301;105916;103676;42928;85.5;83.7;34.7
06;2020-12-27;5;0;0;5;0;0;0.0;0.0;0.0
06;2020-12-28;4;0;0;9;0;0;0.0;0.0;0.0
06;2020-12-29;0;0;0;9;0;0;0.0;0.0;0.0
06;2020-12-30;3;0;0;12;0;0;0.0;0.0;0.0
06;2020-12-31;23;0;0;35;0;0;0.0;0.0;0.0
06;2021-01-01;12;0;0;47;0;0;0.0;0.0;0.0
06;2021-01-02;8;0;0;55;0;0;0.0;0.0;0.0
06;2021-01-03;5;0;0;60;0;0;0.0;0.0;0.0
06;2021-01-04;131;1;0;191;1;0;0.0;0.0;0.0
06;2021-01-05;178;2;0;369;3;0;0.0;0.0;0.0
06;2021-01-06;222;1;0;591;4;0;0.1;0.0;0.0
06;2021-01-07;506;0;0;1097;4;0;0.1;0.0;0.0
06;2021-01-08;678;3;0;1775;7;0;0.2;0.0;0.0
06;2021-01-09;369;4;0;2144;11;0;0.2;0.0;0.0
06;2021-01-10;69;0;0;2213;11;0;0.2;0.0;0.0
06;2021-01-11;1023;6;0;3236;17;0;0.3;0.0;0.0
06;2021-01-12;2130;11;0;5366;28;0;0.6;0.0;0.0
06;2021-01-13;1712;12;0;7078;40;0;0.7;0.0;0.0
06;2021-01-14;2030;23;0;9108;63;0;1.0;0.0;0.0
06;2021-01-15;1666;5;0;10774;68;0;1.1;0.0;0.0
06;2021-01-16;960;7;0;11734;75;0;1.2;0.0;0.0
06;2021-01-17;211;0;0;11945;75;0;1.3;0.0;0.0
06;2021-01-18;2193;22;0;14138;97;0;1.5;0.0;0.0
06;2021-01-19;2664;28;0;16802;125;0;1.8;0.0;0.0
06;2021-01-20;3245;17;0;20047;142;0;2.1;0.0;0.0
06;2021-01-21;2959;32;0;23006;174;0;2.4;0.0;0.0
06;2021-01-22;2959;31;0;25965;205;0;2.7;0.0;0.0
06;2021-01-23;1241;3;0;27206;208;0;2.9;0.0;0.0
06;2021-01-24;33;0;0;27239;208;0;2.9;0.0;0.0
06;2021-01-25;2109;15;0;29348;223;0;3.1;0.0;0.0
06;2021-01-26;3151;49;0;32499;272;0;3.4;0.0;0.0
06;2021-01-27;2462;116;0;34961;388;0;3.7;0.0;0.0
06;2021-01-28;2810;226;0;37771;614;0;4.0;0.1;0.0
06;2021-01-29;2532;327;0;40303;941;0;4.3;0.1;0.0
06;2021-01-30;725;55;0;41028;996;0;4.3;0.1;0.0
06;2021-01-31;11;3;0;41039;999;0;4.3;0.1;0.0
06;2021-02-01;1136;455;0;42175;1454;0;4.5;0.2;0.0
06;2021-02-02;1559;426;0;43734;1880;0;4.6;0.2;0.0
06;2021-02-03;382;154;0;44116;2034;0;4.7;0.2;0.0
06;2021-02-04;810;884;0;44926;2918;0;4.8;0.3;0.0
06;2021-02-05;1075;1099;0;46001;4017;0;4.9;0.4;0.0
06;2021-02-06;185;438;0;46186;4455;0;4.9;0.5;0.0
06;2021-02-07;8;50;0;46194;4505;0;4.9;0.5;0.0
06;2021-02-08;542;1030;0;46736;5535;0;4.9;0.6;0.0
06;2021-02-09;342;766;0;47078;6301;0;5.0;0.7;0.0
06;2021-02-10;418;698;0;47496;6999;0;5.0;0.7;0.0
06;2021-02-11;496;1076;0;47992;8075;0;5.1;0.9;0.0
06;2021-02-12;643;1286;0;48635;9361;0;5.1;1.0;0.0
06;2021-02-13;199;505;0;48834;9866;0;5.2;1.0;0.0
06;2021-02-14;11;5;0;48845;9871;0;5.2;1.0;0.0
06;2021-02-15;438;1237;0;49283;11108;0;5.2;1.2;0.0
06;2021-02-16;844;1954;0;50127;13062;0;5.3;1.4;0.0
06;2021-02-17;809;2068;0;50936;15130;0;5.4;1.6;0.0
06;2021-02-18;1836;2663;0;52772;17793;0;5.6;1.9;0.0
06;2021-02-19;1765;2087;0;54537;19880;0;5.8;2.1;0.0
06;2021-02-20;350;484;0;54887;20364;0;5.8;2.2;0.0
06;2021-02-21;18;60;0;54905;20424;0;5.8;2.2;0.0
06;2021-02-22;1026;1605;0;55931;22029;0;5.9;2.3;0.0
06;2021-02-23;1654;1551;0;57585;23580;0;6.1;2.5;0.0
06;2021-02-24;2004;1298;0;59589;24878;0;6.3;2.6;0.0
06;2021-02-25;3622;1677;0;63211;26555;0;6.7;2.8;0.0
06;2021-02-26;3223;1613;0;66434;28168;0;7.0;3.0;0.0
06;2021-02-27;1343;323;0;67777;28491;0;7.2;3.0;0.0
06;2021-02-28;91;18;0;67868;28509;0;7.2;3.0;0.0
06;2021-03-01;2325;848;0;70193;29357;0;7.4;3.1;0.0
06;2021-03-02;2362;978;0;72555;30335;0;7.7;3.2;0.0
06;2021-03-03;2732;625;0;75287;30960;0;8.0;3.3;0.0
06;2021-03-04;4421;648;0;79708;31608;0;8.4;3.3;0.0
06;2021-03-05;3761;1041;0;83469;32649;0;8.8;3.5;0.0
06;2021-03-06;11100;389;0;94569;33038;0;10.0;3.5;0.0
06;2021-03-07;9494;331;0;104063;33369;0;11.0;3.5;0.0
06;2021-03-08;3836;1190;0;107899;34559;0;11.4;3.7;0.0
06;2021-03-09;4730;946;0;112629;35505;0;11.9;3.8;0.0
06;2021-03-10;4491;909;0;117120;36414;0;12.4;3.9;0.0
06;2021-03-11;6433;947;0;123553;37361;0;13.1;4.0;0.0
06;2021-03-12;6539;1020;0;130092;38381;0;13.8;4.1;0.0
06;2021-03-13;10587;385;0;140679;38766;0;14.9;4.1;0.0
06;2021-03-14;501;60;0;141180;38826;0;14.9;4.1;0.0
06;2021-03-15;4566;761;0;145746;39587;0;15.4;4.2;0.0
06;2021-03-16;3587;1050;0;149333;40637;0;15.8;4.3;0.0
06;2021-03-17;5817;1837;0;155150;42474;0;16.4;4.5;0.0
06;2021-03-18;4917;1786;0;160067;44260;0;16.9;4.7;0.0
06;2021-03-19;6451;1966;0;166518;46226;0;17.6;4.9;0.0
06;2021-03-20;2267;538;0;168785;46764;0;17.9;4.9;0.0
06;2021-03-21;381;24;0;169166;46788;0;17.9;5.0;0.0
06;2021-03-22;3729;698;0;172895;47486;0;18.3;5.0;0.0
06;2021-03-23;5642;1185;0;178537;48671;0;18.9;5.2;0.0
06;2021-03-24;4051;3200;0;182588;51871;0;19.3;5.5;0.0
06;2021-03-25;5632;3144;0;188220;55015;0;19.9;5.8;0.0
06;2021-03-26;5974;1941;0;194194;56956;0;20.6;6.0;0.0
06;2021-03-27;1957;370;0;196151;57326;0;20.8;6.1;0.0
06;2021-03-28;201;8;0;196352;57334;0;20.8;6.1;0.0
06;2021-03-29;3012;2019;0;199364;59353;0;21.1;6.3;0.0
06;2021-03-30;4951;2469;0;204315;61822;0;21.6;6.5;0.0
06;2021-03-31;7510;1697;0;211825;63519;0;22.4;6.7;0.0
06;2021-04-01;7237;2432;0;219062;65951;0;23.2;7.0;0.0
06;2021-04-02;6689;2597;0;225751;68548;0;23.9;7.3;0.0
06;2021-04-03;2535;1323;0;228286;69871;0;24.2;7.4;0.0
06;2021-04-04;270;540;0;228556;70411;0;24.2;7.5;0.0
06;2021-04-05;1332;675;0;229888;71086;0;24.3;7.5;0.0
06;2021-04-06;6201;3259;0;236089;74345;0;25.0;7.9;0.0
06;2021-04-07;5787;3811;0;241876;78156;0;25.6;8.3;0.0
06;2021-04-08;5411;5498;0;247287;83654;0;26.2;8.9;0.0
06;2021-04-09;8766;5657;0;256053;89311;0;27.1;9.5;0.0
06;2021-04-10;2250;2694;0;258303;92005;0;27.3;9.7;0.0
06;2021-04-11;160;97;0;258463;92102;0;27.4;9.7;0.0
06;2021-04-12;4008;3394;0;262471;95496;0;27.8;10.1;0.0
06;2021-04-13;5934;4958;0;268405;100454;0;28.4;10.6;0.0
06;2021-04-14;5002;4227;0;273407;104681;0;28.9;11.1;0.0
06;2021-04-15;5085;4223;0;278492;108904;0;29.5;11.5;0.0
06;2021-04-16;6388;5006;0;284880;113910;0;30.1;12.1;0.0
06;2021-04-17;2563;2927;0;287443;116837;0;30.4;12.4;0.0
06;2021-04-18;225;238;0;287668;117075;0;30.4;12.4;0.0
06;2021-04-19;4801;3883;0;292469;120958;0;31.0;12.8;0.0
06;2021-04-20;4997;4680;0;297466;125638;0;31.5;13.3;0.0
06;2021-04-21;7239;4007;0;304705;129645;0;32.2;13.7;0.0
06;2021-04-22;7421;4076;0;312126;133721;0;33.0;14.2;0.0
06;2021-04-23;7472;4021;0;319598;137742;0;33.8;14.6;0.0
06;2021-04-24;2197;1474;0;321795;139216;0;34.1;14.7;0.0
06;2021-04-25;109;42;0;321904;139258;0;34.1;14.7;0.0
06;2021-04-26;3683;2239;0;325587;141497;0;34.5;15.0;0.0
06;2021-04-27;4156;3926;0;329743;145423;0;34.9;15.4;0.0
06;2021-04-28;3746;4335;0;333489;149758;0;35.3;15.8;0.0
06;2021-04-29;5384;5262;0;338873;155020;0;35.9;16.4;0.0
06;2021-04-30;5892;4931;0;344765;159951;0;36.5;16.9;0.0
06;2021-05-01;3238;794;0;348003;160745;0;36.8;17.0;0.0
06;2021-05-02;473;170;0;348476;160915;0;36.9;17.0;0.0
06;2021-05-03;6046;3386;0;354522;164301;0;37.5;17.4;0.0
06;2021-05-04;5011;5098;0;359533;169399;0;38.0;17.9;0.0
06;2021-05-05;4066;3769;0;363599;173168;0;38.5;18.3;0.0
06;2021-05-06;4681;4561;0;368280;177729;0;39.0;18.8;0.0
06;2021-05-07;5046;5389;0;373326;183118;0;39.5;19.4;0.0
06;2021-05-08;3911;1285;0;377237;184403;0;39.9;19.5;0.0
06;2021-05-09;216;321;0;377453;184724;0;39.9;19.5;0.0
06;2021-05-10;4252;4751;0;381705;189475;0;40.4;20.1;0.0
06;2021-05-11;4218;5228;0;385923;194703;0;40.8;20.6;0.0
06;2021-05-12;7460;4571;0;393383;199274;0;41.6;21.1;0.0
06;2021-05-13;6942;1978;0;400325;201252;0;42.4;21.3;0.0
06;2021-05-14;8763;3069;0;409088;204321;0;43.3;21.6;0.0
06;2021-05-15;7181;1983;0;416269;206304;0;44.1;21.8;0.0
06;2021-05-16;1343;264;0;417612;206568;0;44.2;21.9;0.0
06;2021-05-17;6398;3462;0;424010;210030;0;44.9;22.2;0.0
06;2021-05-18;8148;2981;0;432158;213011;0;45.7;22.5;0.0
06;2021-05-19;6468;2689;0;438626;215700;0;46.4;22.8;0.0
06;2021-05-20;6591;3346;0;445217;219046;0;47.1;23.2;0.0
06;2021-05-21;7151;3623;0;452368;222669;0;47.9;23.6;0.0
06;2021-05-22;2630;1247;0;454998;223916;0;48.1;23.7;0.0
06;2021-05-23;193;627;0;455191;224543;0;48.2;23.8;0.0
06;2021-05-24;2606;898;0;457797;225441;0;48.4;23.9;0.0
06;2021-05-25;4129;4723;0;461926;230164;0;48.9;24.4;0.0
06;2021-05-26;4521;6279;0;466447;236443;0;49.4;25.0;0.0
06;2021-05-27;4545;5945;0;470992;242388;0;49.8;25.7;0.0
06;2021-05-28;3975;6786;0;474967;249174;0;50.3;26.4;0.0
06;2021-05-29;1414;2769;0;476381;251943;0;50.4;26.7;0.0
06;2021-05-30;305;1095;0;476686;253038;0;50.4;26.8;0.0
06;2021-05-31;3554;4745;0;480240;257783;0;50.8;27.3;0.0
06;2021-06-01;4731;6824;0;484971;264607;0;51.3;28.0;0.0
06;2021-06-02;2867;7902;0;487838;272509;0;51.6;28.8;0.0
06;2021-06-03;3771;7631;0;491609;280140;0;52.0;29.6;0.0
06;2021-06-04;4547;7102;0;496156;287242;0;52.5;30.4;0.0
06;2021-06-05;2109;3174;0;498265;290416;0;52.7;30.7;0.0
06;2021-06-06;242;243;0;498507;290659;0;52.8;30.8;0.0
06;2021-06-07;3387;5036;0;501894;295695;0;53.1;31.3;0.0
06;2021-06-08;3631;4853;0;505525;300548;0;53.5;31.8;0.0
06;2021-06-09;3352;6726;0;508877;307274;0;53.9;32.5;0.0
06;2021-06-10;3945;6188;0;512822;313462;0;54.3;33.2;0.0
06;2021-06-11;3075;7509;0;515897;320971;0;54.6;34.0;0.0
06;2021-06-12;1492;3492;0;517389;324463;0;54.8;34.3;0.0
06;2021-06-13;198;433;0;517587;324896;0;54.8;34.4;0.0
06;2021-06-14;2241;7827;0;519828;332723;0;55.0;35.2;0.0
06;2021-06-15;2978;8734;0;522806;341457;0;55.3;36.1;0.0
06;2021-06-16;2820;6345;0;525626;347802;0;55.6;36.8;0.0
06;2021-06-17;3058;6528;0;528684;354330;0;55.9;37.5;0.0
06;2021-06-18;2083;5366;0;530767;359696;0;56.2;38.1;0.0
06;2021-06-19;1159;1529;0;531926;361225;0;56.3;38.2;0.0
06;2021-06-20;216;350;0;532142;361575;0;56.3;38.3;0.0
06;2021-06-21;1458;5573;0;533600;367148;0;56.5;38.9;0.0
06;2021-06-22;1929;6465;0;535529;373613;0;56.7;39.5;0.0
06;2021-06-23;1762;5685;0;537291;379298;0;56.9;40.1;0.0
06;2021-06-24;2854;7959;0;540145;387257;0;57.2;41.0;0.0
06;2021-06-25;1836;8440;0;541981;395697;0;57.4;41.9;0.0
06;2021-06-26;744;2112;0;542725;397809;0;57.4;42.1;0.0
06;2021-06-27;322;1133;0;543047;398942;0;57.5;42.2;0.0
06;2021-06-28;1993;6830;0;545040;405772;0;57.7;42.9;0.0
06;2021-06-29;2010;6625;0;547050;412397;0;57.9;43.6;0.0
06;2021-06-30;1230;6863;0;548280;419260;0;58.0;44.4;0.0
06;2021-07-01;3028;6299;0;551308;425559;0;58.3;45.0;0.0
06;2021-07-02;3552;6998;0;554860;432557;0;58.7;45.8;0.0
06;2021-07-03;1103;3966;0;555963;436523;0;58.8;46.2;0.0
06;2021-07-04;293;327;0;556256;436850;0;58.9;46.2;0.0
06;2021-07-05;3109;4356;0;559365;441206;0;59.2;46.7;0.0
06;2021-07-06;1817;4868;0;561182;446074;0;59.4;47.2;0.0
06;2021-07-07;2869;4784;0;564051;450858;0;59.7;47.7;0.0
06;2021-07-08;2936;5178;0;566987;456036;0;60.0;48.3;0.0
06;2021-07-09;3545;5106;0;570532;461142;0;60.4;48.8;0.0
06;2021-07-10;1460;1996;0;571992;463138;0;60.5;49.0;0.0
06;2021-07-11;320;342;0;572312;463480;0;60.6;49.0;0.0
06;2021-07-12;3256;5663;0;575568;469143;0;60.9;49.6;0.0
06;2021-07-13;5036;7484;0;580604;476627;0;61.4;50.4;0.0
06;2021-07-14;1008;428;0;581612;477055;0;61.5;50.5;0.0
06;2021-07-15;5626;6903;0;587238;483958;0;62.1;51.2;0.0
06;2021-07-16;6614;7848;0;593852;491806;0;62.8;52.0;0.0
06;2021-07-17;2880;4639;0;596732;496445;0;63.1;52.5;0.0
06;2021-07-18;965;4665;0;597697;501110;0;63.3;53.0;0.0
06;2021-07-19;5095;6861;0;602792;507971;0;63.8;53.8;0.0
06;2021-07-20;6429;8571;0;609221;516542;0;64.5;54.7;0.0
06;2021-07-21;6944;7132;0;616165;523674;0;65.2;55.4;0.0
06;2021-07-22;8859;6563;0;625024;530237;0;66.1;56.1;0.0
06;2021-07-23;8109;5733;0;633133;535970;0;67.0;56.7;0.0
06;2021-07-24;2916;2705;0;636049;538675;0;67.3;57.0;0.0
06;2021-07-25;875;457;0;636924;539132;0;67.4;57.1;0.0
06;2021-07-26;6386;5583;0;643310;544715;0;68.1;57.6;0.0
06;2021-07-27;7856;4742;0;651166;549457;0;68.9;58.1;0.0
06;2021-07-28;6639;4330;0;657805;553787;0;69.6;58.6;0.0
06;2021-07-29;7456;4617;0;665261;558404;0;70.4;59.1;0.0
06;2021-07-30;6911;4411;0;672172;562815;0;71.1;59.6;0.0
06;2021-07-31;3107;2489;0;675279;565304;0;71.5;59.8;0.0
06;2021-08-01;699;380;0;675978;565684;0;71.5;59.9;0.0
06;2021-08-02;5473;3645;0;681451;569329;0;72.1;60.2;0.0
06;2021-08-03;5480;4397;0;686931;573726;0;72.7;60.7;0.0
06;2021-08-04;4761;2896;0;691692;576622;0;73.2;61.0;0.0
06;2021-08-05;5356;3730;0;697048;580352;0;73.8;61.4;0.0
06;2021-08-06;4965;5095;0;702013;585447;0;74.3;62.0;0.0
06;2021-08-07;2049;2155;0;704062;587602;0;74.5;62.2;0.0
06;2021-08-08;503;634;0;704565;588236;0;74.6;62.2;0.0
06;2021-08-09;3744;4952;0;708309;593188;0;75.0;62.8;0.0
06;2021-08-10;4409;5726;0;712718;598914;0;75.4;63.4;0.0
06;2021-08-11;3591;5186;0;716309;604100;0;75.8;63.9;0.0
06;2021-08-12;3763;5651;0;720072;609751;0;76.2;64.5;0.0
06;2021-08-13;3069;5533;0;723141;615284;0;76.5;65.1;0.0
06;2021-08-14;1384;2194;0;724525;617478;0;76.7;65.3;0.0
06;2021-08-15;348;570;0;724873;618048;0;76.7;65.4;0.0
06;2021-08-16;2701;5761;0;727574;623809;0;77.0;66.0;0.0
06;2021-08-17;2982;6476;0;730556;630285;0;77.3;66.7;0.0
06;2021-08-18;2534;5491;0;733090;635776;0;77.6;67.3;0.0
06;2021-08-19;3416;6931;0;736506;642707;0;77.9;68.0;0.0
06;2021-08-20;2775;5598;0;739281;648305;0;78.2;68.6;0.0
06;2021-08-21;1475;3109;0;740756;651414;0;78.4;68.9;0.0
06;2021-08-22;320;709;0;741076;652123;0;78.4;69.0;0.0
06;2021-08-23;2079;5454;0;743155;657577;0;78.6;69.6;0.0
06;2021-08-24;2428;5497;0;745583;663074;0;78.9;70.2;0.0
06;2021-08-25;2167;4814;0;747750;667888;0;79.1;70.7;0.0
06;2021-08-26;2305;5573;0;750055;673461;0;79.4;71.3;0.0
06;2021-08-27;2289;5655;0;752344;679116;0;79.6;71.9;0.0
06;2021-08-28;1127;2515;0;753471;681631;0;79.7;72.1;0.0
06;2021-08-29;253;596;0;753724;682227;0;79.8;72.2;0.0
06;2021-08-30;1987;4537;165;755711;686764;165;80.0;72.7;0.0
06;2021-08-31;2210;5010;264;757921;691774;429;80.2;73.2;0.0
06;2021-09-01;2394;3652;523;760315;695426;952;80.5;73.6;0.1
06;2021-09-02;2109;3668;977;762424;699094;1929;80.7;74.0;0.2
06;2021-09-03;1830;3927;991;764254;703021;2920;80.9;74.4;0.3
06;2021-09-04;1175;2251;202;765429;705272;3122;81.0;74.6;0.3
06;2021-09-05;263;391;25;765692;705663;3147;81.0;74.7;0.3
06;2021-09-06;1440;2506;978;767132;708169;4125;81.2;74.9;0.4
06;2021-09-07;1389;2809;1421;768521;710978;5546;81.3;75.2;0.6
06;2021-09-08;1437;2790;1295;769958;713768;6841;81.5;75.5;0.7
06;2021-09-09;1364;2900;1280;771322;716668;8121;81.6;75.8;0.9
06;2021-09-10;1771;3022;1020;773093;719690;9141;81.8;76.2;1.0
06;2021-09-11;960;2059;178;774053;721749;9319;81.9;76.4;1.0
06;2021-09-12;128;301;15;774181;722050;9334;81.9;76.4;1.0
06;2021-09-13;1209;2251;1002;775390;724301;10336;82.1;76.6;1.1
06;2021-09-14;1384;2044;1286;776774;726345;11622;82.2;76.9;1.2
06;2021-09-15;1357;2383;1296;778131;728728;12918;82.3;77.1;1.4
06;2021-09-16;1168;2068;1892;779299;730796;14810;82.5;77.3;1.6
06;2021-09-17;1345;2534;1252;780644;733330;16062;82.6;77.6;1.7
06;2021-09-18;600;1688;225;781244;735018;16287;82.7;77.8;1.7
06;2021-09-19;82;250;21;781326;735268;16308;82.7;77.8;1.7
06;2021-09-20;806;1803;1050;782132;737071;17358;82.8;78.0;1.8
06;2021-09-21;872;2033;1638;783004;739104;18996;82.9;78.2;2.0
06;2021-09-22;928;2169;1024;783932;741273;20020;83.0;78.4;2.1
06;2021-09-23;755;1923;1081;784687;743196;21101;83.0;78.6;2.2
06;2021-09-24;819;2048;1088;785506;745244;22189;83.1;78.9;2.3
06;2021-09-25;401;1499;302;785907;746743;22491;83.2;79.0;2.4
06;2021-09-26;75;204;21;785982;746947;22512;83.2;79.0;2.4
06;2021-09-27;606;1375;1367;786588;748322;23879;83.2;79.2;2.5
06;2021-09-28;505;1350;1232;787093;749672;25111;83.3;79.3;2.7
06;2021-09-29;684;1523;777;787777;751195;25888;83.4;79.5;2.7
06;2021-09-30;660;1423;1475;788437;752618;27363;83.4;79.6;2.9
06;2021-10-01;1414;1684;1312;789851;754302;28675;83.6;79.8;3.0
06;2021-10-02;508;1134;402;790359;755436;29077;83.6;79.9;3.1
06;2021-10-03;97;168;29;790456;755604;29106;83.6;80.0;3.1
06;2021-10-04;889;963;1203;791345;756567;30309;83.7;80.1;3.2
06;2021-10-05;655;1296;1746;792000;757863;32055;83.8;80.2;3.4
06;2021-10-06;751;1419;1991;792751;759282;34046;83.9;80.4;3.6
06;2021-10-07;584;1353;1967;793335;760635;36013;84.0;80.5;3.8
06;2021-10-08;888;1567;2164;794223;762202;38177;84.0;80.7;4.0
06;2021-10-09;481;955;576;794704;763157;38753;84.1;80.8;4.1
06;2021-10-10;100;180;30;794804;763337;38783;84.1;80.8;4.1
06;2021-10-11;542;1078;1761;795346;764415;40544;84.2;80.9;4.3
06;2021-10-12;516;933;2076;795862;765348;42620;84.2;81.0;4.5
06;2021-10-13;712;1181;1807;796574;766529;44427;84.3;81.1;4.7
06;2021-10-14;619;1038;2018;797193;767567;46445;84.4;81.2;4.9
06;2021-10-15;893;1224;2169;798086;768791;48614;84.5;81.4;5.1
06;2021-10-16;500;701;612;798586;769492;49226;84.5;81.4;5.2
06;2021-10-17;67;164;47;798653;769656;49273;84.5;81.4;5.2
06;2021-10-18;493;897;2025;799146;770553;51298;84.6;81.5;5.4
06;2021-10-19;506;726;2408;799652;771279;53706;84.6;81.6;5.7
06;2021-10-20;572;895;2622;800224;772174;56328;84.7;81.7;6.0
06;2021-10-21;494;955;2445;800718;773129;58773;84.7;81.8;6.2
06;2021-10-22;667;1066;2362;801385;774195;61135;84.8;81.9;6.5
06;2021-10-23;376;516;769;801761;774711;61904;84.8;82.0;6.6
06;2021-10-24;17;124;13;801778;774835;61917;84.8;82.0;6.6
06;2021-10-25;427;647;1797;802205;775482;63714;84.9;82.1;6.7
06;2021-10-26;426;693;2534;802631;776175;66248;84.9;82.1;7.0
06;2021-10-27;461;814;2454;803092;776989;68702;85.0;82.2;7.3
06;2021-10-28;407;628;2559;803499;777617;71261;85.0;82.3;7.5
06;2021-10-29;523;730;2338;804022;778347;73599;85.1;82.4;7.8
06;2021-10-30;287;459;857;804309;778806;74456;85.1;82.4;7.9
06;2021-10-31;36;62;51;804345;778868;74507;85.1;82.4;7.9
06;2021-11-01;133;120;28;804478;778988;74535;85.1;82.4;7.9
06;2021-11-02;439;687;2494;804917;779675;77029;85.2;82.5;8.2
06;2021-11-03;503;793;3007;805420;780468;80036;85.2;82.6;8.5
06;2021-11-04;404;636;2779;805824;781104;82815;85.3;82.7;8.8
06;2021-11-05;549;741;2584;806373;781845;85399;85.3;82.7;9.0
06;2021-11-06;325;557;1034;806698;782402;86433;85.4;82.8;9.1
06;2021-11-07;63;115;87;806761;782517;86520;85.4;82.8;9.2
06;2021-11-08;394;681;2679;807155;783198;89199;85.4;82.9;9.4
06;2021-11-09;399;620;3339;807554;783818;92538;85.5;82.9;9.8
06;2021-11-10;597;871;4194;808151;784689;96732;85.5;83.0;10.2
06;2021-11-11;78;146;225;808229;784835;96957;85.5;83.1;10.3
06;2021-11-12;513;782;3305;808742;785617;100262;85.6;83.1;10.6
06;2021-11-13;306;372;1129;809048;785989;101391;85.6;83.2;10.7
06;2021-11-14;77;91;140;809125;786080;101531;85.6;83.2;10.7
06;2021-11-15;383;655;3086;809508;786735;104617;85.7;83.3;11.1
06;2021-11-16;386;603;4332;809894;787338;108949;85.7;83.3;11.5
06;2021-11-17;523;732;3863;810417;788070;112812;85.8;83.4;11.9
06;2021-11-18;428;623;4221;810845;788693;117033;85.8;83.5;12.4
06;2021-11-19;599;817;5133;811444;789510;122166;85.9;83.5;12.9
06;2021-11-20;344;478;1609;811788;789988;123775;85.9;83.6;13.1
06;2021-11-21;57;112;126;811845;790100;123901;85.9;83.6;13.1
06;2021-11-22;427;480;3766;812272;790580;127667;86.0;83.7;13.5
06;2021-11-23;417;524;5282;812689;791104;132949;86.0;83.7;14.1
06;2021-11-24;536;698;4825;813225;791802;137774;86.1;83.8;14.6
06;2021-11-25;497;620;5771;813722;792422;143545;86.1;83.9;15.2
06;2021-11-26;578;746;7258;814300;793168;150803;86.2;83.9;16.0
06;2021-11-27;370;478;3577;814670;793646;154380;86.2;84.0;16.3
06;2021-11-28;64;119;742;814734;793765;155122;86.2;84.0;16.4
06;2021-11-29;391;544;7338;815125;794309;162460;86.3;84.1;17.2
06;2021-11-30;424;594;8564;815549;794903;171024;86.3;84.1;18.1
06;2021-12-01;611;749;10362;816160;795652;181386;86.4;84.2;19.2
06;2021-12-02;468;597;12960;816628;796249;194346;86.4;84.3;20.6
06;2021-12-03;486;817;13363;817114;797066;207709;86.5;84.3;22.0
06;2021-12-04;394;508;6356;817508;797574;214065;86.5;84.4;22.7
06;2021-12-05;119;179;1412;817627;797753;215477;86.5;84.4;22.8
06;2021-12-06;438;675;10970;818065;798428;226447;86.6;84.5;24.0
06;2021-12-07;549;683;14884;818614;799111;241331;86.6;84.6;25.5
06;2021-12-08;562;820;12486;819176;799931;253817;86.7;84.7;26.9
06;2021-12-09;580;779;13950;819756;800710;267767;86.8;84.7;28.3
06;2021-12-10;520;824;14467;820276;801534;282234;86.8;84.8;29.9
06;2021-12-11;327;512;5269;820603;802046;287503;86.8;84.9;30.4
06;2021-12-12;83;153;1256;820686;802199;288759;86.8;84.9;30.6
06;2021-12-13;425;689;11381;821111;802888;300140;86.9;85.0;31.8
06;2021-12-14;469;701;13040;821580;803589;313180;86.9;85.0;33.1
06;2021-12-15;565;788;11607;822145;804377;324787;87.0;85.1;34.4
06;2021-12-16;545;751;11943;822690;805128;336730;87.1;85.2;35.6
06;2021-12-17;617;847;12696;823307;805975;349426;87.1;85.3;37.0
06;2021-12-18;444;481;4415;823751;806456;353841;87.2;85.3;37.4
06;2021-12-19;135;191;1169;823886;806647;355010;87.2;85.4;37.6
07;2020-12-27;0;0;0;0;0;0;0.0;0.0;0.0
07;2020-12-28;0;0;0;0;0;0;0.0;0.0;0.0
07;2020-12-29;0;0;0;0;0;0;0.0;0.0;0.0
07;2020-12-30;0;0;0;0;0;0;0.0;0.0;0.0
07;2020-12-31;0;0;0;0;0;0;0.0;0.0;0.0
07;2021-01-01;5;0;0;5;0;0;0.0;0.0;0.0
07;2021-01-02;0;0;0;5;0;0;0.0;0.0;0.0
07;2021-01-03;0;0;0;5;0;0;0.0;0.0;0.0
07;2021-01-04;0;0;0;5;0;0;0.0;0.0;0.0
07;2021-01-05;0;0;0;5;0;0;0.0;0.0;0.0
07;2021-01-06;31;0;0;36;0;0;0.0;0.0;0.0
07;2021-01-07;133;1;0;169;1;0;0.1;0.0;0.0
07;2021-01-08;68;1;0;237;2;0;0.1;0.0;0.0
07;2021-01-09;14;0;0;251;2;0;0.1;0.0;0.0
07;2021-01-10;0;0;0;251;2;0;0.1;0.0;0.0
07;2021-01-11;175;1;0;426;3;0;0.1;0.0;0.0
07;2021-01-12;309;1;0;735;4;0;0.3;0.0;0.0
07;2021-01-13;308;2;0;1043;6;0;0.4;0.0;0.0
07;2021-01-14;463;0;0;1506;6;0;0.5;0.0;0.0
07;2021-01-15;235;0;0;1741;6;0;0.6;0.0;0.0
07;2021-01-16;42;0;0;1783;6;0;0.6;0.0;0.0
07;2021-01-17;3;0;0;1786;6;0;0.6;0.0;0.0
07;2021-01-18;363;3;0;2149;9;0;0.8;0.0;0.0
07;2021-01-19;796;3;0;2945;12;0;1.0;0.0;0.0
07;2021-01-20;556;4;0;3501;16;0;1.2;0.0;0.0
07;2021-01-21;493;5;0;3994;21;0;1.4;0.0;0.0
07;2021-01-22;352;3;0;4346;24;0;1.5;0.0;0.0
07;2021-01-23;153;2;0;4499;26;0;1.6;0.0;0.0
07;2021-01-24;10;0;0;4509;26;0;1.6;0.0;0.0
07;2021-01-25;232;2;0;4741;28;0;1.7;0.0;0.0
07;2021-01-26;529;4;0;5270;32;0;1.8;0.0;0.0
07;2021-01-27;574;12;0;5844;44;0;2.0;0.0;0.0
07;2021-01-28;1166;111;0;7010;155;0;2.5;0.1;0.0
07;2021-01-29;729;28;0;7739;183;0;2.7;0.1;0.0
07;2021-01-30;236;2;0;7975;185;0;2.8;0.1;0.0
07;2021-01-31;11;0;0;7986;185;0;2.8;0.1;0.0
07;2021-02-01;319;50;0;8305;235;0;2.9;0.1;0.0
07;2021-02-02;640;247;0;8945;482;0;3.1;0.2;0.0
07;2021-02-03;1059;236;0;10004;718;0;3.5;0.3;0.0
07;2021-02-04;686;292;0;10690;1010;0;3.7;0.4;0.0
07;2021-02-05;506;254;0;11196;1264;0;3.9;0.4;0.0
07;2021-02-06;139;17;0;11335;1281;0;4.0;0.4;0.0
07;2021-02-07;29;2;0;11364;1283;0;4.0;0.4;0.0
07;2021-02-08;264;193;0;11628;1476;0;4.1;0.5;0.0
07;2021-02-09;509;365;0;12137;1841;0;4.2;0.6;0.0
07;2021-02-10;536;358;0;12673;2199;0;4.4;0.8;0.0
07;2021-02-11;423;293;0;13096;2492;0;4.6;0.9;0.0
07;2021-02-12;294;213;0;13390;2705;0;4.7;0.9;0.0
07;2021-02-13;118;52;0;13508;2757;0;4.7;1.0;0.0
07;2021-02-14;4;0;0;13512;2757;0;4.7;1.0;0.0
07;2021-02-15;302;175;0;13814;2932;0;4.8;1.0;0.0
07;2021-02-16;352;383;0;14166;3315;0;5.0;1.2;0.0
07;2021-02-17;434;358;0;14600;3673;0;5.1;1.3;0.0
07;2021-02-18;538;714;0;15138;4387;0;5.3;1.5;0.0
07;2021-02-19;458;486;0;15596;4873;0;5.5;1.7;0.0
07;2021-02-20;105;91;0;15701;4964;0;5.5;1.7;0.0
07;2021-02-21;17;11;0;15718;4975;0;5.5;1.7;0.0
07;2021-02-22;412;281;0;16130;5256;0;5.6;1.8;0.0
07;2021-02-23;628;616;0;16758;5872;0;5.9;2.1;0.0
07;2021-02-24;886;782;0;17644;6654;0;6.2;2.3;0.0
07;2021-02-25;715;569;0;18359;7223;0;6.4;2.5;0.0
07;2021-02-26;819;332;0;19178;7555;0;6.7;2.6;0.0
07;2021-02-27;202;196;0;19380;7751;0;6.8;2.7;0.0
07;2021-02-28;2;7;0;19382;7758;0;6.8;2.7;0.0
07;2021-03-01;447;243;0;19829;8001;0;6.9;2.8;0.0
07;2021-03-02;657;548;0;20486;8549;0;7.2;3.0;0.0
07;2021-03-03;709;551;0;21195;9100;0;7.4;3.2;0.0
07;2021-03-04;1105;383;0;22300;9483;0;7.8;3.3;0.0
07;2021-03-05;1124;404;0;23424;9887;0;8.2;3.5;0.0
07;2021-03-06;1307;139;0;24731;10026;0;8.6;3.5;0.0
07;2021-03-07;920;32;0;25651;10058;0;9.0;3.5;0.0
07;2021-03-08;425;355;0;26076;10413;0;9.1;3.6;0.0
07;2021-03-09;1110;464;0;27186;10877;0;9.5;3.8;0.0
07;2021-03-10;900;514;0;28086;11391;0;9.8;4.0;0.0
07;2021-03-11;1438;468;0;29524;11859;0;10.3;4.1;0.0
07;2021-03-12;1642;540;0;31166;12399;0;10.9;4.3;0.0
07;2021-03-13;746;143;0;31912;12542;0;11.2;4.4;0.0
07;2021-03-14;18;10;0;31930;12552;0;11.2;4.4;0.0
07;2021-03-15;582;290;0;32512;12842;0;11.4;4.5;0.0
07;2021-03-16;1232;476;0;33744;13318;0;11.8;4.7;0.0
07;2021-03-17;1168;757;0;34912;14075;0;12.2;4.9;0.0
07;2021-03-18;1198;438;0;36110;14513;0;12.6;5.1;0.0
07;2021-03-19;1244;422;0;37354;14935;0;13.1;5.2;0.0
07;2021-03-20;523;115;0;37877;15050;0;13.2;5.3;0.0
07;2021-03-21;20;4;0;37897;15054;0;13.2;5.3;0.0
07;2021-03-22;833;518;0;38730;15572;0;13.5;5.4;0.0
07;2021-03-23;1441;659;0;40171;16231;0;14.0;5.7;0.0
07;2021-03-24;1252;628;0;41423;16859;0;14.5;5.9;0.0
07;2021-03-25;1835;495;0;43258;17354;0;15.1;6.1;0.0
07;2021-03-26;1817;433;0;45075;17787;0;15.8;6.2;0.0
07;2021-03-27;455;115;0;45530;17902;0;15.9;6.3;0.0
07;2021-03-28;31;4;0;45561;17906;0;15.9;6.3;0.0
07;2021-03-29;840;366;0;46401;18272;0;16.2;6.4;0.0
07;2021-03-30;1587;536;0;47988;18808;0;16.8;6.6;0.0
07;2021-03-31;1482;492;0;49470;19300;0;17.3;6.7;0.0
07;2021-04-01;1661;666;0;51131;19966;0;17.9;7.0;0.0
07;2021-04-02;1495;504;0;52626;20470;0;18.4;7.2;0.0
07;2021-04-03;277;236;0;52903;20706;0;18.5;7.2;0.0
07;2021-04-04;34;93;0;52937;20799;0;18.5;7.3;0.0
07;2021-04-05;79;65;0;53016;20864;0;18.5;7.3;0.0
07;2021-04-06;1158;781;0;54174;21645;0;18.9;7.6;0.0
07;2021-04-07;1254;932;0;55428;22577;0;19.4;7.9;0.0
07;2021-04-08;1909;1142;0;57337;23719;0;20.0;8.3;0.0
07;2021-04-09;2296;604;0;59633;24323;0;20.8;8.5;0.0
07;2021-04-10;829;231;0;60462;24554;0;21.1;8.6;0.0
07;2021-04-11;313;16;0;60775;24570;0;21.2;8.6;0.0
07;2021-04-12;1236;638;0;62011;25208;0;21.7;8.8;0.0
07;2021-04-13;1701;1280;0;63712;26488;0;22.3;9.3;0.0
07;2021-04-14;1535;1032;0;65247;27520;0;22.8;9.6;0.0
07;2021-04-15;1368;858;0;66615;28378;0;23.3;9.9;0.0
07;2021-04-16;1421;893;0;68036;29271;0;23.8;10.2;0.0
07;2021-04-17;896;253;0;68932;29524;0;24.1;10.3;0.0
07;2021-04-18;589;45;0;69521;29569;0;24.3;10.3;0.0
07;2021-04-19;1092;607;0;70613;30176;0;24.7;10.5;0.0
07;2021-04-20;1364;1264;0;71977;31440;0;25.2;11.0;0.0
07;2021-04-21;1613;906;0;73590;32346;0;25.7;11.3;0.0
07;2021-04-22;1639;933;0;75229;33279;0;26.3;11.6;0.0
07;2021-04-23;1351;969;0;76580;34248;0;26.8;12.0;0.0
07;2021-04-24;925;306;0;77505;34554;0;27.1;12.1;0.0
07;2021-04-25;717;81;0;78222;34635;0;27.3;12.1;0.0
07;2021-04-26;1056;768;0;79278;35403;0;27.7;12.4;0.0
07;2021-04-27;1352;1489;0;80630;36892;0;28.2;12.9;0.0
07;2021-04-28;1464;1458;0;82094;38350;0;28.7;13.4;0.0
07;2021-04-29;1842;1459;0;83936;39809;0;29.3;13.9;0.0
07;2021-04-30;1493;1383;0;85429;41192;0;29.9;14.4;0.0
07;2021-05-01;916;144;0;86345;41336;0;30.2;14.4;0.0
07;2021-05-02;748;151;0;87093;41487;0;30.4;14.5;0.0
07;2021-05-03;1282;491;0;88375;41978;0;30.9;14.7;0.0
07;2021-05-04;1942;1550;0;90317;43528;0;31.6;15.2;0.0
07;2021-05-05;1684;1364;0;92001;44892;0;32.2;15.7;0.0
07;2021-05-06;2051;1588;0;94052;46480;0;32.9;16.2;0.0
07;2021-05-07;1633;1487;0;95685;47967;0;33.4;16.8;0.0
07;2021-05-08;1150;415;0;96835;48382;0;33.8;16.9;0.0
07;2021-05-09;887;307;0;97722;48689;0;34.2;17.0;0.0
07;2021-05-10;1467;1125;0;99189;49814;0;34.7;17.4;0.0
07;2021-05-11;2350;1543;0;101539;51357;0;35.5;18.0;0.0
07;2021-05-12;2132;1152;0;103671;52509;0;36.2;18.4;0.0
07;2021-05-13;1656;273;0;105327;52782;0;36.8;18.4;0.0
07;2021-05-14;1732;880;0;107059;53662;0;37.4;18.8;0.0
07;2021-05-15;1707;473;0;108766;54135;0;38.0;18.9;0.0
07;2021-05-16;1490;201;0;110256;54336;0;38.5;19.0;0.0
07;2021-05-17;1794;834;0;112050;55170;0;39.2;19.3;0.0
07;2021-05-18;2238;1231;0;114288;56401;0;39.9;19.7;0.0
07;2021-05-19;2246;919;0;116534;57320;0;40.7;20.0;0.0
07;2021-05-20;2071;1228;0;118605;58548;0;41.5;20.5;0.0
07;2021-05-21;1731;1242;0;120336;59790;0;42.1;20.9;0.0
07;2021-05-22;966;530;0;121302;60320;0;42.4;21.1;0.0
07;2021-05-23;658;146;0;121960;60466;0;42.6;21.1;0.0
07;2021-05-24;1466;343;0;123426;60809;0;43.1;21.3;0.0
07;2021-05-25;1977;1350;0;125403;62159;0;43.8;21.7;0.0
07;2021-05-26;1616;1294;0;127019;63453;0;44.4;22.2;0.0
07;2021-05-27;1882;1414;0;128901;64867;0;45.1;22.7;0.0
07;2021-05-28;1730;2002;0;130631;66869;0;45.7;23.4;0.0
07;2021-05-29;972;724;0;131603;67593;0;46.0;23.6;0.0
07;2021-05-30;415;482;0;132018;68075;0;46.1;23.8;0.0
07;2021-05-31;1163;1192;0;133181;69267;0;46.6;24.2;0.0
07;2021-06-01;1770;1904;0;134951;71171;0;47.2;24.9;0.0
07;2021-06-02;1475;1546;0;136426;72717;0;47.7;25.4;0.0
07;2021-06-03;1587;1319;0;138013;74036;0;48.2;25.9;0.0
07;2021-06-04;1604;1626;0;139617;75662;0;48.8;26.4;0.0
07;2021-06-05;919;920;0;140536;76582;0;49.1;26.8;0.0
07;2021-06-06;388;552;0;140924;77134;0;49.3;27.0;0.0
07;2021-06-07;938;1205;0;141862;78339;0;49.6;27.4;0.0
07;2021-06-08;1436;1689;0;143298;80028;0;50.1;28.0;0.0
07;2021-06-09;1054;1444;0;144352;81472;0;50.5;28.5;0.0
07;2021-06-10;867;1432;0;145219;82904;0;50.8;29.0;0.0
07;2021-06-11;1173;2063;0;146392;84967;0;51.2;29.7;0.0
07;2021-06-12;572;1193;0;146964;86160;0;51.4;30.1;0.0
07;2021-06-13;248;367;0;147212;86527;0;51.5;30.2;0.0
07;2021-06-14;638;1935;0;147850;88462;0;51.7;30.9;0.0
07;2021-06-15;975;2451;0;148825;90913;0;52.0;31.8;0.0
07;2021-06-16;994;1864;0;149819;92777;0;52.4;32.4;0.0
07;2021-06-17;884;1933;0;150703;94710;0;52.7;33.1;0.0
07;2021-06-18;920;2373;0;151623;97083;0;53.0;33.9;0.0
07;2021-06-19;522;1388;0;152145;98471;0;53.2;34.4;0.0
07;2021-06-20;282;637;0;152427;99108;0;53.3;34.6;0.0
07;2021-06-21;530;2131;0;152957;101239;0;53.5;35.4;0.0
07;2021-06-22;656;2579;0;153613;103818;0;53.7;36.3;0.0
07;2021-06-23;680;2067;0;154293;105885;0;53.9;37.0;0.0
07;2021-06-24;642;1907;0;154935;107792;0;54.2;37.7;0.0
07;2021-06-25;664;2357;0;155599;110149;0;54.4;38.5;0.0
07;2021-06-26;338;1598;0;155937;111747;0;54.5;39.1;0.0
07;2021-06-27;203;902;0;156140;112649;0;54.6;39.4;0.0
07;2021-06-28;502;2225;0;156642;114874;0;54.8;40.2;0.0
07;2021-06-29;544;2850;0;157186;117724;0;54.9;41.1;0.0
07;2021-06-30;820;2293;0;158006;120017;0;55.2;42.0;0.0
07;2021-07-01;857;1923;0;158863;121940;0;55.5;42.6;0.0
07;2021-07-02;864;2231;0;159727;124171;0;55.8;43.4;0.0
07;2021-07-03;400;1261;0;160127;125432;0;56.0;43.8;0.0
07;2021-07-04;202;608;0;160329;126040;0;56.0;44.1;0.0
07;2021-07-05;646;1734;0;160975;127774;0;56.3;44.7;0.0
07;2021-07-06;859;2377;0;161834;130151;0;56.6;45.5;0.0
07;2021-07-07;934;1874;0;162768;132025;0;56.9;46.1;0.0
07;2021-07-08;1025;1842;0;163793;133867;0;57.3;46.8;0.0
07;2021-07-09;951;2243;0;164744;136110;0;57.6;47.6;0.0
07;2021-07-10;559;1172;0;165303;137282;0;57.8;48.0;0.0
07;2021-07-11;206;517;0;165509;137799;0;57.9;48.2;0.0
07;2021-07-12;755;1798;0;166264;139597;0;58.1;48.8;0.0
07;2021-07-13;1523;2679;0;167787;142276;0;58.6;49.7;0.0
07;2021-07-14;395;236;0;168182;142512;0;58.8;49.8;0.0
07;2021-07-15;1844;2171;0;170026;144683;0;59.4;50.6;0.0
07;2021-07-16;1973;1963;0;171999;146646;0;60.1;51.3;0.0
07;2021-07-17;1291;1103;0;173290;147749;0;60.6;51.6;0.0
07;2021-07-18;313;221;0;173603;147970;0;60.7;51.7;0.0
07;2021-07-19;1428;1594;0;175031;149564;0;61.2;52.3;0.0
07;2021-07-20;2393;2258;0;177424;151822;0;62.0;53.1;0.0
07;2021-07-21;1893;1817;0;179317;153639;0;62.7;53.7;0.0
07;2021-07-22;1996;1372;0;181313;155011;0;63.4;54.2;0.0
07;2021-07-23;2286;1612;0;183599;156623;0;64.2;54.7;0.0
07;2021-07-24;1507;958;0;185106;157581;0;64.7;55.1;0.0
07;2021-07-25;192;56;0;185298;157637;0;64.8;55.1;0.0
07;2021-07-26;2012;1458;0;187310;159095;0;65.5;55.6;0.0
07;2021-07-27;2754;1598;0;190064;160693;0;66.4;56.2;0.0
07;2021-07-28;1906;1238;0;191970;161931;0;67.1;56.6;0.0
07;2021-07-29;2390;1258;0;194360;163189;0;67.9;57.0;0.0
07;2021-07-30;1706;1459;0;196066;164648;0;68.5;57.6;0.0
07;2021-07-31;1217;748;0;197283;165396;0;69.0;57.8;0.0
07;2021-08-01;118;53;0;197401;165449;0;69.0;57.8;0.0
07;2021-08-02;1562;1116;0;198963;166565;0;69.5;58.2;0.0
07;2021-08-03;2211;1726;0;201174;168291;0;70.3;58.8;0.0
07;2021-08-04;1864;955;0;203038;169246;0;71.0;59.2;0.0
07;2021-08-05;1834;1286;0;204872;170532;0;71.6;59.6;0.0
07;2021-08-06;1856;1644;0;206728;172176;0;72.3;60.2;0.0
07;2021-08-07;729;562;0;207457;172738;0;72.5;60.4;0.0
07;2021-08-08;28;47;0;207485;172785;0;72.5;60.4;0.0
07;2021-08-09;1127;1452;0;208612;174237;0;72.9;60.9;0.0
07;2021-08-10;1415;2141;0;210027;176378;0;73.4;61.7;0.0
07;2021-08-11;1301;1619;0;211328;177997;0;73.9;62.2;0.0
07;2021-08-12;1087;1518;0;212415;179515;0;74.2;62.7;0.0
07;2021-08-13;1137;1713;0;213552;181228;0;74.6;63.3;0.0
07;2021-08-14;424;747;0;213976;181975;0;74.8;63.6;0.0
07;2021-08-15;26;53;0;214002;182028;0;74.8;63.6;0.0
07;2021-08-16;744;1581;0;214746;183609;0;75.1;64.2;0.0
07;2021-08-17;1186;2218;0;215932;185827;0;75.5;65.0;0.0
07;2021-08-18;952;1631;0;216884;187458;0;75.8;65.5;0.0
07;2021-08-19;1099;1732;0;217983;189190;0;76.2;66.1;0.0
07;2021-08-20;919;2121;0;218902;191311;0;76.5;66.9;0.0
07;2021-08-21;349;657;0;219251;191968;0;76.6;67.1;0.0
07;2021-08-22;7;41;0;219258;192009;0;76.6;67.1;0.0
07;2021-08-23;544;1568;0;219802;193577;0;76.8;67.7;0.0
07;2021-08-24;1062;2249;0;220864;195826;0;77.2;68.4;0.0
07;2021-08-25;761;1837;0;221625;197663;0;77.5;69.1;0.0
07;2021-08-26;710;1908;0;222335;199571;0;77.7;69.8;0.0
07;2021-08-27;839;1969;0;223174;201540;0;78.0;70.4;0.0
07;2021-08-28;331;683;0;223505;202223;0;78.1;70.7;0.0
07;2021-08-29;11;71;0;223516;202294;0;78.1;70.7;0.0
07;2021-08-30;494;1533;23;224010;203827;23;78.3;71.2;0.0
07;2021-08-31;1033;2109;74;225043;205936;97;78.7;72.0;0.0
07;2021-09-01;676;1364;68;225719;207300;165;78.9;72.5;0.1
07;2021-09-02;612;1321;171;226331;208621;336;79.1;72.9;0.1
07;2021-09-03;778;1718;131;227109;210339;467;79.4;73.5;0.2
07;2021-09-04;345;653;24;227454;210992;491;79.5;73.8;0.2
07;2021-09-05;19;29;4;227473;211021;495;79.5;73.8;0.2
07;2021-09-06;435;843;152;227908;211864;647;79.7;74.1;0.2
07;2021-09-07;506;1061;167;228414;212925;814;79.8;74.4;0.3
07;2021-09-08;484;1060;145;228898;213985;959;80.0;74.8;0.3
07;2021-09-09;446;859;207;229344;214844;1166;80.2;75.1;0.4
07;2021-09-10;550;1241;197;229894;216085;1363;80.4;75.5;0.5
07;2021-09-11;178;605;40;230072;216690;1403;80.4;75.7;0.5
07;2021-09-12;4;16;3;230076;216706;1406;80.4;75.7;0.5
07;2021-09-13;365;576;135;230441;217282;1541;80.5;75.9;0.5
07;2021-09-14;576;879;333;231017;218161;1874;80.7;76.3;0.7
07;2021-09-15;343;840;203;231360;219001;2077;80.9;76.5;0.7
07;2021-09-16;433;598;320;231793;219599;2397;81.0;76.8;0.8
07;2021-09-17;365;884;314;232158;220483;2711;81.1;77.1;0.9
07;2021-09-18;138;503;59;232296;220986;2770;81.2;77.2;1.0
07;2021-09-19;6;26;4;232302;221012;2774;81.2;77.3;1.0
07;2021-09-20;231;427;406;232533;221439;3180;81.3;77.4;1.1
07;2021-09-21;270;686;364;232803;222125;3544;81.4;77.6;1.2
07;2021-09-22;201;772;201;233004;222897;3745;81.4;77.9;1.3
07;2021-09-23;200;553;343;233204;223450;4088;81.5;78.1;1.4
07;2021-09-24;275;881;365;233479;224331;4453;81.6;78.4;1.6
07;2021-09-25;93;329;63;233572;224660;4516;81.6;78.5;1.6
07;2021-09-26;5;13;6;233577;224673;4522;81.6;78.5;1.6
07;2021-09-27;190;499;323;233767;225172;4845;81.7;78.7;1.7
07;2021-09-28;181;474;530;233948;225646;5375;81.8;78.9;1.9
07;2021-09-29;179;560;377;234127;226206;5752;81.8;79.1;2.0
07;2021-09-30;184;438;345;234311;226644;6097;81.9;79.2;2.1
07;2021-10-01;287;617;367;234598;227261;6464;82.0;79.4;2.3
07;2021-10-02;110;214;59;234708;227475;6523;82.0;79.5;2.3
07;2021-10-03;5;17;2;234713;227492;6525;82.0;79.5;2.3
07;2021-10-04;170;382;361;234883;227874;6886;82.1;79.7;2.4
07;2021-10-05;214;484;480;235097;228358;7366;82.2;79.8;2.6
07;2021-10-06;178;363;500;235275;228721;7866;82.2;79.9;2.7
07;2021-10-07;127;399;358;235402;229120;8224;82.3;80.1;2.9
07;2021-10-08;230;480;511;235632;229600;8735;82.4;80.3;3.1
07;2021-10-09;99;170;140;235731;229770;8875;82.4;80.3;3.1
07;2021-10-10;1;4;2;235732;229774;8877;82.4;80.3;3.1
07;2021-10-11;116;293;495;235848;230067;9372;82.4;80.4;3.3
07;2021-10-12;171;388;515;236019;230455;9887;82.5;80.6;3.5
07;2021-10-13;150;273;402;236169;230728;10289;82.6;80.6;3.6
07;2021-10-14;152;239;369;236321;230967;10658;82.6;80.7;3.7
07;2021-10-15;234;375;567;236555;231342;11225;82.7;80.9;3.9
07;2021-10-16;107;130;175;236662;231472;11400;82.7;80.9;4.0
07;2021-10-17;1;5;1;236663;231477;11401;82.7;80.9;4.0
07;2021-10-18;183;240;389;236846;231717;11790;82.8;81.0;4.1
07;2021-10-19;114;147;564;236960;231864;12354;82.8;81.0;4.3
07;2021-10-20;108;200;443;237068;232064;12797;82.9;81.1;4.5
07;2021-10-21;65;156;546;237133;232220;13343;82.9;81.2;4.7
07;2021-10-22;88;270;623;237221;232490;13966;82.9;81.3;4.9
07;2021-10-23;53;72;133;237274;232562;14099;82.9;81.3;4.9
07;2021-10-24;3;8;2;237277;232570;14101;82.9;81.3;4.9
07;2021-10-25;77;154;367;237354;232724;14468;83.0;81.3;5.1
07;2021-10-26;97;172;747;237451;232896;15215;83.0;81.4;5.3
07;2021-10-27;76;172;407;237527;233068;15622;83.0;81.5;5.5
07;2021-10-28;61;115;405;237588;233183;16027;83.0;81.5;5.6
07;2021-10-29;88;208;731;237676;233391;16758;83.1;81.6;5.9
07;2021-10-30;53;85;191;237729;233476;16949;83.1;81.6;5.9
07;2021-10-31;0;2;3;237729;233478;16952;83.1;81.6;5.9
07;2021-11-01;7;10;17;237736;233488;16969;83.1;81.6;5.9
07;2021-11-02;89;192;700;237825;233680;17669;83.1;81.7;6.2
07;2021-11-03;94;124;630;237919;233804;18299;83.2;81.7;6.4
07;2021-11-04;72;122;680;237991;233926;18979;83.2;81.8;6.6
07;2021-11-05;97;225;822;238088;234151;19801;83.2;81.8;6.9
07;2021-11-06;32;86;230;238120;234237;20031;83.2;81.9;7.0
07;2021-11-07;2;11;2;238122;234248;20033;83.2;81.9;7.0
07;2021-11-08;64;157;767;238186;234405;20800;83.3;81.9;7.3
07;2021-11-09;68;134;1051;238254;234539;21851;83.3;82.0;7.6
07;2021-11-10;77;183;1128;238331;234722;22979;83.3;82.0;8.0
07;2021-11-11;4;3;27;238335;234725;23006;83.3;82.0;8.0
07;2021-11-12;110;166;1179;238445;234891;24185;83.3;82.1;8.5
07;2021-11-13;44;85;275;238489;234976;24460;83.4;82.1;8.5
07;2021-11-14;0;10;10;238489;234986;24470;83.4;82.1;8.6
07;2021-11-15;70;106;1057;238559;235092;25527;83.4;82.2;8.9
07;2021-11-16;83;107;1543;238642;235199;27070;83.4;82.2;9.5
07;2021-11-17;101;123;1154;238743;235322;28224;83.5;82.3;9.9
07;2021-11-18;82;110;1059;238825;235432;29283;83.5;82.3;10.2
07;2021-11-19;94;131;1493;238919;235563;30776;83.5;82.3;10.8
07;2021-11-20;78;56;366;238997;235619;31142;83.5;82.4;10.9
07;2021-11-21;0;2;13;238997;235621;31155;83.5;82.4;10.9
07;2021-11-22;71;54;1137;239068;235675;32292;83.6;82.4;11.3
07;2021-11-23;122;94;1797;239190;235769;34089;83.6;82.4;11.9
07;2021-11-24;134;116;1423;239324;235885;35512;83.7;82.5;12.4
07;2021-11-25;100;92;1906;239424;235977;37418;83.7;82.5;13.1
07;2021-11-26;142;125;2588;239566;236102;40006;83.7;82.5;14.0
07;2021-11-27;66;59;1329;239632;236161;41335;83.8;82.5;14.4
07;2021-11-28;11;7;472;239643;236168;41807;83.8;82.6;14.6
07;2021-11-29;63;69;2154;239706;236237;43961;83.8;82.6;15.4
07;2021-11-30;82;88;3338;239788;236325;47299;83.8;82.6;16.5
07;2021-12-01;99;89;2634;239887;236414;49933;83.9;82.6;17.5
07;2021-12-02;56;58;2926;239943;236472;52859;83.9;82.7;18.5
07;2021-12-03;93;118;3633;240036;236590;56492;83.9;82.7;19.7
07;2021-12-04;60;50;1573;240096;236640;58065;83.9;82.7;20.3
07;2021-12-05;6;12;349;240102;236652;58414;83.9;82.7;20.4
07;2021-12-06;62;73;2712;240164;236725;61126;83.9;82.7;21.4
07;2021-12-07;107;114;4367;240271;236839;65493;84.0;82.8;22.9
07;2021-12-08;87;94;3484;240358;236933;68977;84.0;82.8;24.1
07;2021-12-09;97;83;3580;240455;237016;72557;84.0;82.8;25.4
07;2021-12-10;97;111;4254;240552;237127;76811;84.1;82.9;26.8
07;2021-12-11;69;71;2001;240621;237198;78812;84.1;82.9;27.5
07;2021-12-12;9;7;438;240630;237205;79250;84.1;82.9;27.7
07;2021-12-13;80;86;3085;240710;237291;82335;84.1;82.9;28.8
07;2021-12-14;136;133;4636;240846;237424;86971;84.2;83.0;30.4
07;2021-12-15;91;134;3982;240937;237558;90953;84.2;83.0;31.8
07;2021-12-16;101;104;4245;241038;237662;95198;84.3;83.1;33.3
07;2021-12-17;132;177;4153;241170;237839;99351;84.3;83.1;34.7
07;2021-12-18;110;85;2224;241280;237924;101575;84.3;83.2;35.5
07;2021-12-19;30;24;879;241310;237948;102454;84.3;83.2;35.8
08;2020-12-27;0;0;0;0;0;0;0.0;0.0;0.0
08;2020-12-28;0;0;0;0;0;0;0.0;0.0;0.0
08;2020-12-29;0;0;0;0;0;0;0.0;0.0;0.0
08;2020-12-30;0;0;0;0;0;0;0.0;0.0;0.0
08;2020-12-31;0;0;0;0;0;0;0.0;0.0;0.0
08;2021-01-01;0;0;0;0;0;0;0.0;0.0;0.0
08;2021-01-02;0;0;0;0;0;0;0.0;0.0;0.0
08;2021-01-03;1;0;0;1;0;0;0.0;0.0;0.0
08;2021-01-04;23;0;0;24;0;0;0.0;0.0;0.0
08;2021-01-05;0;0;0;24;0;0;0.0;0.0;0.0
08;2021-01-06;0;0;0;24;0;0;0.0;0.0;0.0
08;2021-01-07;187;0;0;211;0;0;0.1;0.0;0.0
08;2021-01-08;302;0;0;513;0;0;0.2;0.0;0.0
08;2021-01-09;106;0;0;619;0;0;0.3;0.0;0.0
08;2021-01-10;1;0;0;620;0;0;0.3;0.0;0.0
08;2021-01-11;79;1;0;699;1;0;0.3;0.0;0.0
08;2021-01-12;174;0;0;873;1;0;0.4;0.0;0.0
08;2021-01-13;484;1;0;1357;2;0;0.6;0.0;0.0
08;2021-01-14;540;8;0;1897;10;0;0.8;0.0;0.0
08;2021-01-15;294;2;0;2191;12;0;1.0;0.0;0.0
08;2021-01-16;105;0;0;2296;12;0;1.0;0.0;0.0
08;2021-01-17;1;0;0;2297;12;0;1.0;0.0;0.0
08;2021-01-18;385;2;0;2682;14;0;1.2;0.0;0.0
08;2021-01-19;842;1;0;3524;15;0;1.5;0.0;0.0
08;2021-01-20;891;4;0;4415;19;0;1.9;0.0;0.0
08;2021-01-21;729;1;0;5144;20;0;2.2;0.0;0.0
08;2021-01-22;682;2;0;5826;22;0;2.5;0.0;0.0
08;2021-01-23;237;0;0;6063;22;0;2.6;0.0;0.0
08;2021-01-24;1;0;0;6064;22;0;2.6;0.0;0.0
08;2021-01-25;204;0;0;6268;22;0;2.7;0.0;0.0
08;2021-01-26;289;1;0;6557;23;0;2.8;0.0;0.0
08;2021-01-27;415;1;0;6972;24;0;3.0;0.0;0.0
08;2021-01-28;565;173;0;7537;197;0;3.3;0.1;0.0
08;2021-01-29;574;172;0;8111;369;0;3.5;0.2;0.0
08;2021-01-30;207;60;0;8318;429;0;3.6;0.2;0.0
08;2021-01-31;0;0;0;8318;429;0;3.6;0.2;0.0
08;2021-02-01;84;49;0;8402;478;0;3.6;0.2;0.0
08;2021-02-02;202;166;0;8604;644;0;3.7;0.3;0.0
08;2021-02-03;144;169;0;8748;813;0;3.8;0.4;0.0
08;2021-02-04;329;295;0;9077;1108;0;3.9;0.5;0.0
08;2021-02-05;515;343;0;9592;1451;0;4.2;0.6;0.0
08;2021-02-06;142;75;0;9734;1526;0;4.2;0.7;0.0
08;2021-02-07;8;0;0;9742;1526;0;4.2;0.7;0.0
08;2021-02-08;44;175;0;9786;1701;0;4.2;0.7;0.0
08;2021-02-09;217;623;0;10003;2324;0;4.3;1.0;0.0
08;2021-02-10;325;616;0;10328;2940;0;4.5;1.3;0.0
08;2021-02-11;464;358;0;10792;3298;0;4.7;1.4;0.0
08;2021-02-12;663;385;0;11455;3683;0;5.0;1.6;0.0
08;2021-02-13;128;113;0;11583;3796;0;5.0;1.6;0.0
08;2021-02-14;4;61;0;11587;3857;0;5.0;1.7;0.0
08;2021-02-15;226;204;0;11813;4061;0;5.1;1.8;0.0
08;2021-02-16;138;381;0;11951;4442;0;5.2;1.9;0.0
08;2021-02-17;127;409;0;12078;4851;0;5.2;2.1;0.0
08;2021-02-18;229;518;0;12307;5369;0;5.3;2.3;0.0
08;2021-02-19;311;426;0;12618;5795;0;5.5;2.5;0.0
08;2021-02-20;16;205;0;12634;6000;0;5.5;2.6;0.0
08;2021-02-21;0;0;0;12634;6000;0;5.5;2.6;0.0
08;2021-02-22;139;181;0;12773;6181;0;5.5;2.7;0.0
08;2021-02-23;163;324;0;12936;6505;0;5.6;2.8;0.0
08;2021-02-24;169;387;0;13105;6892;0;5.7;3.0;0.0
08;2021-02-25;497;528;0;13602;7420;0;5.9;3.2;0.0
08;2021-02-26;616;631;0;14218;8051;0;6.2;3.5;0.0
08;2021-02-27;308;185;0;14526;8236;0;6.3;3.6;0.0
08;2021-02-28;21;1;0;14547;8237;0;6.3;3.6;0.0
08;2021-03-01;200;103;0;14747;8340;0;6.4;3.6;0.0
08;2021-03-02;623;275;0;15370;8615;0;6.7;3.7;0.0
08;2021-03-03;871;196;0;16241;8811;0;7.0;3.8;0.0
08;2021-03-04;724;345;0;16965;9156;0;7.4;4.0;0.0
08;2021-03-05;1006;546;0;17971;9702;0;7.8;4.2;0.0
08;2021-03-06;652;133;0;18623;9835;0;8.1;4.3;0.0
08;2021-03-07;57;0;0;18680;9835;0;8.1;4.3;0.0
08;2021-03-08;210;126;0;18890;9961;0;8.2;4.3;0.0
08;2021-03-09;686;166;0;19576;10127;0;8.5;4.4;0.0
08;2021-03-10;1043;125;0;20619;10252;0;8.9;4.4;0.0
08;2021-03-11;962;255;0;21581;10507;0;9.4;4.6;0.0
08;2021-03-12;1625;519;0;23206;11026;0;10.1;4.8;0.0
08;2021-03-13;799;112;0;24005;11138;0;10.4;4.8;0.0
08;2021-03-14;28;0;0;24033;11138;0;10.4;4.8;0.0
08;2021-03-15;292;74;0;24325;11212;0;10.5;4.9;0.0
08;2021-03-16;560;43;0;24885;11255;0;10.8;4.9;0.0
08;2021-03-17;802;80;0;25687;11335;0;11.1;4.9;0.0
08;2021-03-18;808;171;0;26495;11506;0;11.5;5.0;0.0
08;2021-03-19;1141;290;0;27636;11796;0;12.0;5.1;0.0
08;2021-03-20;507;27;0;28143;11823;0;12.2;5.1;0.0
08;2021-03-21;17;1;0;28160;11824;0;12.2;5.1;0.0
08;2021-03-22;381;50;0;28541;11874;0;12.4;5.1;0.0
08;2021-03-23;769;69;0;29310;11943;0;12.7;5.2;0.0
08;2021-03-24;1347;76;0;30657;12019;0;13.3;5.2;0.0
08;2021-03-25;1911;104;0;32568;12123;0;14.1;5.3;0.0
08;2021-03-26;2472;175;0;35040;12298;0;15.2;5.3;0.0
08;2021-03-27;912;127;0;35952;12425;0;15.6;5.4;0.0
08;2021-03-28;232;8;0;36184;12433;0;15.7;5.4;0.0
08;2021-03-29;290;182;0;36474;12615;0;15.8;5.5;0.0
08;2021-03-30;846;472;0;37320;13087;0;16.2;5.7;0.0
08;2021-03-31;868;512;0;38188;13599;0;16.6;5.9;0.0
08;2021-04-01;1688;438;0;39876;14037;0;17.3;6.1;0.0
08;2021-04-02;1485;511;0;41361;14548;0;17.9;6.3;0.0
08;2021-04-03;1287;196;0;42648;14744;0;18.5;6.4;0.0
08;2021-04-04;125;5;0;42773;14749;0;18.5;6.4;0.0
08;2021-04-05;14;2;0;42787;14751;0;18.6;6.4;0.0
08;2021-04-06;706;482;0;43493;15233;0;18.9;6.6;0.0
08;2021-04-07;908;692;0;44401;15925;0;19.3;6.9;0.0
08;2021-04-08;1740;519;0;46141;16444;0;20.0;7.1;0.0
08;2021-04-09;2330;727;0;48471;17171;0;21.0;7.4;0.0
08;2021-04-10;1429;228;0;49900;17399;0;21.6;7.5;0.0
08;2021-04-11;16;10;0;49916;17409;0;21.6;7.5;0.0
08;2021-04-12;667;217;0;50583;17626;0;21.9;7.6;0.0
08;2021-04-13;1287;612;0;51870;18238;0;22.5;7.9;0.0
08;2021-04-14;1289;852;0;53159;19090;0;23.1;8.3;0.0
08;2021-04-15;1610;808;0;54769;19898;0;23.8;8.6;0.0
08;2021-04-16;1879;874;0;56648;20772;0;24.6;9.0;0.0
08;2021-04-17;1074;400;0;57722;21172;0;25.0;9.2;0.0
08;2021-04-18;42;16;0;57764;21188;0;25.0;9.2;0.0
08;2021-04-19;1129;313;0;58893;21501;0;25.5;9.3;0.0
08;2021-04-20;1086;571;0;59979;22072;0;26.0;9.6;0.0
08;2021-04-21;1107;769;0;61086;22841;0;26.5;9.9;0.0
08;2021-04-22;1262;885;0;62348;23726;0;27.0;10.3;0.0
08;2021-04-23;1606;1169;0;63954;24895;0;27.7;10.8;0.0
08;2021-04-24;1231;637;0;65185;25532;0;28.3;11.1;0.0
08;2021-04-25;32;204;0;65217;25736;0;28.3;11.2;0.0
08;2021-04-26;947;163;0;66164;25899;0;28.7;11.2;0.0
08;2021-04-27;1258;606;0;67422;26505;0;29.2;11.5;0.0
08;2021-04-28;1371;698;0;68793;27203;0;29.8;11.8;0.0
08;2021-04-29;1105;1306;0;69898;28509;0;30.3;12.4;0.0
08;2021-04-30;1677;1592;0;71575;30101;0;31.0;13.1;0.0
08;2021-05-01;929;474;0;72504;30575;0;31.4;13.3;0.0
08;2021-05-02;581;179;0;73085;30754;0;31.7;13.3;0.0
08;2021-05-03;1093;383;0;74178;31137;0;32.2;13.5;0.0
08;2021-05-04;1271;878;0;75449;32015;0;32.7;13.9;0.0
08;2021-05-05;1512;1313;0;76961;33328;0;33.4;14.5;0.0
08;2021-05-06;1840;1644;0;78801;34972;0;34.2;15.2;0.0
08;2021-05-07;1814;2052;0;80615;37024;0;35.0;16.1;0.0
08;2021-05-08;883;760;0;81498;37784;0;35.3;16.4;0.0
08;2021-05-09;414;60;0;81912;37844;0;35.5;16.4;0.0
08;2021-05-10;1165;666;0;83077;38510;0;36.0;16.7;0.0
08;2021-05-11;1837;968;0;84914;39478;0;36.8;17.1;0.0
08;2021-05-12;1728;1243;0;86642;40721;0;37.6;17.7;0.0
08;2021-05-13;1266;596;0;87908;41317;0;38.1;17.9;0.0
08;2021-05-14;2426;1009;0;90334;42326;0;39.2;18.4;0.0
08;2021-05-15;1737;697;0;92071;43023;0;39.9;18.7;0.0
08;2021-05-16;796;96;0;92867;43119;0;40.3;18.7;0.0
08;2021-05-17;668;885;0;93535;44004;0;40.6;19.1;0.0
08;2021-05-18;1252;837;0;94787;44841;0;41.1;19.4;0.0
08;2021-05-19;1513;960;0;96300;45801;0;41.8;19.9;0.0
08;2021-05-20;1956;948;0;98256;46749;0;42.6;20.3;0.0
08;2021-05-21;2191;1246;0;100447;47995;0;43.6;20.8;0.0
08;2021-05-22;1751;748;0;102198;48743;0;44.3;21.1;0.0
08;2021-05-23;857;89;0;103055;48832;0;44.7;21.2;0.0
08;2021-05-24;748;110;0;103803;48942;0;45.0;21.2;0.0
08;2021-05-25;1318;676;0;105121;49618;0;45.6;21.5;0.0
08;2021-05-26;1435;1022;0;106556;50640;0;46.2;22.0;0.0
08;2021-05-27;1818;1099;0;108374;51739;0;47.0;22.4;0.0
08;2021-05-28;1878;1806;0;110252;53545;0;47.8;23.2;0.0
08;2021-05-29;1582;937;0;111834;54482;0;48.5;23.6;0.0
08;2021-05-30;806;103;0;112640;54585;0;48.8;23.7;0.0
08;2021-05-31;715;556;0;113355;55141;0;49.2;23.9;0.0
08;2021-06-01;1319;889;0;114674;56030;0;49.7;24.3;0.0
08;2021-06-02;1333;1169;0;116007;57199;0;50.3;24.8;0.0
08;2021-06-03;1355;1485;0;117362;58684;0;50.9;25.4;0.0
08;2021-06-04;1724;2340;0;119086;61024;0;51.6;26.5;0.0
08;2021-06-05;1156;1289;0;120242;62313;0;52.1;27.0;0.0
08;2021-06-06;900;105;0;121142;62418;0;52.5;27.1;0.0
08;2021-06-07;701;1113;0;121843;63531;0;52.8;27.6;0.0
08;2021-06-08;925;1445;0;122768;64976;0;53.2;28.2;0.0
08;2021-06-09;867;1359;0;123635;66335;0;53.6;28.8;0.0
08;2021-06-10;1622;1484;0;125257;67819;0;54.3;29.4;0.0
08;2021-06-11;1672;2127;0;126929;69946;0;55.0;30.3;0.0
08;2021-06-12;1275;1427;0;128204;71373;0;55.6;31.0;0.0
08;2021-06-13;388;589;0;128592;71962;0;55.8;31.2;0.0
08;2021-06-14;399;1258;0;128991;73220;0;55.9;31.8;0.0
08;2021-06-15;782;1509;0;129773;74729;0;56.3;32.4;0.0
08;2021-06-16;812;2017;0;130585;76746;0;56.6;33.3;0.0
08;2021-06-17;1258;1784;0;131843;78530;0;57.2;34.1;0.0
08;2021-06-18;1537;2536;0;133380;81066;0;57.8;35.2;0.0
08;2021-06-19;1245;1345;0;134625;82411;0;58.4;35.7;0.0
08;2021-06-20;124;403;0;134749;82814;0;58.4;35.9;0.0
08;2021-06-21;496;1341;0;135245;84155;0;58.7;36.5;0.0
08;2021-06-22;820;1972;0;136065;86127;0;59.0;37.3;0.0
08;2021-06-23;907;1636;0;136972;87763;0;59.4;38.1;0.0
08;2021-06-24;991;1866;0;137963;89629;0;59.8;38.9;0.0
08;2021-06-25;1042;2652;0;139005;92281;0;60.3;40.0;0.0
08;2021-06-26;959;1749;0;139964;94030;0;60.7;40.8;0.0
08;2021-06-27;346;648;0;140310;94678;0;60.8;41.1;0.0
08;2021-06-28;402;1315;0;140712;95993;0;61.0;41.6;0.0
08;2021-06-29;619;1408;0;141331;97401;0;61.3;42.2;0.0
08;2021-06-30;838;1611;0;142169;99012;0;61.7;42.9;0.0
08;2021-07-01;849;2063;0;143018;101075;0;62.0;43.8;0.0
08;2021-07-02;912;2549;0;143930;103624;0;62.4;44.9;0.0
08;2021-07-03;725;2019;0;144655;105643;0;62.7;45.8;0.0
08;2021-07-04;142;850;0;144797;106493;0;62.8;46.2;0.0
08;2021-07-05;117;1187;0;144914;107680;0;62.8;46.7;0.0
08;2021-07-06;446;1705;2;145360;109385;2;63.0;47.4;0.0
08;2021-07-07;410;1726;0;145770;111111;2;63.2;48.2;0.0
08;2021-07-08;671;1839;0;146441;112950;2;63.5;49.0;0.0
08;2021-07-09;728;2370;0;147169;115320;2;63.8;50.0;0.0
08;2021-07-10;611;1849;0;147780;117169;2;64.1;50.8;0.0
08;2021-07-11;236;721;0;148016;117890;2;64.2;51.1;0.0
08;2021-07-12;334;1204;0;148350;119094;2;64.3;51.6;0.0
08;2021-07-13;942;1775;0;149292;120869;2;64.7;52.4;0.0
08;2021-07-14;224;369;0;149516;121238;2;64.8;52.6;0.0
08;2021-07-15;813;2409;0;150329;123647;2;65.2;53.6;0.0
08;2021-07-16;1079;2350;0;151408;125997;2;65.7;54.6;0.0
08;2021-07-17;1031;2019;0;152439;128016;2;66.1;55.5;0.0
08;2021-07-18;348;734;0;152787;128750;2;66.3;55.8;0.0
08;2021-07-19;515;941;0;153302;129691;2;66.5;56.2;0.0
08;2021-07-20;971;1505;0;154273;131196;2;66.9;56.9;0.0
08;2021-07-21;1313;1735;0;155586;132931;2;67.5;57.6;0.0
08;2021-07-22;1309;2088;1;156895;135019;3;68.0;58.6;0.0
08;2021-07-23;1616;2419;0;158511;137438;3;68.7;59.6;0.0
08;2021-07-24;1378;1860;0;159889;139298;3;69.3;60.4;0.0
08;2021-07-25;782;458;0;160671;139756;3;69.7;60.6;0.0
08;2021-07-26;1351;877;0;162022;140633;3;70.3;61.0;0.0
08;2021-07-27;2141;1421;0;164163;142054;3;71.2;61.6;0.0
08;2021-07-28;2344;1487;0;166507;143541;3;72.2;62.2;0.0
08;2021-07-29;2522;1311;0;169029;144852;3;73.3;62.8;0.0
08;2021-07-30;2505;1539;0;171534;146391;3;74.4;63.5;0.0
08;2021-07-31;1874;1030;0;173408;147421;3;75.2;63.9;0.0
08;2021-08-01;898;303;0;174306;147724;3;75.6;64.1;0.0
08;2021-08-02;1266;693;0;175572;148417;3;76.1;64.4;0.0
08;2021-08-03;1659;848;0;177231;149265;3;76.9;64.7;0.0
08;2021-08-04;1513;662;0;178744;149927;3;77.5;65.0;0.0
08;2021-08-05;1812;951;0;180556;150878;3;78.3;65.4;0.0
08;2021-08-06;2410;1110;1;182966;151988;4;79.3;65.9;0.0
08;2021-08-07;1529;1115;0;184495;153103;4;80.0;66.4;0.0
08;2021-08-08;557;370;0;185052;153473;4;80.2;66.6;0.0
08;2021-08-09;680;573;0;185732;154046;4;80.5;66.8;0.0
08;2021-08-10;875;800;0;186607;154846;4;80.9;67.2;0.0
08;2021-08-11;576;834;0;187183;155680;4;81.2;67.5;0.0
08;2021-08-12;1033;1068;0;188216;156748;4;81.6;68.0;0.0
08;2021-08-13;1112;1052;0;189328;157800;4;82.1;68.4;0.0
08;2021-08-14;564;902;0;189892;158702;4;82.3;68.8;0.0
08;2021-08-15;138;262;0;190030;158964;4;82.4;68.9;0.0
08;2021-08-16;241;1256;0;190271;160220;4;82.5;69.5;0.0
08;2021-08-17;521;1263;0;190792;161483;4;82.7;70.0;0.0
08;2021-08-18;329;1319;0;191121;162802;4;82.9;70.6;0.0
08;2021-08-19;587;1825;0;191708;164627;4;83.1;71.4;0.0
08;2021-08-20;676;2176;0;192384;166803;4;83.4;72.3;0.0
08;2021-08-21;266;1327;0;192650;168130;4;83.5;72.9;0.0
08;2021-08-22;107;863;0;192757;168993;4;83.6;73.3;0.0
08;2021-08-23;181;1475;0;192938;170468;4;83.7;73.9;0.0
08;2021-08-24;390;1777;0;193328;172245;4;83.8;74.7;0.0
08;2021-08-25;327;1295;0;193655;173540;4;84.0;75.3;0.0
08;2021-08-26;483;1987;0;194138;175527;4;84.2;76.1;0.0
08;2021-08-27;444;2206;0;194582;177733;4;84.4;77.1;0.0
08;2021-08-28;265;1322;0;194847;179055;4;84.5;77.6;0.0
08;2021-08-29;163;556;0;195010;179611;4;84.6;77.9;0.0
08;2021-08-30;321;1213;11;195331;180824;15;84.7;78.4;0.0
08;2021-08-31;351;1248;42;195682;182072;57;84.9;79.0;0.0
08;2021-09-01;435;1236;115;196117;183308;172;85.0;79.5;0.1
08;2021-09-02;465;1087;150;196582;184395;322;85.2;80.0;0.1
08;2021-09-03;463;1527;149;197045;185922;471;85.5;80.6;0.2
08;2021-09-04;332;1301;57;197377;187223;528;85.6;81.2;0.2
08;2021-09-05;105;165;34;197482;187388;562;85.6;81.3;0.2
08;2021-09-06;188;387;131;197670;187775;693;85.7;81.4;0.3
08;2021-09-07;204;485;149;197874;188260;842;85.8;81.6;0.4
08;2021-09-08;261;516;112;198135;188776;954;85.9;81.9;0.4
08;2021-09-09;311;580;161;198446;189356;1115;86.1;82.1;0.5
08;2021-09-10;479;761;281;198925;190117;1396;86.3;82.4;0.6
08;2021-09-11;348;685;126;199273;190802;1522;86.4;82.7;0.7
08;2021-09-12;48;69;21;199321;190871;1543;86.4;82.8;0.7
08;2021-09-13;356;180;99;199677;191051;1642;86.6;82.9;0.7
08;2021-09-14;236;276;141;199913;191327;1783;86.7;83.0;0.8
08;2021-09-15;231;340;260;200144;191667;2043;86.8;83.1;0.9
08;2021-09-16;214;409;236;200358;192076;2279;86.9;83.3;1.0
08;2021-09-17;311;499;347;200669;192575;2626;87.0;83.5;1.1
08;2021-09-18;175;441;186;200844;193016;2812;87.1;83.7;1.2
08;2021-09-19;24;85;6;200868;193101;2818;87.1;83.7;1.2
08;2021-09-20;62;230;180;200930;193331;2998;87.1;83.8;1.3
08;2021-09-21;119;269;300;201049;193600;3298;87.2;84.0;1.4
08;2021-09-22;131;376;293;201180;193976;3591;87.2;84.1;1.6
08;2021-09-23;168;375;310;201348;194351;3901;87.3;84.3;1.7
08;2021-09-24;163;525;411;201511;194876;4312;87.4;84.5;1.9
08;2021-09-25;105;403;161;201616;195279;4473;87.4;84.7;1.9
08;2021-09-26;20;101;11;201636;195380;4484;87.4;84.7;1.9
08;2021-09-27;48;207;178;201684;195587;4662;87.5;84.8;2.0
08;2021-09-28;80;220;239;201764;195807;4901;87.5;84.9;2.1
08;2021-09-29;114;321;238;201878;196128;5139;87.5;85.1;2.2
08;2021-09-30;143;341;251;202021;196469;5390;87.6;85.2;2.3
08;2021-10-01;171;469;389;202192;196938;5779;87.7;85.4;2.5
08;2021-10-02;132;284;169;202324;197222;5948;87.7;85.5;2.6
08;2021-10-03;24;68;17;202348;197290;5965;87.8;85.6;2.6
08;2021-10-04;80;328;141;202428;197618;6106;87.8;85.7;2.6
08;2021-10-05;78;178;279;202506;197796;6385;87.8;85.8;2.8
08;2021-10-06;96;237;250;202602;198033;6635;87.9;85.9;2.9
08;2021-10-07;100;181;303;202702;198214;6938;87.9;86.0;3.0
08;2021-10-08;157;337;496;202859;198551;7434;88.0;86.1;3.2
08;2021-10-09;127;315;280;202986;198866;7714;88.0;86.2;3.3
08;2021-10-10;32;44;30;203018;198910;7744;88.0;86.3;3.4
08;2021-10-11;59;87;265;203077;198997;8009;88.1;86.3;3.5
08;2021-10-12;79;137;260;203156;199134;8269;88.1;86.4;3.6
08;2021-10-13;112;164;225;203268;199298;8494;88.1;86.4;3.7
08;2021-10-14;59;168;294;203327;199466;8788;88.2;86.5;3.8
08;2021-10-15;211;285;705;203538;199751;9493;88.3;86.6;4.1
08;2021-10-16;73;114;238;203611;199865;9731;88.3;86.7;4.2
08;2021-10-17;34;28;28;203645;199893;9759;88.3;86.7;4.2
08;2021-10-18;78;68;275;203723;199961;10034;88.3;86.7;4.4
08;2021-10-19;60;73;324;203783;200034;10358;88.4;86.7;4.5
08;2021-10-20;109;144;497;203892;200178;10855;88.4;86.8;4.7
08;2021-10-21;72;85;365;203964;200263;11220;88.5;86.8;4.9
08;2021-10-22;141;197;577;204105;200460;11797;88.5;86.9;5.1
08;2021-10-23;69;148;281;204174;200608;12078;88.5;87.0;5.2
08;2021-10-24;20;37;39;204194;200645;12117;88.6;87.0;5.3
08;2021-10-25;68;64;269;204262;200709;12386;88.6;87.0;5.4
08;2021-10-26;81;73;384;204343;200782;12770;88.6;87.1;5.5
08;2021-10-27;79;104;401;204422;200886;13171;88.6;87.1;5.7
08;2021-10-28;84;85;471;204506;200971;13642;88.7;87.2;5.9
08;2021-10-29;146;167;704;204652;201138;14346;88.7;87.2;6.2
08;2021-10-30;54;70;243;204706;201208;14589;88.8;87.3;6.3
08;2021-10-31;15;29;66;204721;201237;14655;88.8;87.3;6.4
08;2021-11-01;2;1;4;204723;201238;14659;88.8;87.3;6.4
08;2021-11-02;66;114;463;204789;201352;15122;88.8;87.3;6.6
08;2021-11-03;77;99;459;204866;201451;15581;88.8;87.4;6.8
08;2021-11-04;72;81;499;204938;201532;16080;88.9;87.4;7.0
08;2021-11-05;85;192;753;205023;201724;16833;88.9;87.5;7.3
08;2021-11-06;67;95;396;205090;201819;17229;88.9;87.5;7.5
08;2021-11-07;10;34;47;205100;201853;17276;88.9;87.5;7.5
08;2021-11-08;36;71;308;205136;201924;17584;89.0;87.6;7.6
08;2021-11-09;77;105;658;205213;202029;18242;89.0;87.6;7.9
08;2021-11-10;81;141;761;205294;202170;19003;89.0;87.7;8.2
08;2021-11-11;4;4;27;205298;202174;19030;89.0;87.7;8.3
08;2021-11-12;133;187;1073;205431;202361;20103;89.1;87.8;8.7
08;2021-11-13;46;62;418;205477;202423;20521;89.1;87.8;8.9
08;2021-11-14;11;17;72;205488;202440;20593;89.1;87.8;8.9
08;2021-11-15;35;69;466;205523;202509;21059;89.1;87.8;9.1
08;2021-11-16;51;77;762;205574;202586;21821;89.1;87.9;9.5
08;2021-11-17;56;86;582;205630;202672;22403;89.2;87.9;9.7
08;2021-11-18;61;112;936;205691;202784;23339;89.2;87.9;10.1
08;2021-11-19;118;196;1370;205809;202980;24709;89.3;88.0;10.7
08;2021-11-20;60;64;534;205869;203044;25243;89.3;88.1;10.9
08;2021-11-21;21;19;100;205890;203063;25343;89.3;88.1;11.0
08;2021-11-22;44;30;533;205934;203093;25876;89.3;88.1;11.2
08;2021-11-23;79;64;886;206013;203157;26762;89.3;88.1;11.6
08;2021-11-24;70;108;842;206083;203265;27604;89.4;88.1;12.0
08;2021-11-25;71;82;1197;206154;203347;28801;89.4;88.2;12.5
08;2021-11-26;142;143;2132;206296;203490;30933;89.5;88.2;13.4
08;2021-11-27;84;66;903;206380;203556;31836;89.5;88.3;13.8
08;2021-11-28;23;21;288;206403;203577;32124;89.5;88.3;13.9
08;2021-11-29;47;33;988;206450;203610;33112;89.5;88.3;14.4
08;2021-11-30;81;84;1819;206531;203694;34931;89.6;88.3;15.1
08;2021-12-01;79;79;1899;206610;203773;36830;89.6;88.4;16.0
08;2021-12-02;65;46;2409;206675;203819;39239;89.6;88.4;17.0
08;2021-12-03;120;154;3002;206795;203973;42241;89.7;88.5;18.3
08;2021-12-04;58;72;1595;206853;204045;43836;89.7;88.5;19.0
08;2021-12-05;12;16;369;206865;204061;44205;89.7;88.5;19.2
08;2021-12-06;29;60;1558;206894;204121;45763;89.7;88.5;19.8
08;2021-12-07;75;70;2593;206969;204191;48356;89.8;88.5;21.0
08;2021-12-08;53;74;1864;207022;204265;50220;89.8;88.6;21.8
08;2021-12-09;63;75;3026;207085;204340;53246;89.8;88.6;23.1
08;2021-12-10;105;123;3989;207190;204463;57235;89.9;88.7;24.8
08;2021-12-11;62;77;2331;207252;204540;59566;89.9;88.7;25.8
08;2021-12-12;13;31;797;207265;204571;60363;89.9;88.7;26.2
08;2021-12-13;42;54;1990;207307;204625;62353;89.9;88.7;27.0
08;2021-12-14;72;82;3181;207379;204707;65534;89.9;88.8;28.4
08;2021-12-15;69;88;3071;207448;204795;68605;90.0;88.8;29.8
08;2021-12-16;100;97;3763;207548;204892;72368;90.0;88.9;31.4
08;2021-12-17;126;160;4567;207674;205052;76935;90.1;88.9;33.4
08;2021-12-18;114;99;3244;207788;205151;80179;90.1;89.0;34.8
08;2021-12-19;18;29;983;207806;205180;81162;90.1;89.0;35.2
09;2020-12-27;0;0;0;0;0;0;0.0;0.0;0.0
09;2020-12-28;1;0;0;1;0;0;0.0;0.0;0.0
09;2020-12-29;0;0;0;1;0;0;0.0;0.0;0.0
09;2020-12-30;0;0;0;1;0;0;0.0;0.0;0.0
09;2020-12-31;0;0;0;1;0;0;0.0;0.0;0.0
09;2021-01-01;0;0;0;1;0;0;0.0;0.0;0.0
09;2021-01-02;0;0;0;1;0;0;0.0;0.0;0.0
09;2021-01-03;0;0;0;1;0;0;0.0;0.0;0.0
09;2021-01-04;1;0;0;2;0;0;0.0;0.0;0.0
09;2021-01-05;1;0;0;3;0;0;0.0;0.0;0.0
09;2021-01-06;4;0;0;7;0;0;0.0;0.0;0.0
09;2021-01-07;231;2;0;238;2;0;0.2;0.0;0.0
09;2021-01-08;196;0;0;434;2;0;0.3;0.0;0.0
09;2021-01-09;88;0;0;522;2;0;0.4;0.0;0.0
09;2021-01-10;55;0;0;577;2;0;0.4;0.0;0.0
09;2021-01-11;177;0;0;754;2;0;0.6;0.0;0.0
09;2021-01-12;282;0;0;1036;2;0;0.8;0.0;0.0
09;2021-01-13;191;0;0;1227;2;0;0.9;0.0;0.0
09;2021-01-14;431;6;0;1658;8;0;1.2;0.0;0.0
09;2021-01-15;223;2;0;1881;10;0;1.4;0.0;0.0
09;2021-01-16;168;2;0;2049;12;0;1.5;0.0;0.0
09;2021-01-17;93;0;0;2142;12;0;1.6;0.0;0.0
09;2021-01-18;272;1;0;2414;13;0;1.8;0.0;0.0
09;2021-01-19;261;1;0;2675;14;0;2.0;0.0;0.0
09;2021-01-20;368;2;0;3043;16;0;2.3;0.0;0.0
09;2021-01-21;325;1;0;3368;17;0;2.5;0.0;0.0
09;2021-01-22;349;1;0;3717;18;0;2.8;0.0;0.0
09;2021-01-23;212;0;0;3929;18;0;2.9;0.0;0.0
09;2021-01-24;73;1;0;4002;19;0;3.0;0.0;0.0
09;2021-01-25;206;9;0;4208;28;0;3.1;0.0;0.0
09;2021-01-26;570;26;0;4778;54;0;3.5;0.0;0.0
09;2021-01-27;407;41;0;5185;95;0;3.8;0.1;0.0
09;2021-01-28;311;188;0;5496;283;0;4.1;0.2;0.0
09;2021-01-29;233;112;0;5729;395;0;4.3;0.3;0.0
09;2021-01-30;141;52;0;5870;447;0;4.4;0.3;0.0
09;2021-01-31;43;10;0;5913;457;0;4.4;0.3;0.0
09;2021-02-01;90;129;0;6003;586;0;4.5;0.4;0.0
09;2021-02-02;75;280;0;6078;866;0;4.5;0.6;0.0
09;2021-02-03;90;182;0;6168;1048;0;4.6;0.8;0.0
09;2021-02-04;59;304;0;6227;1352;0;4.6;1.0;0.0
09;2021-02-05;92;148;0;6319;1500;0;4.7;1.1;0.0
09;2021-02-06;72;47;0;6391;1547;0;4.7;1.1;0.0
09;2021-02-07;9;56;0;6400;1603;0;4.8;1.2;0.0
09;2021-02-08;35;203;0;6435;1806;0;4.8;1.3;0.0
09;2021-02-09;56;283;0;6491;2089;0;4.8;1.6;0.0
09;2021-02-10;33;210;0;6524;2299;0;4.8;1.7;0.0
09;2021-02-11;36;216;0;6560;2515;0;4.9;1.9;0.0
09;2021-02-12;140;184;0;6700;2699;0;5.0;2.0;0.0
09;2021-02-13;8;131;0;6708;2830;0;5.0;2.1;0.0
09;2021-02-14;0;46;0;6708;2876;0;5.0;2.1;0.0
09;2021-02-15;69;137;0;6777;3013;0;5.0;2.2;0.0
09;2021-02-16;206;469;0;6983;3482;0;5.2;2.6;0.0
09;2021-02-17;94;319;0;7077;3801;0;5.3;2.8;0.0
09;2021-02-18;91;434;0;7168;4235;0;5.3;3.1;0.0
09;2021-02-19;54;271;0;7222;4506;0;5.4;3.3;0.0
09;2021-02-20;45;172;0;7267;4678;0;5.4;3.5;0.0
09;2021-02-21;0;46;0;7267;4724;0;5.4;3.5;0.0
09;2021-02-22;119;226;0;7386;4950;0;5.5;3.7;0.0
09;2021-02-23;152;162;0;7538;5112;0;5.6;3.8;0.0
09;2021-02-24;80;181;0;7618;5293;0;5.7;3.9;0.0
09;2021-02-25;206;175;0;7824;5468;0;5.8;4.1;0.0
09;2021-02-26;146;167;0;7970;5635;0;5.9;4.2;0.0
09;2021-02-27;56;68;0;8026;5703;0;6.0;4.2;0.0
09;2021-02-28;25;15;0;8051;5718;0;6.0;4.2;0.0
09;2021-03-01;220;94;0;8271;5812;0;6.1;4.3;0.0
09;2021-03-02;261;88;0;8532;5900;0;6.3;4.4;0.0
09;2021-03-03;216;122;0;8748;6022;0;6.5;4.5;0.0
09;2021-03-04;374;48;0;9122;6070;0;6.8;4.5;0.0
09;2021-03-05;316;75;0;9438;6145;0;7.0;4.6;0.0
09;2021-03-06;353;39;0;9791;6184;0;7.3;4.6;0.0
09;2021-03-07;128;4;0;9919;6188;0;7.4;4.6;0.0
09;2021-03-08;327;68;0;10246;6256;0;7.6;4.6;0.0
09;2021-03-09;418;145;0;10664;6401;0;7.9;4.8;0.0
09;2021-03-10;523;82;0;11187;6483;0;8.3;4.8;0.0
09;2021-03-11;646;91;0;11833;6574;0;8.8;4.9;0.0
09;2021-03-12;627;35;0;12460;6609;0;9.3;4.9;0.0
09;2021-03-13;359;2;0;12819;6611;0;9.5;4.9;0.0
09;2021-03-14;101;5;0;12920;6616;0;9.6;4.9;0.0
09;2021-03-15;414;53;0;13334;6669;0;9.9;5.0;0.0
09;2021-03-16;313;89;0;13647;6758;0;10.1;5.0;0.0
09;2021-03-17;327;76;0;13974;6834;0;10.4;5.1;0.0
09;2021-03-18;390;39;0;14364;6873;0;10.7;5.1;0.0
09;2021-03-19;479;53;0;14843;6926;0;11.0;5.1;0.0
09;2021-03-20;281;37;0;15124;6963;0;11.2;5.2;0.0
09;2021-03-21;79;0;0;15203;6963;0;11.3;5.2;0.0
09;2021-03-22;373;116;0;15576;7079;0;11.6;5.3;0.0
09;2021-03-23;506;156;0;16082;7235;0;11.9;5.4;0.0
09;2021-03-24;664;39;0;16746;7274;0;12.4;5.4;0.0
09;2021-03-25;797;126;0;17543;7400;0;13.0;5.5;0.0
09;2021-03-26;692;41;0;18235;7441;0;13.5;5.5;0.0
09;2021-03-27;540;65;0;18775;7506;0;13.9;5.6;0.0
09;2021-03-28;123;15;0;18898;7521;0;14.0;5.6;0.0
09;2021-03-29;491;233;0;19389;7754;0;14.4;5.8;0.0
09;2021-03-30;786;145;0;20175;7899;0;15.0;5.9;0.0
09;2021-03-31;729;167;0;20904;8066;0;15.5;6.0;0.0
09;2021-04-01;695;226;0;21599;8292;0;16.0;6.2;0.0
09;2021-04-02;618;236;0;22217;8528;0;16.5;6.3;0.0
09;2021-04-03;604;90;0;22821;8618;0;16.9;6.4;0.0
09;2021-04-04;123;51;0;22944;8669;0;17.0;6.4;0.0
09;2021-04-05;207;57;0;23151;8726;0;17.2;6.5;0.0
09;2021-04-06;879;356;0;24030;9082;0;17.8;6.7;0.0
09;2021-04-07;970;321;0;25000;9403;0;18.6;7.0;0.0
09;2021-04-08;1223;374;0;26223;9777;0;19.5;7.3;0.0
09;2021-04-09;1003;352;0;27226;10129;0;20.2;7.5;0.0
09;2021-04-10;989;154;0;28215;10283;0;20.9;7.6;0.0
09;2021-04-11;169;87;0;28384;10370;0;21.1;7.7;0.0
09;2021-04-12;630;298;0;29014;10668;0;21.5;7.9;0.0
09;2021-04-13;915;369;0;29929;11037;0;22.2;8.2;0.0
09;2021-04-14;1123;419;0;31052;11456;0;23.1;8.5;0.0
09;2021-04-15;991;441;0;32043;11897;0;23.8;8.8;0.0
09;2021-04-16;869;364;0;32912;12261;0;24.4;9.1;0.0
09;2021-04-17;966;286;0;33878;12547;0;25.2;9.3;0.0
09;2021-04-18;96;85;0;33974;12632;0;25.2;9.4;0.0
09;2021-04-19;620;354;0;34594;12986;0;25.7;9.6;0.0
09;2021-04-20;738;478;0;35332;13464;0;26.2;10.0;0.0
09;2021-04-21;811;520;0;36143;13984;0;26.8;10.4;0.0
09;2021-04-22;598;534;0;36741;14518;0;27.3;10.8;0.0
09;2021-04-23;714;388;0;37455;14906;0;27.8;11.1;0.0
09;2021-04-24;617;542;0;38072;15448;0;28.3;11.5;0.0
09;2021-04-25;74;112;0;38146;15560;0;28.3;11.6;0.0
09;2021-04-26;382;477;0;38528;16037;0;28.6;11.9;0.0
09;2021-04-27;423;638;0;38951;16675;0;28.9;12.4;0.0
09;2021-04-28;745;687;0;39696;17362;0;29.5;12.9;0.0
09;2021-04-29;539;692;0;40235;18054;0;29.9;13.4;0.0
09;2021-04-30;589;558;0;40824;18612;0;30.3;13.8;0.0
09;2021-05-01;389;313;0;41213;18925;0;30.6;14.1;0.0
09;2021-05-02;59;100;0;41272;19025;0;30.6;14.1;0.0
09;2021-05-03;507;575;0;41779;19600;0;31.0;14.6;0.0
09;2021-05-04;532;1071;0;42311;20671;0;31.4;15.3;0.0
09;2021-05-05;709;984;0;43020;21655;0;31.9;16.1;0.0
09;2021-05-06;760;881;0;43780;22536;0;32.5;16.7;0.0
09;2021-05-07;858;669;0;44638;23205;0;33.1;17.2;0.0
09;2021-05-08;326;349;0;44964;23554;0;33.4;17.5;0.0
09;2021-05-09;197;87;0;45161;23641;0;33.5;17.6;0.0
09;2021-05-10;444;806;0;45605;24447;0;33.9;18.2;0.0
09;2021-05-11;645;883;0;46250;25330;0;34.3;18.8;0.0
09;2021-05-12;1146;1125;0;47396;26455;0;35.2;19.6;0.0
09;2021-05-13;895;322;0;48291;26777;0;35.9;19.9;0.0
09;2021-05-14;688;533;0;48979;27310;0;36.4;20.3;0.0
09;2021-05-15;784;553;0;49763;27863;0;36.9;20.7;0.0
09;2021-05-16;165;44;0;49928;27907;0;37.1;20.7;0.0
09;2021-05-17;596;384;0;50524;28291;0;37.5;21.0;0.0
09;2021-05-18;1004;398;0;51528;28689;0;38.3;21.3;0.0
09;2021-05-19;1070;348;0;52598;29037;0;39.1;21.6;0.0
09;2021-05-20;984;382;0;53582;29419;0;39.8;21.8;0.0
09;2021-05-21;764;429;0;54346;29848;0;40.4;22.2;0.0
09;2021-05-22;908;297;0;55254;30145;0;41.0;22.4;0.0
09;2021-05-23;117;17;0;55371;30162;0;41.1;22.4;0.0
09;2021-05-24;119;80;0;55490;30242;0;41.2;22.5;0.0
09;2021-05-25;758;478;0;56248;30720;0;41.8;22.8;0.0
09;2021-05-26;811;422;0;57059;31142;0;42.4;23.1;0.0
09;2021-05-27;595;366;0;57654;31508;0;42.8;23.4;0.0
09;2021-05-28;619;469;0;58273;31977;0;43.3;23.7;0.0
09;2021-05-29;821;536;0;59094;32513;0;43.9;24.1;0.0
09;2021-05-30;265;180;0;59359;32693;0;44.1;24.3;0.0
09;2021-05-31;438;557;0;59797;33250;0;44.4;24.7;0.0
09;2021-06-01;715;620;0;60512;33870;0;44.9;25.1;0.0
09;2021-06-02;796;783;0;61308;34653;0;45.5;25.7;0.0
09;2021-06-03;595;636;0;61903;35289;0;46.0;26.2;0.0
09;2021-06-04;708;754;0;62611;36043;0;46.5;26.8;0.0
09;2021-06-05;792;732;0;63403;36775;0;47.1;27.3;0.0
09;2021-06-06;179;92;0;63582;36867;0;47.2;27.4;0.0
09;2021-06-07;499;504;0;64081;37371;0;47.6;27.7;0.0
09;2021-06-08;715;489;0;64796;37860;0;48.1;28.1;0.0
09;2021-06-09;581;718;0;65377;38578;0;48.5;28.6;0.0
09;2021-06-10;507;541;0;65884;39119;0;48.9;29.0;0.0
09;2021-06-11;688;705;0;66572;39824;0;49.4;29.6;0.0
09;2021-06-12;429;603;0;67001;40427;0;49.7;30.0;0.0
09;2021-06-13;93;127;0;67094;40554;0;49.8;30.1;0.0
09;2021-06-14;501;661;0;67595;41215;0;50.2;30.6;0.0
09;2021-06-15;698;865;0;68293;42080;0;50.7;31.2;0.0
09;2021-06-16;475;875;0;68768;42955;0;51.1;31.9;0.0
09;2021-06-17;595;691;0;69363;43646;0;51.5;32.4;0.0
09;2021-06-18;524;975;0;69887;44621;0;51.9;33.1;0.0
09;2021-06-19;359;1102;0;70246;45723;0;52.2;33.9;0.0
09;2021-06-20;24;208;0;70270;45931;0;52.2;34.1;0.0
09;2021-06-21;387;611;0;70657;46542;0;52.5;34.6;0.0
09;2021-06-22;376;876;0;71033;47418;0;52.7;35.2;0.0
09;2021-06-23;325;889;0;71358;48307;0;53.0;35.9;0.0
09;2021-06-24;455;620;0;71813;48927;0;53.3;36.3;0.0
09;2021-06-25;370;781;0;72183;49708;0;53.6;36.9;0.0
09;2021-06-26;326;732;0;72509;50440;0;53.8;37.5;0.0
09;2021-06-27;10;154;0;72519;50594;0;53.8;37.6;0.0
09;2021-06-28;204;750;0;72723;51344;0;54.0;38.1;0.0
09;2021-06-29;255;974;0;72978;52318;0;54.2;38.8;0.0
09;2021-06-30;394;1127;0;73372;53445;0;54.5;39.7;0.0
09;2021-07-01;344;1114;0;73716;54559;0;54.7;40.5;0.0
09;2021-07-02;288;822;0;74004;55381;0;54.9;41.1;0.0
09;2021-07-03;174;978;0;74178;56359;0;55.1;41.8;0.0
09;2021-07-04;15;135;0;74193;56494;0;55.1;41.9;0.0
09;2021-07-05;190;559;0;74383;57053;0;55.2;42.4;0.0
09;2021-07-06;269;983;0;74652;58036;0;55.4;43.1;0.0
09;2021-07-07;345;950;0;74997;58986;0;55.7;43.8;0.0
09;2021-07-08;294;814;0;75291;59800;0;55.9;44.4;0.0
09;2021-07-09;287;825;0;75578;60625;0;56.1;45.0;0.0
09;2021-07-10;261;983;0;75839;61608;0;56.3;45.7;0.0
09;2021-07-11;135;231;0;75974;61839;0;56.4;45.9;0.0
09;2021-07-12;169;786;0;76143;62625;0;56.5;46.5;0.0
09;2021-07-13;607;1004;0;76750;63629;0;57.0;47.2;0.0
09;2021-07-14;402;159;0;77152;63788;0;57.3;47.4;0.0
09;2021-07-15;743;848;0;77895;64636;0;57.8;48.0;0.0
09;2021-07-16;558;987;0;78453;65623;0;58.3;48.7;0.0
09;2021-07-17;750;940;0;79203;66563;0;58.8;49.4;0.0
09;2021-07-18;296;183;0;79499;66746;0;59.0;49.6;0.0
09;2021-07-19;450;785;0;79949;67531;0;59.4;50.1;0.0
09;2021-07-20;724;1032;0;80673;68563;0;59.9;50.9;0.0
09;2021-07-21;849;937;0;81522;69500;0;60.5;51.6;0.0
09;2021-07-22;768;762;0;82290;70262;0;61.1;52.2;0.0
09;2021-07-23;679;748;0;82969;71010;0;61.6;52.7;0.0
09;2021-07-24;790;401;0;83759;71411;0;62.2;53.0;0.0
09;2021-07-25;502;129;0;84261;71540;0;62.6;53.1;0.0
09;2021-07-26;563;637;0;84824;72177;0;63.0;53.6;0.0
09;2021-07-27;1001;790;0;85825;72967;0;63.7;54.2;0.0
09;2021-07-28;967;761;0;86792;73728;0;64.4;54.7;0.0
09;2021-07-29;879;599;0;87671;74327;0;65.1;55.2;0.0
09;2021-07-30;686;527;0;88357;74854;0;65.6;55.6;0.0
09;2021-07-31;1116;335;0;89473;75189;0;66.4;55.8;0.0
09;2021-08-01;151;125;0;89624;75314;0;66.5;55.9;0.0
09;2021-08-02;736;418;0;90360;75732;0;67.1;56.2;0.0
09;2021-08-03;1058;686;0;91418;76418;0;67.9;56.7;0.0
09;2021-08-04;1110;525;0;92528;76943;0;68.7;57.1;0.0
09;2021-08-05;800;558;0;93328;77501;0;69.3;57.5;0.0
09;2021-08-06;860;558;0;94188;78059;0;69.9;58.0;0.0
09;2021-08-07;653;347;0;94841;78406;0;70.4;58.2;0.0
09;2021-08-08;122;151;0;94963;78557;0;70.5;58.3;0.0
09;2021-08-09;562;558;0;95525;79115;0;70.9;58.7;0.0
09;2021-08-10;803;619;0;96328;79734;0;71.5;59.2;0.0
09;2021-08-11;720;731;0;97048;80465;0;72.1;59.7;0.0
09;2021-08-12;526;654;0;97574;81119;0;72.4;60.2;0.0
09;2021-08-13;444;574;0;98018;81693;0;72.8;60.7;0.0
09;2021-08-14;281;673;0;98299;82366;0;73.0;61.2;0.0
09;2021-08-15;58;146;0;98357;82512;0;73.0;61.3;0.0
09;2021-08-16;466;553;0;98823;83065;0;73.4;61.7;0.0
09;2021-08-17;600;673;0;99423;83738;0;73.8;62.2;0.0
09;2021-08-18;502;770;0;99925;84508;0;74.2;62.7;0.0
09;2021-08-19;372;602;0;100297;85110;0;74.5;63.2;0.0
09;2021-08-20;338;675;0;100635;85785;0;74.7;63.7;0.0
09;2021-08-21;268;1117;0;100903;86902;0;74.9;64.5;0.0
09;2021-08-22;62;172;0;100965;87074;0;75.0;64.7;0.0
09;2021-08-23;295;684;0;101260;87758;0;75.2;65.2;0.0
09;2021-08-24;355;834;0;101615;88592;0;75.5;65.8;0.0
09;2021-08-25;225;806;0;101840;89398;0;75.6;66.4;0.0
09;2021-08-26;267;810;0;102107;90208;0;75.8;67.0;0.0
09;2021-08-27;224;687;0;102331;90895;0;76.0;67.5;0.0
09;2021-08-28;227;821;0;102558;91716;0;76.2;68.1;0.0
09;2021-08-29;19;138;0;102577;91854;0;76.2;68.2;0.0
09;2021-08-30;244;629;29;102821;92483;29;76.3;68.7;0.0
09;2021-08-31;283;952;69;103104;93435;98;76.6;69.4;0.1
09;2021-09-01;304;641;182;103408;94076;280;76.8;69.9;0.2
09;2021-09-02;153;442;92;103561;94518;372;76.9;70.2;0.3
09;2021-09-03;220;646;122;103781;95164;494;77.1;70.7;0.4
09;2021-09-04;141;415;59;103922;95579;553;77.2;71.0;0.4
09;2021-09-05;23;77;23;103945;95656;576;77.2;71.0;0.4
09;2021-09-06;165;457;121;104110;96113;697;77.3;71.4;0.5
09;2021-09-07;142;494;139;104252;96607;836;77.4;71.7;0.6
09;2021-09-08;178;694;81;104430;97301;917;77.5;72.2;0.7
09;2021-09-09;151;357;110;104581;97658;1027;77.7;72.5;0.8
09;2021-09-10;126;399;41;104707;98057;1068;77.7;72.8;0.8
09;2021-09-11;112;318;75;104819;98375;1143;77.8;73.0;0.8
09;2021-09-12;18;64;8;104837;98439;1151;77.8;73.1;0.9
09;2021-09-13;133;507;132;104970;98946;1283;77.9;73.5;1.0
09;2021-09-14;142;442;161;105112;99388;1444;78.0;73.8;1.1
09;2021-09-15;168;483;124;105280;99871;1568;78.2;74.2;1.2
09;2021-09-16;119;298;170;105399;100169;1738;78.3;74.4;1.3
09;2021-09-17;152;379;115;105551;100548;1853;78.4;74.7;1.4
09;2021-09-18;109;277;72;105660;100825;1925;78.5;74.9;1.4
09;2021-09-19;1;11;0;105661;100836;1925;78.5;74.9;1.4
09;2021-09-20;63;247;124;105724;101083;2049;78.5;75.1;1.5
09;2021-09-21;86;203;127;105810;101286;2176;78.6;75.2;1.6
09;2021-09-22;143;412;120;105953;101698;2296;78.7;75.5;1.7
09;2021-09-23;73;157;116;106026;101855;2412;78.7;75.6;1.8
09;2021-09-24;110;264;97;106136;102119;2509;78.8;75.8;1.9
09;2021-09-25;38;160;42;106174;102279;2551;78.8;75.9;1.9
09;2021-09-26;1;16;3;106175;102295;2554;78.8;76.0;1.9
09;2021-09-27;66;288;88;106241;102583;2642;78.9;76.2;2.0
09;2021-09-28;76;155;152;106317;102738;2794;78.9;76.3;2.1
09;2021-09-29;82;212;89;106399;102950;2883;79.0;76.4;2.1
09;2021-09-30;44;120;286;106443;103070;3169;79.0;76.5;2.4
09;2021-10-01;89;129;89;106532;103199;3258;79.1;76.6;2.4
09;2021-10-02;61;155;56;106593;103354;3314;79.1;76.7;2.5
09;2021-10-03;1;9;0;106594;103363;3314;79.1;76.7;2.5
09;2021-10-04;67;99;134;106661;103462;3448;79.2;76.8;2.6
09;2021-10-05;59;127;212;106720;103589;3660;79.2;76.9;2.7
09;2021-10-06;115;193;186;106835;103782;3846;79.3;77.1;2.9
09;2021-10-07;60;124;201;106895;103906;4047;79.4;77.2;3.0
09;2021-10-08;102;186;143;106997;104092;4190;79.4;77.3;3.1
09;2021-10-09;46;102;62;107043;104194;4252;79.5;77.4;3.2
09;2021-10-10;0;7;9;107043;104201;4261;79.5;77.4;3.2
09;2021-10-11;59;99;150;107102;104300;4411;79.5;77.4;3.3
09;2021-10-12;51;74;152;107153;104374;4563;79.6;77.5;3.4
09;2021-10-13;86;151;181;107239;104525;4744;79.6;77.6;3.5
09;2021-10-14;51;93;142;107290;104618;4886;79.7;77.7;3.6
09;2021-10-15;73;121;212;107363;104739;5098;79.7;77.8;3.8
09;2021-10-16;65;60;104;107428;104799;5202;79.8;77.8;3.9
09;2021-10-17;3;3;7;107431;104802;5209;79.8;77.8;3.9
09;2021-10-18;44;108;175;107475;104910;5384;79.8;77.9;4.0
09;2021-10-19;50;83;135;107525;104993;5519;79.8;78.0;4.1
09;2021-10-20;79;134;265;107604;105127;5784;79.9;78.1;4.3
09;2021-10-21;54;89;158;107658;105216;5942;79.9;78.1;4.4
09;2021-10-22;51;87;177;107709;105303;6119;80.0;78.2;4.5
09;2021-10-23;42;63;176;107751;105366;6295;80.0;78.2;4.7
09;2021-10-24;0;0;17;107751;105366;6312;80.0;78.2;4.7
09;2021-10-25;43;63;225;107794;105429;6537;80.0;78.3;4.9
09;2021-10-26;44;55;196;107838;105484;6733;80.1;78.3;5.0
09;2021-10-27;57;135;289;107895;105619;7022;80.1;78.4;5.2
09;2021-10-28;61;64;274;107956;105683;7296;80.2;78.5;5.4
09;2021-10-29;72;134;269;108028;105817;7565;80.2;78.6;5.6
09;2021-10-30;27;34;85;108055;105851;7650;80.2;78.6;5.7
09;2021-10-31;1;5;0;108056;105856;7650;80.2;78.6;5.7
09;2021-11-01;9;30;32;108065;105886;7682;80.2;78.6;5.7
09;2021-11-02;41;53;190;108106;105939;7872;80.3;78.7;5.8
09;2021-11-03;60;90;350;108166;106029;8222;80.3;78.7;6.1
09;2021-11-04;49;77;351;108215;106106;8573;80.4;78.8;6.4
09;2021-11-05;61;104;371;108276;106210;8944;80.4;78.9;6.6
09;2021-11-06;58;58;286;108334;106268;9230;80.4;78.9;6.9
09;2021-11-07;5;7;23;108339;106275;9253;80.4;78.9;6.9
09;2021-11-08;44;53;320;108383;106328;9573;80.5;78.9;7.1
09;2021-11-09;61;66;500;108444;106394;10073;80.5;79.0;7.5
09;2021-11-10;65;87;490;108509;106481;10563;80.6;79.1;7.8
09;2021-11-11;6;6;78;108515;106487;10641;80.6;79.1;7.9
09;2021-11-12;47;63;445;108562;106550;11086;80.6;79.1;8.2
09;2021-11-13;24;39;199;108586;106589;11285;80.6;79.1;8.4
09;2021-11-14;0;3;2;108586;106592;11287;80.6;79.1;8.4
09;2021-11-15;37;55;431;108623;106647;11718;80.7;79.2;8.7
09;2021-11-16;33;47;534;108656;106694;12252;80.7;79.2;9.1
09;2021-11-17;70;59;623;108726;106753;12875;80.7;79.3;9.6
09;2021-11-18;33;62;607;108759;106815;13482;80.8;79.3;10.0
09;2021-11-19;56;53;618;108815;106868;14100;80.8;79.4;10.5
09;2021-11-20;61;44;307;108876;106912;14407;80.8;79.4;10.7
09;2021-11-21;0;3;5;108876;106915;14412;80.8;79.4;10.7
09;2021-11-22;47;71;524;108923;106986;14936;80.9;79.4;11.1
09;2021-11-23;77;46;607;109000;107032;15543;80.9;79.5;11.5
09;2021-11-24;60;82;576;109060;107114;16119;81.0;79.5;12.0
09;2021-11-25;59;55;734;109119;107169;16853;81.0;79.6;12.5
09;2021-11-26;81;79;791;109200;107248;17644;81.1;79.6;13.1
09;2021-11-27;44;41;360;109244;107289;18004;81.1;79.7;13.4
09;2021-11-28;3;3;32;109247;107292;18036;81.1;79.7;13.4
09;2021-11-29;56;49;683;109303;107341;18719;81.2;79.7;13.9
09;2021-11-30;75;67;1160;109378;107408;19879;81.2;79.8;14.8
09;2021-12-01;38;56;985;109416;107464;20864;81.2;79.8;15.5
09;2021-12-02;65;46;1301;109481;107510;22165;81.3;79.8;16.5
09;2021-12-03;55;45;1148;109536;107555;23313;81.3;79.9;17.3
09;2021-12-04;43;41;465;109579;107596;23778;81.4;79.9;17.7
09;2021-12-05;2;4;195;109581;107600;23973;81.4;79.9;17.8
09;2021-12-06;38;44;903;109619;107644;24876;81.4;79.9;18.5
09;2021-12-07;53;43;1452;109672;107687;26328;81.4;80.0;19.5
09;2021-12-08;81;64;1334;109753;107751;27662;81.5;80.0;20.5
09;2021-12-09;73;62;1550;109826;107813;29212;81.5;80.1;21.7
09;2021-12-10;60;58;1619;109886;107871;30831;81.6;80.1;22.9
09;2021-12-11;72;30;1601;109958;107901;32432;81.6;80.1;24.1
09;2021-12-12;5;13;799;109963;107914;33231;81.6;80.1;24.7
09;2021-12-13;48;61;1159;110011;107975;34390;81.7;80.2;25.5
09;2021-12-14;68;81;1627;110079;108056;36017;81.7;80.2;26.7
09;2021-12-15;81;94;1467;110160;108150;37484;81.8;80.3;27.8
09;2021-12-16;83;69;1924;110243;108219;39408;81.9;80.4;29.3
09;2021-12-17;93;99;1528;110336;108318;40936;81.9;80.4;30.4
09;2021-12-18;69;55;1535;110405;108373;42471;82.0;80.5;31.5
09;2021-12-19;21;25;1010;110426;108398;43481;82.0;80.5;32.3
10;2020-12-27;0;0;0;0;0;0;0.0;0.0;0.0
10;2020-12-28;0;0;0;0;0;0;0.0;0.0;0.0
10;2020-12-29;0;0;0;0;0;0;0.0;0.0;0.0
10;2020-12-30;0;0;0;0;0;0;0.0;0.0;0.0
10;2020-12-31;0;0;0;0;0;0;0.0;0.0;0.0
10;2021-01-01;0;0;0;0;0;0;0.0;0.0;0.0
10;2021-01-02;1;0;0;1;0;0;0.0;0.0;0.0
10;2021-01-03;0;0;0;1;0;0;0.0;0.0;0.0
10;2021-01-04;0;0;0;1;0;0;0.0;0.0;0.0
10;2021-01-05;2;0;0;3;0;0;0.0;0.0;0.0
10;2021-01-06;1;0;0;4;0;0;0.0;0.0;0.0
10;2021-01-07;77;0;0;81;0;0;0.0;0.0;0.0
10;2021-01-08;237;0;0;318;0;0;0.1;0.0;0.0
10;2021-01-09;2;0;0;320;0;0;0.1;0.0;0.0
10;2021-01-10;1;0;0;321;0;0;0.1;0.0;0.0
10;2021-01-11;112;0;0;433;0;0;0.2;0.0;0.0
10;2021-01-12;182;0;0;615;0;0;0.2;0.0;0.0
10;2021-01-13;306;1;0;921;1;0;0.3;0.0;0.0
10;2021-01-14;368;9;0;1289;10;0;0.5;0.0;0.0
10;2021-01-15;367;3;0;1656;13;0;0.6;0.0;0.0
10;2021-01-16;56;0;0;1712;13;0;0.6;0.0;0.0
10;2021-01-17;0;0;0;1712;13;0;0.6;0.0;0.0
10;2021-01-18;625;3;0;2337;16;0;0.9;0.0;0.0
10;2021-01-19;1317;6;0;3654;22;0;1.4;0.0;0.0
10;2021-01-20;1093;8;0;4747;30;0;1.8;0.0;0.0
10;2021-01-21;1119;2;0;5866;32;0;2.2;0.0;0.0
10;2021-01-22;778;2;0;6644;34;0;2.5;0.0;0.0
10;2021-01-23;313;0;0;6957;34;0;2.6;0.0;0.0
10;2021-01-24;0;0;0;6957;34;0;2.6;0.0;0.0
10;2021-01-25;446;7;0;7403;41;0;2.8;0.0;0.0
10;2021-01-26;492;14;0;7895;55;0;3.0;0.0;0.0
10;2021-01-27;454;15;0;8349;70;0;3.1;0.0;0.0
10;2021-01-28;362;47;0;8711;117;0;3.3;0.0;0.0
10;2021-01-29;417;177;0;9128;294;0;3.4;0.1;0.0
10;2021-01-30;33;0;0;9161;294;0;3.4;0.1;0.0
10;2021-01-31;0;0;0;9161;294;0;3.4;0.1;0.0
10;2021-02-01;397;139;0;9558;433;0;3.6;0.2;0.0
10;2021-02-02;183;147;0;9741;580;0;3.7;0.2;0.0
10;2021-02-03;351;188;0;10092;768;0;3.8;0.3;0.0
10;2021-02-04;342;249;0;10434;1017;0;3.9;0.4;0.0
10;2021-02-05;309;308;0;10743;1325;0;4.0;0.5;0.0
10;2021-02-06;6;37;0;10749;1362;0;4.0;0.5;0.0
10;2021-02-07;0;0;0;10749;1362;0;4.0;0.5;0.0
10;2021-02-08;179;392;0;10928;1754;0;4.1;0.7;0.0
10;2021-02-09;454;574;0;11382;2328;0;4.3;0.9;0.0
10;2021-02-10;632;491;0;12014;2819;0;4.5;1.1;0.0
10;2021-02-11;729;577;0;12743;3396;0;4.8;1.3;0.0
10;2021-02-12;570;501;0;13313;3897;0;5.0;1.5;0.0
10;2021-02-13;34;113;0;13347;4010;0;5.0;1.5;0.0
10;2021-02-14;3;2;0;13350;4012;0;5.0;1.5;0.0
10;2021-02-15;137;444;0;13487;4456;0;5.1;1.7;0.0
10;2021-02-16;111;544;0;13598;5000;0;5.1;1.9;0.0
10;2021-02-17;138;599;0;13736;5599;0;5.2;2.1;0.0
10;2021-02-18;213;558;0;13949;6157;0;5.2;2.3;0.0
10;2021-02-19;190;450;0;14139;6607;0;5.3;2.5;0.0
10;2021-02-20;24;193;0;14163;6800;0;5.3;2.6;0.0
10;2021-02-21;0;0;0;14163;6800;0;5.3;2.6;0.0
10;2021-02-22;83;445;0;14246;7245;0;5.3;2.7;0.0
10;2021-02-23;86;553;0;14332;7798;0;5.4;2.9;0.0
10;2021-02-24;125;376;0;14457;8174;0;5.4;3.1;0.0
10;2021-02-25;340;379;0;14797;8553;0;5.6;3.2;0.0
10;2021-02-26;350;283;0;15147;8836;0;5.7;3.3;0.0
10;2021-02-27;255;124;0;15402;8960;0;5.8;3.4;0.0
10;2021-02-28;0;1;0;15402;8961;0;5.8;3.4;0.0
10;2021-03-01;258;324;0;15660;9285;0;5.9;3.5;0.0
10;2021-03-02;437;352;0;16097;9637;0;6.0;3.6;0.0
10;2021-03-03;465;571;0;16562;10208;0;6.2;3.8;0.0
10;2021-03-04;588;470;0;17150;10678;0;6.4;4.0;0.0
10;2021-03-05;679;270;0;17829;10948;0;6.7;4.1;0.0
10;2021-03-06;922;44;0;18751;10992;0;7.0;4.1;0.0
10;2021-03-07;744;6;0;19495;10998;0;7.3;4.1;0.0
10;2021-03-08;507;435;0;20002;11433;0;7.5;4.3;0.0
10;2021-03-09;644;400;0;20646;11833;0;7.7;4.4;0.0
10;2021-03-10;656;359;0;21302;12192;0;8.0;4.6;0.0
10;2021-03-11;1122;225;0;22424;12417;0;8.4;4.7;0.0
10;2021-03-12;1275;246;0;23699;12663;0;8.9;4.7;0.0
10;2021-03-13;881;34;0;24580;12697;0;9.2;4.8;0.0
10;2021-03-14;1326;20;0;25906;12717;0;9.7;4.8;0.0
10;2021-03-15;810;76;0;26716;12793;0;10.0;4.8;0.0
10;2021-03-16;681;64;0;27397;12857;0;10.3;4.8;0.0
10;2021-03-17;770;67;0;28167;12924;0;10.6;4.8;0.0
10;2021-03-18;832;74;0;28999;12998;0;10.9;4.9;0.0
10;2021-03-19;916;76;0;29915;13074;0;11.2;4.9;0.0
10;2021-03-20;536;16;0;30451;13090;0;11.4;4.9;0.0
10;2021-03-21;1767;43;0;32218;13133;0;12.1;4.9;0.0
10;2021-03-22;816;71;0;33034;13204;0;12.4;5.0;0.0
10;2021-03-23;1181;93;0;34215;13297;0;12.8;5.0;0.0
10;2021-03-24;1272;62;0;35487;13359;0;13.3;5.0;0.0
10;2021-03-25;1605;211;0;37092;13570;0;13.9;5.1;0.0
10;2021-03-26;1380;121;0;38472;13691;0;14.4;5.1;0.0
10;2021-03-27;781;75;0;39253;13766;0;14.7;5.2;0.0
10;2021-03-28;1197;29;0;40450;13795;0;15.2;5.2;0.0
10;2021-03-29;653;304;0;41103;14099;0;15.4;5.3;0.0
10;2021-03-30;916;372;0;42019;14471;0;15.8;5.4;0.0
10;2021-03-31;625;360;0;42644;14831;0;16.0;5.6;0.0
10;2021-04-01;896;667;0;43540;15498;0;16.3;5.8;0.0
10;2021-04-02;1077;582;0;44617;16080;0;16.7;6.0;0.0
10;2021-04-03;560;554;0;45177;16634;0;16.9;6.2;0.0
10;2021-04-04;1746;248;0;46923;16882;0;17.6;6.3;0.0
10;2021-04-05;1731;43;0;48654;16925;0;18.2;6.3;0.0
10;2021-04-06;525;627;0;49179;17552;0;18.4;6.6;0.0
10;2021-04-07;580;524;0;49759;18076;0;18.7;6.8;0.0
10;2021-04-08;1057;582;0;50816;18658;0;19.1;7.0;0.0
10;2021-04-09;1143;584;0;51959;19242;0;19.5;7.2;0.0
10;2021-04-10;1726;344;0;53685;19586;0;20.1;7.3;0.0
10;2021-04-11;70;1225;0;53755;20811;0;20.2;7.8;0.0
10;2021-04-12;984;782;0;54739;21593;0;20.5;8.1;0.0
10;2021-04-13;1459;870;0;56198;22463;0;21.1;8.4;0.0
10;2021-04-14;850;597;0;57048;23060;0;21.4;8.6;0.0
10;2021-04-15;1415;847;0;58463;23907;0;21.9;9.0;0.0
10;2021-04-16;1106;678;0;59569;24585;0;22.3;9.2;0.0
10;2021-04-17;2233;353;0;61802;24938;0;23.2;9.4;0.0
10;2021-04-18;1336;1713;0;63138;26651;0;23.7;10.0;0.0
10;2021-04-19;828;774;0;63966;27425;0;24.0;10.3;0.0
10;2021-04-20;557;951;0;64523;28376;0;24.2;10.6;0.0
10;2021-04-21;613;968;0;65136;29344;0;24.4;11.0;0.0
10;2021-04-22;890;942;0;66026;30286;0;24.8;11.4;0.0
10;2021-04-23;2023;755;0;68049;31041;0;25.5;11.6;0.0
10;2021-04-24;2090;400;0;70139;31441;0;26.3;11.8;0.0
10;2021-04-25;1867;1178;0;72006;32619;0;27.0;12.2;0.0
10;2021-04-26;714;636;0;72720;33255;0;27.3;12.5;0.0
10;2021-04-27;850;544;0;73570;33799;0;27.6;12.7;0.0
10;2021-04-28;861;400;0;74431;34199;0;27.9;12.8;0.0
10;2021-04-29;1435;677;0;75866;34876;0;28.5;13.1;0.0
10;2021-04-30;2083;785;0;77949;35661;0;29.2;13.4;0.0
10;2021-05-01;1847;2040;0;79796;37701;0;29.9;14.1;0.0
10;2021-05-02;1833;1810;0;81629;39511;0;30.6;14.8;0.0
10;2021-05-03;567;477;0;82196;39988;0;30.8;15.0;0.0
10;2021-05-04;1078;1241;0;83274;41229;0;31.2;15.5;0.0
10;2021-05-05;1708;1005;0;84982;42234;0;31.9;15.8;0.0
10;2021-05-06;2195;952;0;87177;43186;0;32.7;16.2;0.0
10;2021-05-07;2152;1104;0;89329;44290;0;33.5;16.6;0.0
10;2021-05-08;2163;892;0;91492;45182;0;34.3;16.9;0.0
10;2021-05-09;1884;106;0;93376;45288;0;35.0;17.0;0.0
10;2021-05-10;535;1093;0;93911;46381;0;35.2;17.4;0.0
10;2021-05-11;1056;1029;0;94967;47410;0;35.6;17.8;0.0
10;2021-05-12;1965;869;0;96932;48279;0;36.4;18.1;0.0
10;2021-05-13;2078;419;0;99010;48698;0;37.1;18.3;0.0
10;2021-05-14;2514;643;0;101524;49341;0;38.1;18.5;0.0
10;2021-05-15;2249;1903;0;103773;51244;0;38.9;19.2;0.0
10;2021-05-16;1885;1350;0;105658;52594;0;39.6;19.7;0.0
10;2021-05-17;1421;446;0;107079;53040;0;40.2;19.9;0.0
10;2021-05-18;2384;594;0;109463;53634;0;41.1;20.1;0.0
10;2021-05-19;1515;629;0;110978;54263;0;41.6;20.4;0.0
10;2021-05-20;1783;819;0;112761;55082;0;42.3;20.7;0.0
10;2021-05-21;2174;608;0;114935;55690;0;43.1;20.9;0.0
10;2021-05-22;2018;407;0;116953;56097;0;43.9;21.0;0.0
10;2021-05-23;1550;125;0;118503;56222;0;44.4;21.1;0.0
10;2021-05-24;1689;162;0;120192;56384;0;45.1;21.1;0.0
10;2021-05-25;1750;486;0;121942;56870;0;45.7;21.3;0.0
10;2021-05-26;1492;416;0;123434;57286;0;46.3;21.5;0.0
10;2021-05-27;1515;724;0;124949;58010;0;46.9;21.8;0.0
10;2021-05-28;1580;1143;0;126529;59153;0;47.5;22.2;0.0
10;2021-05-29;1849;615;0;128378;59768;0;48.2;22.4;0.0
10;2021-05-30;893;126;0;129271;59894;0;48.5;22.5;0.0
10;2021-05-31;1014;745;0;130285;60639;0;48.9;22.7;0.0
10;2021-06-01;1120;859;0;131405;61498;0;49.3;23.1;0.0
10;2021-06-02;1023;698;0;132428;62196;0;49.7;23.3;0.0
10;2021-06-03;1364;1028;0;133792;63224;0;50.2;23.7;0.0
10;2021-06-04;1728;2469;0;135520;65693;0;50.8;24.6;0.0
10;2021-06-05;1363;2256;0;136883;67949;0;51.3;25.5;0.0
10;2021-06-06;931;1741;0;137814;69690;0;51.7;26.1;0.0
10;2021-06-07;722;1087;0;138536;70777;0;52.0;26.5;0.0
10;2021-06-08;909;1108;0;139445;71885;0;52.3;27.0;0.0
10;2021-06-09;878;922;0;140323;72807;0;52.6;27.3;0.0
10;2021-06-10;724;1006;0;141047;73813;0;52.9;27.7;0.0
10;2021-06-11;1181;2115;0;142228;75928;0;53.3;28.5;0.0
10;2021-06-12;862;2258;0;143090;78186;0;53.7;29.3;0.0
10;2021-06-13;378;1724;0;143468;79910;0;53.8;30.0;0.0
10;2021-06-14;551;713;0;144019;80623;0;54.0;30.2;0.0
10;2021-06-15;735;2035;0;144754;82658;0;54.3;31.0;0.0
10;2021-06-16;766;1845;0;145520;84503;0;54.6;31.7;0.0
10;2021-06-17;856;2358;0;146376;86861;0;54.9;32.6;0.0
10;2021-06-18;1043;2471;0;147419;89332;0;55.3;33.5;0.0
10;2021-06-19;981;2423;0;148400;91755;0;55.7;34.4;0.0
10;2021-06-20;517;1491;0;148917;93246;0;55.9;35.0;0.0
10;2021-06-21;651;1030;0;149568;94276;0;56.1;35.4;0.0
10;2021-06-22;703;1500;1;150271;95776;1;56.4;35.9;0.0
10;2021-06-23;672;2300;0;150943;98076;1;56.6;36.8;0.0
10;2021-06-24;788;2473;0;151731;100549;1;56.9;37.7;0.0
10;2021-06-25;720;2873;0;152451;103422;1;57.2;38.8;0.0
10;2021-06-26;504;2522;0;152955;105944;1;57.4;39.7;0.0
10;2021-06-27;404;1787;0;153359;107731;1;57.5;40.4;0.0
10;2021-06-28;632;1660;0;153991;109391;1;57.8;41.0;0.0
10;2021-06-29;616;2535;0;154607;111926;1;58.0;42.0;0.0
10;2021-06-30;573;1540;0;155180;113466;1;58.2;42.6;0.0
10;2021-07-01;579;2025;0;155759;115491;1;58.4;43.3;0.0
10;2021-07-02;704;2579;0;156463;118070;1;58.7;44.3;0.0
10;2021-07-03;529;2391;0;156992;120461;1;58.9;45.2;0.0
10;2021-07-04;400;1526;0;157392;121987;1;59.0;45.8;0.0
10;2021-07-05;664;2044;1;158056;124031;2;59.3;46.5;0.0
10;2021-07-06;675;1900;4;158731;125931;6;59.5;47.2;0.0
10;2021-07-07;660;1634;1;159391;127565;7;59.8;47.8;0.0
10;2021-07-08;750;1422;0;160141;128987;7;60.1;48.4;0.0
10;2021-07-09;812;1896;0;160953;130883;7;60.4;49.1;0.0
10;2021-07-10;637;1870;0;161590;132753;7;60.6;49.8;0.0
10;2021-07-11;491;1258;0;162081;134011;7;60.8;50.3;0.0
10;2021-07-12;775;1587;0;162856;135598;7;61.1;50.9;0.0
10;2021-07-13;1125;1834;0;163981;137432;7;61.5;51.5;0.0
10;2021-07-14;1161;1035;0;165142;138467;7;61.9;51.9;0.0
10;2021-07-15;1437;1993;0;166579;140460;7;62.5;52.7;0.0
10;2021-07-16;1303;2198;0;167882;142658;7;63.0;53.5;0.0
10;2021-07-17;1224;1641;0;169106;144299;7;63.4;54.1;0.0
10;2021-07-18;918;1167;0;170024;145466;7;63.8;54.6;0.0
10;2021-07-19;1359;1598;0;171383;147064;7;64.3;55.2;0.0
10;2021-07-20;1688;1469;0;173071;148533;7;64.9;55.7;0.0
10;2021-07-21;1452;1504;0;174523;150037;7;65.5;56.3;0.0
10;2021-07-22;1923;1596;0;176446;151633;7;66.2;56.9;0.0
10;2021-07-23;1697;1581;0;178143;153214;7;66.8;57.5;0.0
10;2021-07-24;1371;1240;0;179514;154454;7;67.3;57.9;0.0
10;2021-07-25;1223;763;0;180737;155217;7;67.8;58.2;0.0
10;2021-07-26;1807;1309;0;182544;156526;7;68.5;58.7;0.0
10;2021-07-27;2095;1080;0;184639;157606;7;69.3;59.1;0.0
10;2021-07-28;2130;1031;0;186769;158637;7;70.1;59.5;0.0
10;2021-07-29;2299;1161;0;189068;159798;7;70.9;59.9;0.0
10;2021-07-30;2156;1259;0;191224;161057;7;71.7;60.4;0.0
10;2021-07-31;1584;950;0;192808;162007;7;72.3;60.8;0.0
10;2021-08-01;1203;562;0;194011;162569;7;72.8;61.0;0.0
10;2021-08-02;1380;1283;0;195391;163852;7;73.3;61.5;0.0
10;2021-08-03;1523;919;0;196914;164771;7;73.9;61.8;0.0
10;2021-08-04;1306;1071;0;198220;165842;7;74.3;62.2;0.0
10;2021-08-05;1565;1278;0;199785;167120;7;74.9;62.7;0.0
10;2021-08-06;1735;1348;0;201520;168468;7;75.6;63.2;0.0
10;2021-08-07;1107;1082;0;202627;169550;7;76.0;63.6;0.0
10;2021-08-08;636;716;0;203263;170266;7;76.2;63.9;0.0
10;2021-08-09;1262;1453;0;204525;171719;7;76.7;64.4;0.0
10;2021-08-10;1529;1359;0;206054;173078;7;77.3;64.9;0.0
10;2021-08-11;827;1128;0;206881;174206;7;77.6;65.3;0.0
10;2021-08-12;997;1274;0;207878;175480;7;78.0;65.8;0.0
10;2021-08-13;741;1157;0;208619;176637;7;78.2;66.3;0.0
10;2021-08-14;587;1198;0;209206;177835;7;78.5;66.7;0.0
10;2021-08-15;270;771;0;209476;178606;7;78.6;67.0;0.0
10;2021-08-16;663;1589;0;210139;180195;7;78.8;67.6;0.0
10;2021-08-17;769;1728;0;210908;181923;7;79.1;68.2;0.0
10;2021-08-18;702;1610;0;211610;183533;7;79.4;68.8;0.0
10;2021-08-19;530;1542;0;212140;185075;7;79.6;69.4;0.0
10;2021-08-20;585;1765;0;212725;186840;7;79.8;70.1;0.0
10;2021-08-21;438;1410;0;213163;188250;7;80.0;70.6;0.0
10;2021-08-22;199;1010;0;213362;189260;7;80.0;71.0;0.0
10;2021-08-23;475;1603;0;213837;190863;7;80.2;71.6;0.0
10;2021-08-24;617;1721;0;214454;192584;7;80.4;72.2;0.0
10;2021-08-25;473;1389;0;214927;193973;7;80.6;72.8;0.0
10;2021-08-26;437;1511;0;215364;195484;7;80.8;73.3;0.0
10;2021-08-27;588;1633;0;215952;197117;7;81.0;73.9;0.0
10;2021-08-28;383;1306;0;216335;198423;7;81.1;74.4;0.0
10;2021-08-29;222;910;0;216557;199333;7;81.2;74.8;0.0
10;2021-08-30;414;1422;15;216971;200755;22;81.4;75.3;0.0
10;2021-08-31;471;1395;24;217442;202150;46;81.6;75.8;0.0
10;2021-09-01;335;1108;100;217777;203258;146;81.7;76.2;0.1
10;2021-09-02;281;936;177;218058;204194;323;81.8;76.6;0.1
10;2021-09-03;429;1074;158;218487;205268;481;81.9;77.0;0.2
10;2021-09-04;332;1023;83;218819;206291;564;82.1;77.4;0.2
10;2021-09-05;161;360;56;218980;206651;620;82.1;77.5;0.2
10;2021-09-06;256;585;166;219236;207236;786;82.2;77.7;0.3
10;2021-09-07;308;581;161;219544;207817;947;82.3;77.9;0.4
10;2021-09-08;272;582;121;219816;208399;1068;82.4;78.2;0.4
10;2021-09-09;312;681;219;220128;209080;1287;82.6;78.4;0.5
10;2021-09-10;411;740;151;220539;209820;1438;82.7;78.7;0.5
10;2021-09-11;272;648;88;220811;210468;1526;82.8;78.9;0.6
10;2021-09-12;85;194;20;220896;210662;1546;82.9;79.0;0.6
10;2021-09-13;214;400;216;221110;211062;1762;82.9;79.2;0.7
10;2021-09-14;238;548;426;221348;211610;2188;83.0;79.4;0.8
10;2021-09-15;223;468;308;221571;212078;2496;83.1;79.5;0.9
10;2021-09-16;271;419;335;221842;212497;2831;83.2;79.7;1.1
10;2021-09-17;246;726;242;222088;213223;3073;83.3;80.0;1.2
10;2021-09-18;197;549;71;222285;213772;3144;83.4;80.2;1.2
10;2021-09-19;53;208;34;222338;213980;3178;83.4;80.3;1.2
10;2021-09-20;128;496;242;222466;214476;3420;83.4;80.4;1.3
10;2021-09-21;155;499;237;222621;214975;3657;83.5;80.6;1.4
10;2021-09-22;136;320;195;222757;215295;3852;83.6;80.8;1.4
10;2021-09-23;207;340;279;222964;215635;4131;83.6;80.9;1.5
10;2021-09-24;216;514;251;223180;216149;4382;83.7;81.1;1.6
10;2021-09-25;123;431;80;223303;216580;4462;83.8;81.2;1.7
10;2021-09-26;50;186;24;223353;216766;4486;83.8;81.3;1.7
10;2021-09-27;219;261;216;223572;217027;4702;83.9;81.4;1.8
10;2021-09-28;193;326;381;223765;217353;5083;83.9;81.5;1.9
10;2021-09-29;191;277;204;223956;217630;5287;84.0;81.6;2.0
10;2021-09-30;164;203;225;224120;217833;5512;84.1;81.7;2.1
10;2021-10-01;207;450;276;224327;218283;5788;84.1;81.9;2.2
10;2021-10-02;172;303;139;224499;218586;5927;84.2;82.0;2.2
10;2021-10-03;55;101;25;224554;218687;5952;84.2;82.0;2.2
10;2021-10-04;118;201;250;224672;218888;6202;84.3;82.1;2.3
10;2021-10-05;112;215;353;224784;219103;6555;84.3;82.2;2.5
10;2021-10-06;126;209;195;224910;219312;6750;84.4;82.3;2.5
10;2021-10-07;128;309;365;225038;219621;7115;84.4;82.4;2.7
10;2021-10-08;170;268;307;225208;219889;7422;84.5;82.5;2.8
10;2021-10-09;145;245;147;225353;220134;7569;84.5;82.6;2.8
10;2021-10-10;49;78;67;225402;220212;7636;84.5;82.6;2.9
10;2021-10-11;113;192;306;225515;220404;7942;84.6;82.7;3.0
10;2021-10-12;118;190;399;225633;220594;8341;84.6;82.7;3.1
10;2021-10-13;130;187;378;225763;220781;8719;84.7;82.8;3.3
10;2021-10-14;122;207;456;225885;220988;9175;84.7;82.9;3.4
10;2021-10-15;145;285;437;226030;221273;9612;84.8;83.0;3.6
10;2021-10-16;117;184;153;226147;221457;9765;84.8;83.1;3.7
10;2021-10-17;40;50;32;226187;221507;9797;84.8;83.1;3.7
10;2021-10-18;101;161;423;226288;221668;10220;84.9;83.1;3.8
10;2021-10-19;105;196;461;226393;221864;10681;84.9;83.2;4.0
10;2021-10-20;118;180;489;226511;222044;11170;85.0;83.3;4.2
10;2021-10-21;103;220;616;226614;222264;11786;85.0;83.4;4.4
10;2021-10-22;146;224;486;226760;222488;12272;85.1;83.5;4.6
10;2021-10-23;87;185;282;226847;222673;12554;85.1;83.5;4.7
10;2021-10-24;36;43;70;226883;222716;12624;85.1;83.5;4.7
10;2021-10-25;96;124;453;226979;222840;13077;85.1;83.6;4.9
10;2021-10-26;99;124;562;227078;222964;13639;85.2;83.6;5.1
10;2021-10-27;74;132;421;227152;223096;14060;85.2;83.7;5.3
10;2021-10-28;51;94;454;227203;223190;14514;85.2;83.7;5.4
10;2021-10-29;97;172;442;227300;223362;14956;85.3;83.8;5.6
10;2021-10-30;81;119;206;227381;223481;15162;85.3;83.8;5.7
10;2021-10-31;27;44;127;227408;223525;15289;85.3;83.8;5.7
10;2021-11-01;25;18;34;227433;223543;15323;85.3;83.8;5.7
10;2021-11-02;105;132;602;227538;223675;15925;85.3;83.9;6.0
10;2021-11-03;77;117;641;227615;223792;16566;85.4;83.9;6.2
10;2021-11-04;87;96;777;227702;223888;17343;85.4;84.0;6.5
10;2021-11-05;128;184;703;227830;224072;18046;85.5;84.0;6.8
10;2021-11-06;84;115;389;227914;224187;18435;85.5;84.1;6.9
10;2021-11-07;23;48;170;227937;224235;18605;85.5;84.1;7.0
10;2021-11-08;63;95;719;228000;224330;19324;85.5;84.1;7.2
10;2021-11-09;82;130;973;228082;224460;20297;85.5;84.2;7.6
10;2021-11-10;95;143;819;228177;224603;21116;85.6;84.2;7.9
10;2021-11-11;6;6;39;228183;224609;21155;85.6;84.2;7.9
10;2021-11-12;101;138;719;228284;224747;21874;85.6;84.3;8.2
10;2021-11-13;81;92;663;228365;224839;22537;85.7;84.3;8.5
10;2021-11-14;34;45;260;228399;224884;22797;85.7;84.3;8.6
10;2021-11-15;77;115;933;228476;224999;23730;85.7;84.4;8.9
10;2021-11-16;81;108;1196;228557;225107;24926;85.7;84.4;9.3
10;2021-11-17;100;100;991;228657;225207;25917;85.8;84.5;9.7
10;2021-11-18;62;99;1028;228719;225306;26945;85.8;84.5;10.1
10;2021-11-19;127;146;1058;228846;225452;28003;85.8;84.6;10.5
10;2021-11-20;109;151;963;228955;225603;28966;85.9;84.6;10.9
10;2021-11-21;48;35;250;229003;225638;29216;85.9;84.6;11.0
10;2021-11-22;79;71;832;229082;225709;30048;85.9;84.7;11.3
10;2021-11-23;84;94;1308;229166;225803;31356;86.0;84.7;11.8
10;2021-11-24;106;96;1004;229272;225899;32360;86.0;84.7;12.1
10;2021-11-25;90;72;1246;229362;225971;33606;86.0;84.8;12.6
10;2021-11-26;143;166;1663;229505;226137;35269;86.1;84.8;13.2
10;2021-11-27;130;116;1498;229635;226253;36767;86.1;84.9;13.8
10;2021-11-28;43;32;519;229678;226285;37286;86.1;84.9;14.0
10;2021-11-29;79;85;2083;229757;226370;39369;86.2;84.9;14.8
10;2021-11-30;126;101;2680;229883;226471;42049;86.2;84.9;15.8
10;2021-12-01;96;85;2273;229979;226556;44322;86.3;85.0;16.6
10;2021-12-02;82;60;2842;230061;226616;47164;86.3;85.0;17.7
10;2021-12-03;111;107;2900;230172;226723;50064;86.3;85.0;18.8
10;2021-12-04;106;101;2065;230278;226824;52129;86.4;85.1;19.6
10;2021-12-05;46;41;1165;230324;226865;53294;86.4;85.1;20.0
10;2021-12-06;71;88;2759;230395;226953;56053;86.4;85.1;21.0
10;2021-12-07;95;88;3684;230490;227041;59737;86.5;85.2;22.4
10;2021-12-08;102;105;2684;230592;227146;62421;86.5;85.2;23.4
10;2021-12-09;87;101;3427;230679;227247;65848;86.5;85.2;24.7
10;2021-12-10;86;113;3775;230765;227360;69623;86.6;85.3;26.1
10;2021-12-11;108;119;2778;230873;227479;72401;86.6;85.3;27.2
10;2021-12-12;24;42;1411;230897;227521;73812;86.6;85.3;27.7
10;2021-12-13;76;107;3366;230973;227628;77178;86.6;85.4;28.9
10;2021-12-14;71;105;3835;231044;227733;81013;86.7;85.4;30.4
10;2021-12-15;62;132;3183;231106;227865;84196;86.7;85.5;31.6
10;2021-12-16;85;89;3337;231191;227954;87533;86.7;85.5;32.8
10;2021-12-17;121;128;3829;231312;228082;91362;86.8;85.5;34.3
10;2021-12-18;89;128;2590;231401;228210;93952;86.8;85.6;35.2
10;2021-12-19;50;54;1684;231451;228264;95636;86.8;85.6;35.9
11;2020-12-27;0;0;0;0;0;0;0.0;0.0;0.0
11;2020-12-28;0;0;0;0;0;0;0.0;0.0;0.0
11;2020-12-29;0;0;0;0;0;0;0.0;0.0;0.0
11;2020-12-30;0;0;0;0;0;0;0.0;0.0;0.0
11;2020-12-31;0;0;0;0;0;0;0.0;0.0;0.0
11;2021-01-01;1;0;0;1;0;0;0.0;0.0;0.0
11;2021-01-02;3;0;0;4;0;0;0.0;0.0;0.0
11;2021-01-03;0;0;0;4;0;0;0.0;0.0;0.0
11;2021-01-04;1;0;0;5;0;0;0.0;0.0;0.0
11;2021-01-05;89;1;0;94;1;0;0.0;0.0;0.0
11;2021-01-06;26;0;0;120;1;0;0.0;0.0;0.0
11;2021-01-07;115;0;0;235;1;0;0.1;0.0;0.0
11;2021-01-08;98;1;0;333;2;0;0.1;0.0;0.0
11;2021-01-09;85;0;0;418;2;0;0.1;0.0;0.0
11;2021-01-10;68;0;0;486;2;0;0.1;0.0;0.0
11;2021-01-11;149;0;0;635;2;0;0.2;0.0;0.0
11;2021-01-12;506;3;0;1141;5;0;0.3;0.0;0.0
11;2021-01-13;411;1;0;1552;6;0;0.5;0.0;0.0
11;2021-01-14;612;8;0;2164;14;0;0.7;0.0;0.0
11;2021-01-15;327;3;0;2491;17;0;0.8;0.0;0.0
11;2021-01-16;79;1;0;2570;18;0;0.8;0.0;0.0
11;2021-01-17;49;2;0;2619;20;0;0.8;0.0;0.0
11;2021-01-18;468;1;0;3087;21;0;0.9;0.0;0.0
11;2021-01-19;631;11;0;3718;32;0;1.1;0.0;0.0
11;2021-01-20;777;7;0;4495;39;0;1.4;0.0;0.0
11;2021-01-21;742;5;0;5237;44;0;1.6;0.0;0.0
11;2021-01-22;649;3;0;5886;47;0;1.8;0.0;0.0
11;2021-01-23;253;2;0;6139;49;0;1.9;0.0;0.0
11;2021-01-24;178;2;0;6317;51;0;1.9;0.0;0.0
11;2021-01-25;456;14;0;6773;65;0;2.1;0.0;0.0
11;2021-01-26;922;80;0;7695;145;0;2.4;0.0;0.0
11;2021-01-27;868;25;0;8563;170;0;2.6;0.1;0.0
11;2021-01-28;747;70;0;9310;240;0;2.8;0.1;0.0
11;2021-01-29;559;122;0;9869;362;0;3.0;0.1;0.0
11;2021-01-30;174;8;0;10043;370;0;3.1;0.1;0.0
11;2021-01-31;114;1;0;10157;371;0;3.1;0.1;0.0
11;2021-02-01;408;199;0;10565;570;0;3.2;0.2;0.0
11;2021-02-02;522;384;0;11087;954;0;3.4;0.3;0.0
11;2021-02-03;487;348;0;11574;1302;0;3.5;0.4;0.0
11;2021-02-04;498;488;0;12072;1790;0;3.7;0.5;0.0
11;2021-02-05;429;335;0;12501;2125;0;3.8;0.6;0.0
11;2021-02-06;238;61;0;12739;2186;0;3.9;0.7;0.0
11;2021-02-07;122;21;0;12861;2207;0;3.9;0.7;0.0
11;2021-02-08;377;207;0;13238;2414;0;4.0;0.7;0.0
11;2021-02-09;368;321;0;13606;2735;0;4.2;0.8;0.0
11;2021-02-10;413;451;0;14019;3186;0;4.3;1.0;0.0
11;2021-02-11;581;653;0;14600;3839;0;4.5;1.2;0.0
11;2021-02-12;482;416;0;15082;4255;0;4.6;1.3;0.0
11;2021-02-13;192;146;0;15274;4401;0;4.7;1.3;0.0
11;2021-02-14;73;60;0;15347;4461;0;4.7;1.4;0.0
11;2021-02-15;262;270;0;15609;4731;0;4.8;1.4;0.0
11;2021-02-16;304;555;0;15913;5286;0;4.9;1.6;0.0
11;2021-02-17;467;665;0;16380;5951;0;5.0;1.8;0.0
11;2021-02-18;469;599;0;16849;6550;0;5.1;2.0;0.0
11;2021-02-19;336;564;0;17185;7114;0;5.3;2.2;0.0
11;2021-02-20;153;126;0;17338;7240;0;5.3;2.2;0.0
11;2021-02-21;62;61;0;17400;7301;0;5.3;2.2;0.0
11;2021-02-22;141;403;0;17541;7704;0;5.4;2.4;0.0
11;2021-02-23;311;426;0;17852;8130;0;5.5;2.5;0.0
11;2021-02-24;272;443;0;18124;8573;0;5.5;2.6;0.0
11;2021-02-25;595;463;0;18719;9036;0;5.7;2.8;0.0
11;2021-02-26;591;413;0;19310;9449;0;5.9;2.9;0.0
11;2021-02-27;337;148;0;19647;9597;0;6.0;2.9;0.0
11;2021-02-28;101;54;0;19748;9651;0;6.0;2.9;0.0
11;2021-03-01;344;334;0;20092;9985;0;6.1;3.1;0.0
11;2021-03-02;554;396;0;20646;10381;0;6.3;3.2;0.0
11;2021-03-03;614;430;0;21260;10811;0;6.5;3.3;0.0
11;2021-03-04;1076;403;0;22336;11214;0;6.8;3.4;0.0
11;2021-03-05;1015;426;0;23351;11640;0;7.1;3.6;0.0
11;2021-03-06;1094;202;0;24445;11842;0;7.5;3.6;0.0
11;2021-03-07;708;39;0;25153;11881;0;7.7;3.6;0.0
11;2021-03-08;428;362;0;25581;12243;0;7.8;3.7;0.0
11;2021-03-09;1004;416;0;26585;12659;0;8.1;3.9;0.0
11;2021-03-10;1194;536;0;27779;13195;0;8.5;4.0;0.0
11;2021-03-11;1568;464;0;29347;13659;0;9.0;4.2;0.0
11;2021-03-12;1475;440;0;30822;14099;0;9.4;4.3;0.0
11;2021-03-13;1155;223;0;31977;14322;0;9.8;4.4;0.0
11;2021-03-14;522;54;0;32499;14376;0;9.9;4.4;0.0
11;2021-03-15;706;247;0;33205;14623;0;10.1;4.5;0.0
11;2021-03-16;853;206;0;34058;14829;0;10.4;4.5;0.0
11;2021-03-17;916;231;0;34974;15060;0;10.7;4.6;0.0
11;2021-03-18;1124;307;0;36098;15367;0;11.0;4.7;0.0
11;2021-03-19;1328;245;0;37426;15612;0;11.4;4.8;0.0
11;2021-03-20;766;164;0;38192;15776;0;11.7;4.8;0.0
11;2021-03-21;218;67;0;38410;15843;0;11.7;4.8;0.0
11;2021-03-22;788;241;0;39198;16084;0;12.0;4.9;0.0
11;2021-03-23;1769;389;0;40967;16473;0;12.5;5.0;0.0
11;2021-03-24;1794;324;0;42761;16797;0;13.1;5.1;0.0
11;2021-03-25;2153;344;0;44914;17141;0;13.7;5.2;0.0
11;2021-03-26;2074;447;0;46988;17588;0;14.4;5.4;0.0
11;2021-03-27;1143;152;0;48131;17740;0;14.7;5.4;0.0
11;2021-03-28;255;50;0;48386;17790;0;14.8;5.4;0.0
11;2021-03-29;1156;244;0;49542;18034;0;15.1;5.5;0.0
11;2021-03-30;1986;330;0;51528;18364;0;15.7;5.6;0.0
11;2021-03-31;1622;385;0;53150;18749;0;16.2;5.7;0.0
11;2021-04-01;2122;440;0;55272;19189;0;16.9;5.9;0.0
11;2021-04-02;1627;447;0;56899;19636;0;17.4;6.0;0.0
11;2021-04-03;722;152;0;57621;19788;0;17.6;6.0;0.0
11;2021-04-04;215;80;0;57836;19868;0;17.7;6.1;0.0
11;2021-04-05;272;14;0;58108;19882;0;17.8;6.1;0.0
11;2021-04-06;1632;576;0;59740;20458;0;18.3;6.3;0.0
11;2021-04-07;1818;611;0;61558;21069;0;18.8;6.4;0.0
11;2021-04-08;1909;676;0;63467;21745;0;19.4;6.6;0.0
11;2021-04-09;2327;622;0;65794;22367;0;20.1;6.8;0.0
11;2021-04-10;1168;209;0;66962;22576;0;20.5;6.9;0.0
11;2021-04-11;594;129;0;67556;22705;0;20.6;6.9;0.0
11;2021-04-12;1590;580;0;69146;23285;0;21.1;7.1;0.0
11;2021-04-13;2310;861;0;71456;24146;0;21.8;7.4;0.0
11;2021-04-14;1735;1021;0;73191;25167;0;22.4;7.7;0.0
11;2021-04-15;1941;1094;0;75132;26261;0;23.0;8.0;0.0
11;2021-04-16;1918;844;0;77050;27105;0;23.5;8.3;0.0
11;2021-04-17;1698;541;0;78748;27646;0;24.1;8.4;0.0
11;2021-04-18;166;147;0;78914;27793;0;24.1;8.5;0.0
11;2021-04-19;1368;714;0;80282;28507;0;24.5;8.7;0.0
11;2021-04-20;1697;1229;0;81979;29736;0;25.1;9.1;0.0
11;2021-04-21;1766;1242;0;83745;30978;0;25.6;9.5;0.0
11;2021-04-22;1814;1285;0;85559;32263;0;26.1;9.9;0.0
11;2021-04-23;1986;1199;0;87545;33462;0;26.8;10.2;0.0
11;2021-04-24;1693;434;0;89238;33896;0;27.3;10.4;0.0
11;2021-04-25;697;173;0;89935;34069;0;27.5;10.4;0.0
11;2021-04-26;1354;810;0;91289;34879;0;27.9;10.7;0.0
11;2021-04-27;1840;1500;0;93129;36379;0;28.5;11.1;0.0
11;2021-04-28;1936;1385;0;95065;37764;0;29.1;11.5;0.0
11;2021-04-29;2207;1656;0;97272;39420;0;29.7;12.0;0.0
11;2021-04-30;2099;1403;0;99371;40823;0;30.4;12.5;0.0
11;2021-05-01;1337;359;0;100708;41182;0;30.8;12.6;0.0
11;2021-05-02;649;345;0;101357;41527;0;31.0;12.7;0.0
11;2021-05-03;1546;762;0;102903;42289;0;31.4;12.9;0.0
11;2021-05-04;1906;1525;0;104809;43814;0;32.0;13.4;0.0
11;2021-05-05;1893;1541;0;106702;45355;0;32.6;13.9;0.0
11;2021-05-06;2129;1545;0;108831;46900;0;33.3;14.3;0.0
11;2021-05-07;2086;1608;0;110917;48508;0;33.9;14.8;0.0
11;2021-05-08;919;735;0;111836;49243;0;34.2;15.0;0.0
11;2021-05-09;668;585;0;112504;49828;0;34.4;15.2;0.0
11;2021-05-10;1402;1674;0;113906;51502;0;34.8;15.7;0.0
11;2021-05-11;2161;1935;0;116067;53437;0;35.5;16.3;0.0
11;2021-05-12;2033;1662;0;118100;55099;0;36.1;16.8;0.0
11;2021-05-13;1516;437;0;119616;55536;0;36.6;17.0;0.0
11;2021-05-14;1751;1187;0;121367;56723;0;37.1;17.3;0.0
11;2021-05-15;1311;863;0;122678;57586;0;37.5;17.6;0.0
11;2021-05-16;972;207;0;123650;57793;0;37.8;17.7;0.0
11;2021-05-17;1637;1037;0;125287;58830;0;38.3;18.0;0.0
11;2021-05-18;2151;1179;0;127438;60009;0;38.9;18.3;0.0
11;2021-05-19;2094;1127;0;129532;61136;0;39.6;18.7;0.0
11;2021-05-20;2279;1126;0;131811;62262;0;40.3;19.0;0.0
11;2021-05-21;2501;1125;0;134312;63387;0;41.0;19.4;0.0
11;2021-05-22;1680;659;0;135992;64046;0;41.6;19.6;0.0
11;2021-05-23;863;84;0;136855;64130;0;41.8;19.6;0.0
11;2021-05-24;1494;226;0;138349;64356;0;42.3;19.7;0.0
11;2021-05-25;1927;1355;0;140276;65711;0;42.9;20.1;0.0
11;2021-05-26;2031;1291;0;142307;67002;0;43.5;20.5;0.0
11;2021-05-27;2087;1713;0;144394;68715;0;44.1;21.0;0.0
11;2021-05-28;1813;1874;0;146207;70589;0;44.7;21.6;0.0
11;2021-05-29;1410;1559;0;147617;72148;0;45.1;22.0;0.0
11;2021-05-30;560;418;0;148177;72566;0;45.3;22.2;0.0
11;2021-05-31;1342;1605;0;149519;74171;0;45.7;22.7;0.0
11;2021-06-01;1861;1896;0;151380;76067;0;46.3;23.2;0.0
11;2021-06-02;1752;2107;0;153132;78174;0;46.8;23.9;0.0
11;2021-06-03;2545;2452;0;155677;80626;0;47.6;24.6;0.0
11;2021-06-04;2089;2617;0;157766;83243;0;48.2;25.4;0.0
11;2021-06-05;1503;1837;0;159269;85080;0;48.7;26.0;0.0
11;2021-06-06;811;868;0;160080;85948;0;48.9;26.3;0.0
11;2021-06-07;1493;1728;0;161573;87676;0;49.4;26.8;0.0
11;2021-06-08;1991;1980;0;163564;89656;0;50.0;27.4;0.0
11;2021-06-09;1796;2178;0;165360;91834;0;50.5;28.1;0.0
11;2021-06-10;1790;2330;0;167150;94164;0;51.1;28.8;0.0
11;2021-06-11;1847;2445;0;168997;96609;0;51.6;29.5;0.0
11;2021-06-12;1323;1596;0;170320;98205;0;52.0;30.0;0.0
11;2021-06-13;683;720;0;171003;98925;0;52.3;30.2;0.0
11;2021-06-14;1071;2034;0;172074;100959;0;52.6;30.9;0.0
11;2021-06-15;1358;2643;0;173432;103602;0;53.0;31.7;0.0
11;2021-06-16;1334;2486;0;174766;106088;0;53.4;32.4;0.0
11;2021-06-17;1458;2496;0;176224;108584;0;53.9;33.2;0.0
11;2021-06-18;1512;2525;0;177736;111109;0;54.3;34.0;0.0
11;2021-06-19;1153;1427;0;178889;112536;0;54.7;34.4;0.0
11;2021-06-20;308;644;0;179197;113180;0;54.8;34.6;0.0
11;2021-06-21;800;2174;0;179997;115354;0;55.0;35.3;0.0
11;2021-06-22;1009;2704;0;181006;118058;0;55.3;36.1;0.0
11;2021-06-23;1082;2223;0;182088;120281;0;55.6;36.8;0.0
11;2021-06-24;900;2310;0;182988;122591;0;55.9;37.5;0.0
11;2021-06-25;966;2623;0;183954;125214;0;56.2;38.3;0.0
11;2021-06-26;718;1754;0;184672;126968;0;56.4;38.8;0.0
11;2021-06-27;227;779;0;184899;127747;0;56.5;39.0;0.0
11;2021-06-28;698;2377;0;185597;130124;0;56.7;39.8;0.0
11;2021-06-29;903;2677;0;186500;132801;0;57.0;40.6;0.0
11;2021-06-30;872;2656;0;187372;135457;0;57.3;41.4;0.0
11;2021-07-01;972;2002;0;188344;137459;0;57.6;42.0;0.0
11;2021-07-02;1012;2673;0;189356;140132;0;57.9;42.8;0.0
11;2021-07-03;668;1899;0;190024;142031;0;58.1;43.4;0.0
11;2021-07-04;331;1165;0;190355;143196;0;58.2;43.8;0.0
11;2021-07-05;707;2187;0;191062;145383;0;58.4;44.4;0.0
11;2021-07-06;941;2505;0;192003;147888;0;58.7;45.2;0.0
11;2021-07-07;925;2546;0;192928;150434;0;59.0;46.0;0.0
11;2021-07-08;1170;1929;0;194098;152363;0;59.3;46.6;0.0
11;2021-07-09;856;1851;0;194954;154214;0;59.6;47.1;0.0
11;2021-07-10;394;1316;0;195348;155530;0;59.7;47.5;0.0
11;2021-07-11;328;623;0;195676;156153;0;59.8;47.7;0.0
11;2021-07-12;519;2612;0;196195;158765;0;60.0;48.5;0.0
11;2021-07-13;1387;2971;0;197582;161736;0;60.4;49.4;0.0
11;2021-07-14;352;298;0;197934;162034;0;60.5;49.5;0.0
11;2021-07-15;1577;2885;0;199511;164919;0;61.0;50.4;0.0
11;2021-07-16;1928;2735;0;201439;167654;0;61.6;51.2;0.0
11;2021-07-17;1103;2076;0;202542;169730;0;61.9;51.9;0.0
11;2021-07-18;662;895;0;203204;170625;0;62.1;52.1;0.0
11;2021-07-19;1369;2020;0;204573;172645;0;62.5;52.8;0.0
11;2021-07-20;2018;2329;0;206591;174974;0;63.1;53.5;0.0
11;2021-07-21;2025;2428;0;208616;177402;0;63.7;54.2;0.0
11;2021-07-22;2307;1907;0;210923;179309;0;64.5;54.8;0.0
11;2021-07-23;2187;2229;0;213110;181538;0;65.1;55.5;0.0
11;2021-07-24;1409;1590;0;214519;183128;0;65.6;56.0;0.0
11;2021-07-25;823;682;0;215342;183810;0;65.8;56.2;0.0
11;2021-07-26;1657;1376;0;216999;185186;0;66.3;56.6;0.0
11;2021-07-27;2319;1893;0;219318;187079;0;67.0;57.2;0.0
11;2021-07-28;2451;1846;0;221769;188925;0;67.8;57.7;0.0
11;2021-07-29;2665;1681;0;224434;190606;0;68.6;58.2;0.0
11;2021-07-30;2483;1692;0;226917;192298;0;69.3;58.8;0.0
11;2021-07-31;1894;1030;0;228811;193328;0;69.9;59.1;0.0
11;2021-08-01;997;465;0;229808;193793;0;70.2;59.2;0.0
11;2021-08-02;1583;1016;0;231391;194809;0;70.7;59.5;0.0
11;2021-08-03;2256;1454;0;233647;196263;0;71.4;60.0;0.0
11;2021-08-04;2372;1146;1;236019;197409;1;72.1;60.3;0.0
11;2021-08-05;2188;1234;0;238207;198643;1;72.8;60.7;0.0
11;2021-08-06;2057;1506;0;240264;200149;1;73.4;61.2;0.0
11;2021-08-07;1543;1088;0;241807;201237;1;73.9;61.5;0.0
11;2021-08-08;528;238;0;242335;201475;1;74.1;61.6;0.0
11;2021-08-09;1005;1390;0;243340;202865;1;74.4;62.0;0.0
11;2021-08-10;1615;1785;0;244955;204650;1;74.9;62.5;0.0
11;2021-08-11;1530;1597;0;246485;206247;1;75.3;63.0;0.0
11;2021-08-12;1548;1712;0;248033;207959;1;75.8;63.5;0.0
11;2021-08-13;1202;1579;0;249235;209538;1;76.2;64.0;0.0
11;2021-08-14;897;1497;0;250132;211035;1;76.4;64.5;0.0
11;2021-08-15;129;154;0;250261;211189;1;76.5;64.5;0.0
11;2021-08-16;694;1874;0;250955;213063;1;76.7;65.1;0.0
11;2021-08-17;978;2190;0;251933;215253;1;77.0;65.8;0.0
11;2021-08-18;1010;1927;1;252943;217180;2;77.3;66.4;0.0
11;2021-08-19;936;2192;0;253879;219372;2;77.6;67.0;0.0
11;2021-08-20;919;2183;0;254798;221555;2;77.9;67.7;0.0
11;2021-08-21;511;1725;0;255309;223280;2;78.0;68.2;0.0
11;2021-08-22;164;530;0;255473;223810;2;78.1;68.4;0.0
11;2021-08-23;499;1764;0;255972;225574;2;78.2;68.9;0.0
11;2021-08-24;762;2148;0;256734;227722;2;78.5;69.6;0.0
11;2021-08-25;750;2103;0;257484;229825;2;78.7;70.2;0.0
11;2021-08-26;686;1966;0;258170;231791;2;78.9;70.8;0.0
11;2021-08-27;667;2169;0;258837;233960;2;79.1;71.5;0.0
11;2021-08-28;406;1715;0;259243;235675;2;79.2;72.0;0.0
11;2021-08-29;145;505;0;259388;236180;2;79.3;72.2;0.0
11;2021-08-30;444;1313;21;259832;237493;23;79.4;72.6;0.0
11;2021-08-31;583;1815;85;260415;239308;108;79.6;73.1;0.0
11;2021-09-01;636;1645;99;261051;240953;207;79.8;73.6;0.1
11;2021-09-02;572;1569;181;261623;242522;388;79.9;74.1;0.1
11;2021-09-03;536;1511;174;262159;244033;562;80.1;74.6;0.2
11;2021-09-04;475;1433;82;262634;245466;644;80.3;75.0;0.2
11;2021-09-05;149;219;48;262783;245685;692;80.3;75.1;0.2
11;2021-09-06;309;693;186;263092;246378;878;80.4;75.3;0.3
11;2021-09-07;366;896;225;263458;247274;1103;80.5;75.6;0.3
11;2021-09-08;455;1151;175;263913;248425;1278;80.6;75.9;0.4
11;2021-09-09;390;854;205;264303;249279;1483;80.8;76.2;0.5
11;2021-09-10;404;967;199;264707;250246;1682;80.9;76.5;0.5
11;2021-09-11;380;973;84;265087;251219;1766;81.0;76.8;0.5
11;2021-09-12;65;118;18;265152;251337;1784;81.0;76.8;0.5
11;2021-09-13;241;561;361;265393;251898;2145;81.1;77.0;0.7
11;2021-09-14;361;626;433;265754;252524;2578;81.2;77.2;0.8
11;2021-09-15;373;955;254;266127;253479;2832;81.3;77.5;0.9
11;2021-09-16;321;561;616;266448;254040;3448;81.4;77.6;1.1
11;2021-09-17;317;669;261;266765;254709;3709;81.5;77.8;1.1
11;2021-09-18;293;755;149;267058;255464;3858;81.6;78.1;1.2
11;2021-09-19;63;113;28;267121;255577;3886;81.6;78.1;1.2
11;2021-09-20;171;366;387;267292;255943;4273;81.7;78.2;1.3
11;2021-09-21;272;411;287;267564;256354;4560;81.8;78.3;1.4
11;2021-09-22;213;740;392;267777;257094;4952;81.8;78.6;1.5
11;2021-09-23;183;406;350;267960;257500;5302;81.9;78.7;1.6
11;2021-09-24;251;505;564;268211;258005;5866;82.0;78.8;1.8
11;2021-09-25;227;627;115;268438;258632;5981;82.0;79.0;1.8
11;2021-09-26;36;133;32;268474;258765;6013;82.0;79.1;1.8
11;2021-09-27;123;386;303;268597;259151;6316;82.1;79.2;1.9
11;2021-09-28;212;356;300;268809;259507;6616;82.1;79.3;2.0
11;2021-09-29;232;539;355;269041;260046;6971;82.2;79.5;2.1
11;2021-09-30;189;354;320;269230;260400;7291;82.3;79.6;2.2
11;2021-10-01;258;384;464;269488;260784;7755;82.4;79.7;2.4
11;2021-10-02;221;455;136;269709;261239;7891;82.4;79.8;2.4
11;2021-10-03;6;15;1;269715;261254;7892;82.4;79.8;2.4
11;2021-10-04;157;303;311;269872;261557;8203;82.5;79.9;2.5
11;2021-10-05;182;320;466;270054;261877;8669;82.5;80.0;2.6
11;2021-10-06;259;442;469;270313;262319;9138;82.6;80.2;2.8
11;2021-10-07;163;302;413;270476;262621;9551;82.7;80.3;2.9
11;2021-10-08;245;424;473;270721;263045;10024;82.7;80.4;3.1
11;2021-10-09;150;363;203;270871;263408;10227;82.8;80.5;3.1
11;2021-10-10;9;7;0;270880;263415;10227;82.8;80.5;3.1
11;2021-10-11;138;252;287;271018;263667;10514;82.8;80.6;3.2
11;2021-10-12;154;308;446;271172;263975;10960;82.9;80.7;3.3
11;2021-10-13;217;295;482;271389;264270;11442;82.9;80.8;3.5
11;2021-10-14;179;247;484;271568;264517;11926;83.0;80.8;3.6
11;2021-10-15;249;326;571;271817;264843;12497;83.1;80.9;3.8
11;2021-10-16;185;258;181;272002;265101;12678;83.1;81.0;3.9
11;2021-10-17;17;28;13;272019;265129;12691;83.1;81.0;3.9
11;2021-10-18;109;157;274;272128;265286;12965;83.2;81.1;4.0
11;2021-10-19;113;192;471;272241;265478;13436;83.2;81.1;4.1
11;2021-10-20;208;286;678;272449;265764;14114;83.3;81.2;4.3
11;2021-10-21;101;219;527;272550;265983;14641;83.3;81.3;4.5
11;2021-10-22;205;321;797;272755;266304;15438;83.3;81.4;4.7
11;2021-10-23;171;254;363;272926;266558;15801;83.4;81.5;4.8
11;2021-10-24;13;10;2;272939;266568;15803;83.4;81.5;4.8
11;2021-10-25;140;156;601;273079;266724;16404;83.4;81.5;5.0
11;2021-10-26;100;157;489;273179;266881;16893;83.5;81.6;5.2
11;2021-10-27;170;254;752;273349;267135;17645;83.5;81.6;5.4
11;2021-10-28;125;148;613;273474;267283;18258;83.6;81.7;5.6
11;2021-10-29;110;185;766;273584;267468;19024;83.6;81.7;5.8
11;2021-10-30;112;182;320;273696;267650;19344;83.6;81.8;5.9
11;2021-10-31;11;13;0;273707;267663;19344;83.6;81.8;5.9
11;2021-11-01;8;5;4;273715;267668;19348;83.6;81.8;5.9
11;2021-11-02;113;150;669;273828;267818;20017;83.7;81.8;6.1
11;2021-11-03;179;269;1165;274007;268087;21182;83.7;81.9;6.5
11;2021-11-04;147;153;699;274154;268240;21881;83.8;82.0;6.7
11;2021-11-05;109;196;912;274263;268436;22793;83.8;82.0;7.0
11;2021-11-06;132;223;426;274395;268659;23219;83.9;82.1;7.1
11;2021-11-07;11;16;8;274406;268675;23227;83.9;82.1;7.1
11;2021-11-08;105;136;731;274511;268811;23958;83.9;82.1;7.3
11;2021-11-09;82;139;1123;274593;268950;25081;83.9;82.2;7.7
11;2021-11-10;163;275;1312;274756;269225;26393;84.0;82.3;8.1
11;2021-11-11;8;12;19;274764;269237;26412;84.0;82.3;8.1
11;2021-11-12;106;158;988;274870;269395;27400;84.0;82.3;8.4
11;2021-11-13;88;140;484;274958;269535;27884;84.0;82.4;8.5
11;2021-11-14;9;4;18;274967;269539;27902;84.0;82.4;8.5
11;2021-11-15;59;131;728;275026;269670;28630;84.0;82.4;8.7
11;2021-11-16;111;134;1540;275137;269804;30170;84.1;82.4;9.2
11;2021-11-17;126;218;1572;275263;270022;31742;84.1;82.5;9.7
11;2021-11-18;154;178;1683;275417;270200;33425;84.2;82.6;10.2
11;2021-11-19;151;141;1618;275568;270341;35043;84.2;82.6;10.7
11;2021-11-20;96;160;419;275664;270501;35462;84.2;82.7;10.8
11;2021-11-21;23;17;166;275687;270518;35628;84.2;82.7;10.9
11;2021-11-22;98;85;926;275785;270603;36554;84.3;82.7;11.2
11;2021-11-23;155;112;1759;275940;270715;38313;84.3;82.7;11.7
11;2021-11-24;171;173;1492;276111;270888;39805;84.4;82.8;12.2
11;2021-11-25;162;170;1842;276273;271058;41647;84.4;82.8;12.7
11;2021-11-26;202;177;2373;276475;271235;44020;84.5;82.9;13.5
11;2021-11-27;93;141;1143;276568;271376;45163;84.5;82.9;13.8
11;2021-11-28;18;13;88;276586;271389;45251;84.5;82.9;13.8
11;2021-11-29;92;92;1742;276678;271481;46993;84.5;83.0;14.4
11;2021-11-30;153;147;2891;276831;271628;49884;84.6;83.0;15.2
11;2021-12-01;150;188;2940;276981;271816;52824;84.6;83.1;16.1
11;2021-12-02;102;113;3388;277083;271929;56212;84.7;83.1;17.2
11;2021-12-03;144;159;3722;277227;272088;59934;84.7;83.1;18.3
11;2021-12-04;89;81;1759;277316;272169;61693;84.7;83.2;18.9
11;2021-12-05;13;23;93;277329;272192;61786;84.7;83.2;18.9
11;2021-12-06;80;79;2385;277409;272271;64171;84.8;83.2;19.6
11;2021-12-07;115;169;4030;277524;272440;68201;84.8;83.3;20.8
11;2021-12-08;151;189;4332;277675;272629;72533;84.9;83.3;22.2
11;2021-12-09;135;154;4489;277810;272783;77022;84.9;83.4;23.5
11;2021-12-10;150;169;4688;277960;272952;81710;84.9;83.4;25.0
11;2021-12-11;114;165;2827;278074;273117;84537;85.0;83.5;25.8
11;2021-12-12;22;34;433;278096;273151;84970;85.0;83.5;26.0
11;2021-12-13;94;122;3036;278190;273273;88006;85.0;83.5;26.9
11;2021-12-14;173;164;4624;278363;273437;92630;85.1;83.6;28.3
11;2021-12-15;230;209;4977;278593;273646;97607;85.1;83.6;29.8
11;2021-12-16;182;198;5229;278775;273844;102836;85.2;83.7;31.4
11;2021-12-17;201;236;4776;278976;274080;107612;85.3;83.8;32.9
11;2021-12-18;153;116;2666;279129;274196;110278;85.3;83.8;33.7
11;2021-12-19;33;22;643;279162;274218;110921;85.3;83.8;33.9
12;2020-12-27;1;0;0;1;0;0;0.0;0.0;0.0
12;2020-12-28;0;0;0;1;0;0;0.0;0.0;0.0
12;2020-12-29;0;0;0;1;0;0;0.0;0.0;0.0
12;2020-12-30;0;0;0;1;0;0;0.0;0.0;0.0
12;2020-12-31;0;0;0;1;0;0;0.0;0.0;0.0
12;2021-01-01;2;0;0;3;0;0;0.0;0.0;0.0
12;2021-01-02;0;0;0;3;0;0;0.0;0.0;0.0
12;2021-01-03;0;0;0;3;0;0;0.0;0.0;0.0
12;2021-01-04;2;0;0;5;0;0;0.0;0.0;0.0
12;2021-01-05;1;0;0;6;0;0;0.0;0.0;0.0
12;2021-01-06;12;1;0;18;1;0;0.0;0.0;0.0
12;2021-01-07;197;0;0;215;1;0;0.1;0.0;0.0
12;2021-01-08;67;0;0;282;1;0;0.1;0.0;0.0
12;2021-01-09;3;0;0;285;1;0;0.1;0.0;0.0
12;2021-01-10;1;0;0;286;1;0;0.1;0.0;0.0
12;2021-01-11;110;1;0;396;2;0;0.2;0.0;0.0
12;2021-01-12;351;1;0;747;3;0;0.3;0.0;0.0
12;2021-01-13;287;0;0;1034;3;0;0.4;0.0;0.0
12;2021-01-14;564;11;0;1598;14;0;0.6;0.0;0.0
12;2021-01-15;374;7;0;1972;21;0;0.8;0.0;0.0
12;2021-01-16;136;1;0;2108;22;0;0.9;0.0;0.0
12;2021-01-17;1;0;0;2109;22;0;0.9;0.0;0.0
12;2021-01-18;410;0;0;2519;22;0;1.0;0.0;0.0
12;2021-01-19;600;4;0;3119;26;0;1.3;0.0;0.0
12;2021-01-20;881;4;0;4000;30;0;1.6;0.0;0.0
12;2021-01-21;764;1;0;4764;31;0;1.9;0.0;0.0
12;2021-01-22;732;1;0;5496;32;0;2.2;0.0;0.0
12;2021-01-23;390;0;0;5886;32;0;2.4;0.0;0.0
12;2021-01-24;2;0;0;5888;32;0;2.4;0.0;0.0
12;2021-01-25;459;0;0;6347;32;0;2.6;0.0;0.0
12;2021-01-26;654;2;0;7001;34;0;2.8;0.0;0.0
12;2021-01-27;1807;38;0;8808;72;0;3.6;0.0;0.0
12;2021-01-28;1856;228;0;10664;300;0;4.3;0.1;0.0
12;2021-01-29;1253;45;0;11917;345;0;4.8;0.1;0.0
12;2021-01-30;374;3;0;12291;348;0;5.0;0.1;0.0
12;2021-01-31;1;0;0;12292;348;0;5.0;0.1;0.0
12;2021-02-01;343;91;0;12635;439;0;5.1;0.2;0.0
12;2021-02-02;459;247;0;13094;686;0;5.3;0.3;0.0
12;2021-02-03;487;168;0;13581;854;0;5.5;0.3;0.0
12;2021-02-04;463;482;0;14044;1336;0;5.7;0.5;0.0
12;2021-02-05;449;184;0;14493;1520;0;5.9;0.6;0.0
12;2021-02-06;202;67;0;14695;1587;0;6.0;0.6;0.0
12;2021-02-07;11;0;0;14706;1587;0;6.0;0.6;0.0
12;2021-02-08;127;291;0;14833;1878;0;6.0;0.8;0.0
12;2021-02-09;206;343;0;15039;2221;0;6.1;0.9;0.0
12;2021-02-10;431;478;0;15470;2699;0;6.3;1.1;0.0
12;2021-02-11;534;367;0;16004;3066;0;6.5;1.2;0.0
12;2021-02-12;569;324;0;16573;3390;0;6.7;1.4;0.0
12;2021-02-13;153;127;0;16726;3517;0;6.8;1.4;0.0
12;2021-02-14;3;1;0;16729;3518;0;6.8;1.4;0.0
12;2021-02-15;174;364;0;16903;3882;0;6.9;1.6;0.0
12;2021-02-16;159;498;0;17062;4380;0;6.9;1.8;0.0
12;2021-02-17;324;1453;0;17386;5833;0;7.1;2.4;0.0
12;2021-02-18;667;1594;0;18053;7427;0;7.3;3.0;0.0
12;2021-02-19;580;958;0;18633;8385;0;7.6;3.4;0.0
12;2021-02-20;100;386;0;18733;8771;0;7.6;3.6;0.0
12;2021-02-21;0;1;0;18733;8772;0;7.6;3.6;0.0
12;2021-02-22;148;417;0;18881;9189;0;7.7;3.7;0.0
12;2021-02-23;168;543;0;19049;9732;0;7.7;4.0;0.0
12;2021-02-24;127;658;0;19176;10390;0;7.8;4.2;0.0
12;2021-02-25;219;784;0;19395;11174;0;7.9;4.5;0.0
12;2021-02-26;324;643;0;19719;11817;0;8.0;4.8;0.0
12;2021-02-27;180;335;0;19899;12152;0;8.1;4.9;0.0
12;2021-02-28;9;2;0;19908;12154;0;8.1;4.9;0.0
12;2021-03-01;65;351;0;19973;12505;0;8.1;5.1;0.0
12;2021-03-02;218;506;0;20191;13011;0;8.2;5.3;0.0
12;2021-03-03;258;387;0;20449;13398;0;8.3;5.4;0.0
12;2021-03-04;308;364;0;20757;13762;0;8.4;5.6;0.0
12;2021-03-05;447;363;0;21204;14125;0;8.6;5.7;0.0
12;2021-03-06;792;114;0;21996;14239;0;8.9;5.8;0.0
12;2021-03-07;138;32;0;22134;14271;0;9.0;5.8;0.0
12;2021-03-08;254;216;0;22388;14487;0;9.1;5.9;0.0
12;2021-03-09;742;274;0;23130;14761;0;9.4;6.0;0.0
12;2021-03-10;785;716;0;23915;15477;0;9.7;6.3;0.0
12;2021-03-11;958;642;0;24873;16119;0;10.1;6.5;0.0
12;2021-03-12;1226;514;0;26099;16633;0;10.6;6.8;0.0
12;2021-03-13;864;126;0;26963;16759;0;10.9;6.8;0.0
12;2021-03-14;43;4;0;27006;16763;0;11.0;6.8;0.0
12;2021-03-15;605;156;0;27611;16919;0;11.2;6.9;0.0
12;2021-03-16;811;152;0;28422;17071;0;11.5;6.9;0.0
12;2021-03-17;1389;179;0;29811;17250;0;12.1;7.0;0.0
12;2021-03-18;978;252;0;30789;17502;0;12.5;7.1;0.0
12;2021-03-19;1328;272;0;32117;17774;0;13.0;7.2;0.0
12;2021-03-20;722;75;0;32839;17849;0;13.3;7.2;0.0
12;2021-03-21;261;10;0;33100;17859;0;13.4;7.2;0.0
12;2021-03-22;609;168;0;33709;18027;0;13.7;7.3;0.0
12;2021-03-23;1203;189;0;34912;18216;0;14.2;7.4;0.0
12;2021-03-24;1369;203;0;36281;18419;0;14.7;7.5;0.0
12;2021-03-25;1776;203;0;38057;18622;0;15.4;7.6;0.0
12;2021-03-26;1922;231;0;39979;18853;0;16.2;7.7;0.0
12;2021-03-27;940;59;0;40919;18912;0;16.6;7.7;0.0
12;2021-03-28;76;7;0;40995;18919;0;16.6;7.7;0.0
12;2021-03-29;1007;95;0;42002;19014;0;17.1;7.7;0.0
12;2021-03-30;1659;134;0;43661;19148;0;17.7;7.8;0.0
12;2021-03-31;1410;124;0;45071;19272;0;18.3;7.8;0.0
12;2021-04-01;1903;187;0;46974;19459;0;19.1;7.9;0.0
12;2021-04-02;1507;346;0;48481;19805;0;19.7;8.0;0.0
12;2021-04-03;820;102;0;49301;19907;0;20.0;8.1;0.0
12;2021-04-04;22;2;0;49323;19909;0;20.0;8.1;0.0
12;2021-04-05;548;12;0;49871;19921;0;20.2;8.1;0.0
12;2021-04-06;1079;544;0;50950;20465;0;20.7;8.3;0.0
12;2021-04-07;1595;629;0;52545;21094;0;21.3;8.6;0.0
12;2021-04-08;1975;578;0;54520;21672;0;22.1;8.8;0.0
12;2021-04-09;1991;645;0;56511;22317;0;22.9;9.1;0.0
12;2021-04-10;1333;203;0;57844;22520;0;23.5;9.1;0.0
12;2021-04-11;126;5;0;57970;22525;0;23.5;9.1;0.0
12;2021-04-12;1726;533;0;59696;23058;0;24.2;9.4;0.0
12;2021-04-13;1859;759;0;61555;23817;0;25.0;9.7;0.0
12;2021-04-14;1764;1211;0;63319;25028;0;25.7;10.2;0.0
12;2021-04-15;1950;884;0;65269;25912;0;26.5;10.5;0.0
12;2021-04-16;1677;1214;0;66946;27126;0;27.2;11.0;0.0
12;2021-04-17;1466;547;0;68412;27673;0;27.8;11.2;0.0
12;2021-04-18;10;2;0;68422;27675;0;27.8;11.2;0.0
12;2021-04-19;1609;556;0;70031;28231;0;28.4;11.5;0.0
12;2021-04-20;1516;977;0;71547;29208;0;29.0;11.9;0.0
12;2021-04-21;1631;1162;0;73178;30370;0;29.7;12.3;0.0
12;2021-04-22;1680;1061;0;74858;31431;0;30.4;12.8;0.0
12;2021-04-23;1365;1295;0;76223;32726;0;30.9;13.3;0.0
12;2021-04-24;1329;676;0;77552;33402;0;31.5;13.6;0.0
12;2021-04-25;72;7;0;77624;33409;0;31.5;13.6;0.0
12;2021-04-26;1352;897;0;78976;34306;0;32.1;13.9;0.0
12;2021-04-27;1261;1253;0;80237;35559;0;32.6;14.4;0.0
12;2021-04-28;1093;1755;0;81330;37314;0;33.0;15.1;0.0
12;2021-04-29;1463;1782;0;82793;39096;0;33.6;15.9;0.0
12;2021-04-30;1748;1714;0;84541;40810;0;34.3;16.6;0.0
12;2021-05-01;1470;255;0;86011;41065;0;34.9;16.7;0.0
12;2021-05-02;95;21;0;86106;41086;0;35.0;16.7;0.0
12;2021-05-03;1668;1156;0;87774;42242;0;35.6;17.1;0.0
12;2021-05-04;1450;1329;0;89224;43571;0;36.2;17.7;0.0
12;2021-05-05;1302;1588;0;90526;45159;0;36.7;18.3;0.0
12;2021-05-06;1730;1369;0;92256;46528;0;37.5;18.9;0.0
12;2021-05-07;1484;1719;0;93740;48247;0;38.1;19.6;0.0
12;2021-05-08;1204;437;0;94944;48684;0;38.5;19.8;0.0
12;2021-05-09;27;42;0;94971;48726;0;38.6;19.8;0.0
12;2021-05-10;796;2134;0;95767;50860;0;38.9;20.6;0.0
12;2021-05-11;883;1827;0;96650;52687;0;39.2;21.4;0.0
12;2021-05-12;933;1796;0;97583;54483;0;39.6;22.1;0.0
12;2021-05-13;1501;789;0;99084;55272;0;40.2;22.4;0.0
12;2021-05-14;1179;1478;0;100263;56750;0;40.7;23.0;0.0
12;2021-05-15;993;1027;0;101256;57777;0;41.1;23.5;0.0
12;2021-05-16;14;19;0;101270;57796;0;41.1;23.5;0.0
12;2021-05-17;979;1737;0;102249;59533;0;41.5;24.2;0.0
12;2021-05-18;1423;1530;0;103672;61063;0;42.1;24.8;0.0
12;2021-05-19;1810;1287;0;105482;62350;0;42.8;25.3;0.0
12;2021-05-20;2207;928;0;107689;63278;0;43.7;25.7;0.0
12;2021-05-21;1758;1228;0;109447;64506;0;44.4;26.2;0.0
12;2021-05-22;1137;929;0;110584;65435;0;44.9;26.6;0.0
12;2021-05-23;39;16;0;110623;65451;0;44.9;26.6;0.0
12;2021-05-24;1722;499;0;112345;65950;0;45.6;26.8;0.0
12;2021-05-25;1680;1153;0;114025;67103;0;46.3;27.2;0.0
12;2021-05-26;1877;780;0;115902;67883;0;47.1;27.6;0.0
12;2021-05-27;2039;759;0;117941;68642;0;47.9;27.9;0.0
12;2021-05-28;1876;1047;0;119817;69689;0;48.6;28.3;0.0
12;2021-05-29;1531;773;0;121348;70462;0;49.3;28.6;0.0
12;2021-05-30;107;39;0;121455;70501;0;49.3;28.6;0.0
12;2021-05-31;1638;824;0;123093;71325;0;50.0;29.0;0.0
12;2021-06-01;1822;1047;0;124915;72372;0;50.7;29.4;0.0
12;2021-06-02;1918;1074;0;126833;73446;0;51.5;29.8;0.0
12;2021-06-03;2020;883;0;128853;74329;0;52.3;30.2;0.0
12;2021-06-04;1900;1342;0;130753;75671;0;53.1;30.7;0.0
12;2021-06-05;1577;904;0;132330;76575;0;53.7;31.1;0.0
12;2021-06-06;44;23;0;132374;76598;0;53.7;31.1;0.0
12;2021-06-07;1086;1736;0;133460;78334;0;54.2;31.8;0.0
12;2021-06-08;1361;1188;0;134821;79522;0;54.7;32.3;0.0
12;2021-06-09;993;1248;0;135814;80770;0;55.1;32.8;0.0
12;2021-06-10;1053;895;0;136867;81665;0;55.6;33.2;0.0
12;2021-06-11;1196;1991;0;138063;83656;0;56.0;34.0;0.0
12;2021-06-12;970;1265;0;139033;84921;0;56.4;34.5;0.0
12;2021-06-13;39;62;0;139072;84983;0;56.5;34.5;0.0
12;2021-06-14;695;1780;0;139767;86763;0;56.7;35.2;0.0
12;2021-06-15;782;1841;0;140549;88604;0;57.1;36.0;0.0
12;2021-06-16;852;1750;0;141401;90354;0;57.4;36.7;0.0
12;2021-06-17;692;998;0;142093;91352;0;57.7;37.1;0.0
12;2021-06-18;1096;1759;0;143189;93111;0;58.1;37.8;0.0
12;2021-06-19;858;1296;0;144047;94407;0;58.5;38.3;0.0
12;2021-06-20;17;24;0;144064;94431;0;58.5;38.3;0.0
12;2021-06-21;520;1644;0;144584;96075;0;58.7;39.0;0.0
12;2021-06-22;508;1474;0;145092;97549;0;58.9;39.6;0.0
12;2021-06-23;586;1296;0;145678;98845;0;59.1;40.1;0.0
12;2021-06-24;273;609;0;145951;99454;0;59.2;40.4;0.0
12;2021-06-25;805;1774;0;146756;101228;0;59.6;41.1;0.0
12;2021-06-26;620;1436;0;147376;102664;0;59.8;41.7;0.0
12;2021-06-27;14;28;0;147390;102692;0;59.8;41.7;0.0
12;2021-06-28;467;2381;0;147857;105073;0;60.0;42.7;0.0
12;2021-06-29;544;1925;0;148401;106998;0;60.2;43.4;0.0
12;2021-06-30;788;2079;0;149189;109077;0;60.6;44.3;0.0
12;2021-07-01;356;1100;0;149545;110177;0;60.7;44.7;0.0
12;2021-07-02;747;2487;0;150292;112664;0;61.0;45.7;0.0
12;2021-07-03;547;1769;0;150839;114433;0;61.2;46.5;0.0
12;2021-07-04;13;33;0;150852;114466;0;61.2;46.5;0.0
12;2021-07-05;438;2293;0;151290;116759;0;61.4;47.4;0.0
12;2021-07-06;628;2413;0;151918;119172;0;61.7;48.4;0.0
12;2021-07-07;677;2069;0;152595;121241;0;61.9;49.2;0.0
12;2021-07-08;313;934;0;152908;122175;0;62.1;49.6;0.0
12;2021-07-09;694;2505;0;153602;124680;0;62.4;50.6;0.0
12;2021-07-10;451;1973;0;154053;126653;0;62.5;51.4;0.0
12;2021-07-11;28;100;0;154081;126753;0;62.5;51.5;0.0
12;2021-07-12;535;2328;0;154616;129081;0;62.8;52.4;0.0
12;2021-07-13;818;2512;0;155434;131593;0;63.1;53.4;0.0
12;2021-07-14;110;69;0;155544;131662;0;63.1;53.4;0.0
12;2021-07-15;835;2037;0;156379;133699;0;63.5;54.3;0.0
12;2021-07-16;1172;2443;0;157551;136142;0;64.0;55.3;0.0
12;2021-07-17;726;1879;0;158277;138021;0;64.3;56.0;0.0
12;2021-07-18;52;52;0;158329;138073;0;64.3;56.1;0.0
12;2021-07-19;1225;1955;0;159554;140028;0;64.8;56.8;0.0
12;2021-07-20;1400;1452;0;160954;141480;0;65.3;57.4;0.0
12;2021-07-21;1086;1032;0;162040;142512;0;65.8;57.9;0.0
12;2021-07-22;2109;1311;0;164149;143823;0;66.6;58.4;0.0
12;2021-07-23;1769;1931;0;165918;145754;0;67.4;59.2;0.0
12;2021-07-24;1528;1437;0;167446;147191;0;68.0;59.8;0.0
12;2021-07-25;170;51;0;167616;147242;0;68.0;59.8;0.0
12;2021-07-26;1721;1318;0;169337;148560;0;68.7;60.3;0.0
12;2021-07-27;2127;1019;0;171464;149579;0;69.6;60.7;0.0
12;2021-07-28;1675;710;0;173139;150289;0;70.3;61.0;0.0
12;2021-07-29;1211;743;0;174350;151032;0;70.8;61.3;0.0
12;2021-07-30;2280;1223;0;176630;152255;0;71.7;61.8;0.0
12;2021-07-31;1750;906;0;178380;153161;0;72.4;62.2;0.0
12;2021-08-01;209;52;0;178589;153213;0;72.5;62.2;0.0
12;2021-08-02;1630;757;0;180219;153970;0;73.2;62.5;0.0
12;2021-08-03;1811;716;0;182030;154686;0;73.9;62.8;0.0
12;2021-08-04;1642;756;0;183672;155442;0;74.6;63.1;0.0
12;2021-08-05;1521;656;0;185193;156098;0;75.2;63.4;0.0
12;2021-08-06;1607;1161;0;186800;157259;0;75.8;63.8;0.0
12;2021-08-07;1286;650;0;188086;157909;0;76.4;64.1;0.0
12;2021-08-08;29;35;0;188115;157944;0;76.4;64.1;0.0
12;2021-08-09;1233;1182;0;189348;159126;0;76.9;64.6;0.0
12;2021-08-10;1221;1155;0;190569;160281;0;77.4;65.1;0.0
12;2021-08-11;822;1133;0;191391;161414;0;77.7;65.5;0.0
12;2021-08-12;741;1075;0;192132;162489;0;78.0;66.0;0.0
12;2021-08-13;984;1269;0;193116;163758;0;78.4;66.5;0.0
12;2021-08-14;662;1244;0;193778;165002;0;78.7;67.0;0.0
12;2021-08-15;197;97;0;193975;165099;0;78.7;67.0;0.0
12;2021-08-16;644;1633;0;194619;166732;0;79.0;67.7;0.0
12;2021-08-17;818;1849;0;195437;168581;0;79.3;68.4;0.0
12;2021-08-18;479;1458;0;195916;170039;0;79.5;69.0;0.0
12;2021-08-19;636;1073;0;196552;171112;0;79.8;69.5;0.0
12;2021-08-20;738;1778;0;197290;172890;0;80.1;70.2;0.0
12;2021-08-21;474;1433;0;197764;174323;0;80.3;70.8;0.0
12;2021-08-22;84;66;0;197848;174389;0;80.3;70.8;0.0
12;2021-08-23;434;1812;0;198282;176201;0;80.5;71.5;0.0
12;2021-08-24;484;1824;0;198766;178025;0;80.7;72.3;0.0
12;2021-08-25;352;1544;0;199118;179569;0;80.8;72.9;0.0
12;2021-08-26;473;1564;0;199591;181133;0;81.0;73.5;0.0
12;2021-08-27;581;1687;0;200172;182820;0;81.3;74.2;0.0
12;2021-08-28;323;1487;0;200495;184307;0;81.4;74.8;0.0
12;2021-08-29;154;149;0;200649;184456;0;81.5;74.9;0.0
12;2021-08-30;532;1802;35;201181;186258;35;81.7;75.6;0.0
12;2021-08-31;428;1298;45;201609;187556;80;81.8;76.1;0.0
12;2021-09-01;411;946;85;202020;188502;165;82.0;76.5;0.1
12;2021-09-02;300;768;90;202320;189270;255;82.1;76.8;0.1
12;2021-09-03;476;1188;193;202796;190458;448;82.3;77.3;0.2
12;2021-09-04;431;1018;101;203227;191476;549;82.5;77.7;0.2
12;2021-09-05;52;170;14;203279;191646;563;82.5;77.8;0.2
12;2021-09-06;236;615;214;203515;192261;777;82.6;78.0;0.3
12;2021-09-07;261;463;195;203776;192724;972;82.7;78.2;0.4
12;2021-09-08;264;505;154;204040;193229;1126;82.8;78.4;0.5
12;2021-09-09;198;444;53;204238;193673;1179;82.9;78.6;0.5
12;2021-09-10;484;973;270;204722;194646;1449;83.1;79.0;0.6
12;2021-09-11;367;878;137;205089;195524;1586;83.3;79.4;0.6
12;2021-09-12;22;75;15;205111;195599;1601;83.3;79.4;0.6
12;2021-09-13;187;390;234;205298;195989;1835;83.3;79.6;0.7
12;2021-09-14;278;367;227;205576;196356;2062;83.5;79.7;0.8
12;2021-09-15;240;437;350;205816;196793;2412;83.6;79.9;1.0
12;2021-09-16;365;416;502;206181;197209;2914;83.7;80.1;1.2
12;2021-09-17;325;517;467;206506;197726;3381;83.8;80.3;1.4
12;2021-09-18;231;679;162;206737;198405;3543;83.9;80.5;1.4
12;2021-09-19;4;22;2;206741;198427;3545;83.9;80.6;1.4
12;2021-09-20;107;437;320;206848;198864;3865;84.0;80.7;1.6
12;2021-09-21;117;253;517;206965;199117;4382;84.0;80.8;1.8
12;2021-09-22;148;555;327;207113;199672;4709;84.1;81.1;1.9
12;2021-09-23;104;186;395;207217;199858;5104;84.1;81.1;2.1
12;2021-09-24;193;540;344;207410;200398;5448;84.2;81.4;2.2
12;2021-09-25;156;639;117;207566;201037;5565;84.3;81.6;2.3
12;2021-09-26;1;11;2;207567;201048;5567;84.3;81.6;2.3
12;2021-09-27;79;259;310;207646;201307;5877;84.3;81.7;2.4
12;2021-09-28;103;258;483;207749;201565;6360;84.3;81.8;2.6
12;2021-09-29;106;319;270;207855;201884;6630;84.4;82.0;2.7
12;2021-09-30;63;141;343;207918;202025;6973;84.4;82.0;2.8
12;2021-10-01;187;409;249;208105;202434;7222;84.5;82.2;2.9
12;2021-10-02;178;453;124;208283;202887;7346;84.6;82.4;3.0
12;2021-10-03;1;9;2;208284;202896;7348;84.6;82.4;3.0
12;2021-10-04;94;189;141;208378;203085;7489;84.6;82.4;3.0
12;2021-10-05;69;198;300;208447;203283;7789;84.6;82.5;3.2
12;2021-10-06;127;253;521;208574;203536;8310;84.7;82.6;3.4
12;2021-10-07;82;309;243;208656;203845;8553;84.7;82.8;3.5
12;2021-10-08;144;379;421;208800;204224;8974;84.8;82.9;3.6
12;2021-10-09;156;321;243;208956;204545;9217;84.8;83.0;3.7
12;2021-10-10;1;9;8;208957;204554;9225;84.8;83.0;3.7
12;2021-10-11;62;113;177;209019;204667;9402;84.9;83.1;3.8
12;2021-10-12;50;116;179;209069;204783;9581;84.9;83.1;3.9
12;2021-10-13;141;275;470;209210;205058;10051;84.9;83.2;4.1
12;2021-10-14;73;139;336;209283;205197;10387;85.0;83.3;4.2
12;2021-10-15;93;187;472;209376;205384;10859;85.0;83.4;4.4
12;2021-10-16;176;233;434;209552;205617;11293;85.1;83.5;4.6
12;2021-10-17;2;8;0;209554;205625;11293;85.1;83.5;4.6
12;2021-10-18;72;97;218;209626;205722;11511;85.1;83.5;4.7
12;2021-10-19;53;82;202;209679;205804;11713;85.1;83.5;4.8
12;2021-10-20;137;190;550;209816;205994;12263;85.2;83.6;5.0
12;2021-10-21;71;52;274;209887;206046;12537;85.2;83.6;5.1
12;2021-10-22;90;119;560;209977;206165;13097;85.2;83.7;5.3
12;2021-10-23;155;235;504;210132;206400;13601;85.3;83.8;5.5
12;2021-10-24;2;4;3;210134;206404;13604;85.3;83.8;5.5
12;2021-10-25;19;32;61;210153;206436;13665;85.3;83.8;5.5
12;2021-10-26;106;124;531;210259;206560;14196;85.4;83.9;5.8
12;2021-10-27;66;103;506;210325;206663;14702;85.4;83.9;6.0
12;2021-10-28;64;66;260;210389;206729;14962;85.4;83.9;6.1
12;2021-10-29;53;104;561;210442;206833;15523;85.4;84.0;6.3
12;2021-10-30;100;166;519;210542;206999;16042;85.5;84.0;6.5
12;2021-10-31;1;1;2;210543;207000;16044;85.5;84.0;6.5
12;2021-11-01;6;6;1;210549;207006;16045;85.5;84.0;6.5
12;2021-11-02;39;53;246;210588;207059;16291;85.5;84.1;6.6
12;2021-11-03;135;204;964;210723;207263;17255;85.5;84.1;7.0
12;2021-11-04;32;66;410;210755;207329;17665;85.6;84.2;7.2
12;2021-11-05;61;84;545;210816;207413;18210;85.6;84.2;7.4
12;2021-11-06;134;178;538;210950;207591;18748;85.6;84.3;7.6
12;2021-11-07;1;4;3;210951;207595;18751;85.6;84.3;7.6
12;2021-11-08;67;94;602;211018;207689;19353;85.7;84.3;7.9
12;2021-11-09;34;60;685;211052;207749;20038;85.7;84.3;8.1
12;2021-11-10;114;151;982;211166;207900;21020;85.7;84.4;8.5
12;2021-11-11;5;2;5;211171;207902;21025;85.7;84.4;8.5
12;2021-11-12;67;85;800;211238;207987;21825;85.8;84.4;8.9
12;2021-11-13;139;173;736;211377;208160;22561;85.8;84.5;9.2
12;2021-11-14;1;2;8;211378;208162;22569;85.8;84.5;9.2
12;2021-11-15;60;60;875;211438;208222;23444;85.8;84.5;9.5
12;2021-11-16;69;81;1377;211507;208303;24821;85.9;84.6;10.1
12;2021-11-17;113;115;1096;211620;208418;25917;85.9;84.6;10.5
12;2021-11-18;64;106;987;211684;208524;26904;85.9;84.7;10.9
12;2021-11-19;78;74;1228;211762;208598;28132;86.0;84.7;11.4
12;2021-11-20;102;116;847;211864;208714;28979;86.0;84.7;11.8
12;2021-11-21;2;5;19;211866;208719;28998;86.0;84.7;11.8
12;2021-11-22;59;42;1144;211925;208761;30142;86.0;84.7;12.2
12;2021-11-23;76;39;1258;212001;208800;31400;86.1;84.8;12.7
12;2021-11-24;95;105;1295;212096;208905;32695;86.1;84.8;13.3
12;2021-11-25;88;81;1458;212184;208986;34153;86.1;84.8;13.9
12;2021-11-26;129;85;1791;212313;209071;35944;86.2;84.9;14.6
12;2021-11-27;72;135;1219;212385;209206;37163;86.2;84.9;15.1
12;2021-11-28;13;6;199;212398;209212;37362;86.2;84.9;15.2
12;2021-11-29;52;56;1545;212450;209268;38907;86.2;85.0;15.8
12;2021-11-30;82;72;2003;212532;209340;40910;86.3;85.0;16.6
12;2021-12-01;79;97;1954;212611;209437;42864;86.3;85.0;17.4
12;2021-12-02;65;53;2035;212676;209490;44899;86.3;85.0;18.2
12;2021-12-03;77;81;2466;212753;209571;47365;86.4;85.1;19.2
12;2021-12-04;87;139;1506;212840;209710;48871;86.4;85.1;19.8
12;2021-12-05;12;11;53;212852;209721;48924;86.4;85.1;19.9
12;2021-12-06;57;73;1806;212909;209794;50730;86.4;85.2;20.6
12;2021-12-07;75;95;3300;212984;209889;54030;86.5;85.2;21.9
12;2021-12-08;72;116;2339;213056;210005;56369;86.5;85.3;22.9
12;2021-12-09;68;68;2911;213124;210073;59280;86.5;85.3;24.1
12;2021-12-10;81;83;3503;213205;210156;62783;86.6;85.3;25.5
12;2021-12-11;75;120;2046;213280;210276;64829;86.6;85.4;26.3
12;2021-12-12;11;6;249;213291;210282;65078;86.6;85.4;26.4
12;2021-12-13;58;81;2682;213349;210363;67760;86.6;85.4;27.5
12;2021-12-14;96;94;4525;213445;210457;72285;86.6;85.4;29.3
12;2021-12-15;70;111;2950;213515;210568;75235;86.7;85.5;30.5
12;2021-12-16;100;104;3769;213615;210672;79004;86.7;85.5;32.1
12;2021-12-17;74;108;3734;213689;210780;82738;86.7;85.6;33.6
12;2021-12-18;64;108;1656;213753;210888;84394;86.8;85.6;34.3
12;2021-12-19;37;20;720;213790;210908;85114;86.8;85.6;34.6
13;2020-12-27;4;0;0;4;0;0;0.0;0.0;0.0
13;2020-12-28;9;0;0;13;0;0;0.0;0.0;0.0
13;2020-12-29;0;0;0;13;0;0;0.0;0.0;0.0
13;2020-12-30;5;0;0;18;0;0;0.0;0.0;0.0
13;2020-12-31;4;0;0;22;0;0;0.0;0.0;0.0
13;2021-01-01;3;0;0;25;0;0;0.0;0.0;0.0
13;2021-01-02;4;1;0;29;1;0;0.0;0.0;0.0
13;2021-01-03;6;1;0;35;2;0;0.0;0.0;0.0
13;2021-01-04;3;1;0;38;3;0;0.0;0.0;0.0
13;2021-01-05;84;1;0;122;4;0;0.0;0.0;0.0
13;2021-01-06;125;1;0;247;5;0;0.0;0.0;0.0
13;2021-01-07;214;1;0;461;6;0;0.0;0.0;0.0
13;2021-01-08;242;0;0;703;6;0;0.0;0.0;0.0
13;2021-01-09;32;0;0;735;6;0;0.0;0.0;0.0
13;2021-01-10;3;0;0;738;6;0;0.0;0.0;0.0
13;2021-01-11;523;2;0;1261;8;0;0.1;0.0;0.0
13;2021-01-12;924;1;0;2185;9;0;0.1;0.0;0.0
13;2021-01-13;1135;2;0;3320;11;0;0.2;0.0;0.0
13;2021-01-14;1661;23;0;4981;34;0;0.3;0.0;0.0
13;2021-01-15;1535;7;0;6516;41;0;0.4;0.0;0.0
13;2021-01-16;458;4;0;6974;45;0;0.4;0.0;0.0
13;2021-01-17;51;0;0;7025;45;0;0.4;0.0;0.0
13;2021-01-18;2312;14;0;9337;59;0;0.5;0.0;0.0
13;2021-01-19;7063;55;0;16400;114;0;0.9;0.0;0.0
13;2021-01-20;5295;27;0;21695;141;0;1.2;0.0;0.0
13;2021-01-21;5340;40;0;27035;181;0;1.5;0.0;0.0
13;2021-01-22;3893;23;0;30928;204;0;1.8;0.0;0.0
13;2021-01-23;1291;8;0;32219;212;0;1.8;0.0;0.0
13;2021-01-24;425;4;0;32644;216;0;1.9;0.0;0.0
13;2021-01-25;2275;25;0;34919;241;0;2.0;0.0;0.0
13;2021-01-26;2799;91;0;37718;332;0;2.2;0.0;0.0
13;2021-01-27;3047;126;0;40765;458;0;2.3;0.0;0.0
13;2021-01-28;3288;226;0;44053;684;0;2.5;0.0;0.0
13;2021-01-29;2547;149;0;46600;833;0;2.7;0.0;0.0
13;2021-01-30;977;29;0;47577;862;0;2.7;0.0;0.0
13;2021-01-31;214;0;0;47791;862;0;2.7;0.0;0.0
13;2021-02-01;1807;309;0;49598;1171;0;2.8;0.1;0.0
13;2021-02-02;2248;675;0;51846;1846;0;3.0;0.1;0.0
13;2021-02-03;1771;587;0;53617;2433;0;3.1;0.1;0.0
13;2021-02-04;1878;958;0;55495;3391;0;3.2;0.2;0.0
13;2021-02-05;2455;1486;0;57950;4877;0;3.3;0.3;0.0
13;2021-02-06;800;336;0;58750;5213;0;3.4;0.3;0.0
13;2021-02-07;250;6;0;59000;5219;0;3.4;0.3;0.0
13;2021-02-08;1797;1512;0;60797;6731;0;3.5;0.4;0.0
13;2021-02-09;3189;4302;0;63986;11033;0;3.7;0.6;0.0
13;2021-02-10;3074;3308;0;67060;14341;0;3.8;0.8;0.0
13;2021-02-11;3489;3527;0;70549;17868;0;4.0;1.0;0.0
13;2021-02-12;2663;3098;0;73212;20966;0;4.2;1.2;0.0
13;2021-02-13;716;608;0;73928;21574;0;4.2;1.2;0.0
13;2021-02-14;69;333;0;73997;21907;0;4.2;1.3;0.0
13;2021-02-15;897;2010;0;74894;23917;0;4.3;1.4;0.0
13;2021-02-16;1267;2580;0;76161;26497;0;4.4;1.5;0.0
13;2021-02-17;1331;2911;0;77492;29408;0;4.4;1.7;0.0
13;2021-02-18;1854;2738;0;79346;32146;0;4.5;1.8;0.0
13;2021-02-19;1505;2258;0;80851;34404;0;4.6;2.0;0.0
13;2021-02-20;436;780;0;81287;35184;0;4.7;2.0;0.0
13;2021-02-21;31;266;0;81318;35450;0;4.7;2.0;0.0
13;2021-02-22;1006;2236;0;82324;37686;0;4.7;2.2;0.0
13;2021-02-23;1243;2496;0;83567;40182;0;4.8;2.3;0.0
13;2021-02-24;1441;2537;0;85008;42719;0;4.9;2.4;0.0
13;2021-02-25;2331;2054;0;87339;44773;0;5.0;2.6;0.0
13;2021-02-26;2402;1999;0;89741;46772;0;5.1;2.7;0.0
13;2021-02-27;956;742;0;90697;47514;0;5.2;2.7;0.0
13;2021-02-28;183;179;0;90880;47693;0;5.2;2.7;0.0
13;2021-03-01;1847;1551;0;92727;49244;0;5.3;2.8;0.0
13;2021-03-02;2918;2618;0;95645;51862;0;5.5;3.0;0.0
13;2021-03-03;3436;2611;0;99081;54473;0;5.7;3.1;0.0
13;2021-03-04;4065;3097;0;103146;57570;0;5.9;3.3;0.0
13;2021-03-05;4030;2712;0;107176;60282;0;6.1;3.4;0.0
13;2021-03-06;5290;820;0;112466;61102;0;6.4;3.5;0.0
13;2021-03-07;4175;371;0;116641;61473;0;6.7;3.5;0.0
13;2021-03-08;3844;1993;0;120485;63466;0;6.9;3.6;0.0
13;2021-03-09;4885;2319;0;125370;65785;0;7.2;3.8;0.0
13;2021-03-10;5185;2075;0;130555;67860;0;7.5;3.9;0.0
13;2021-03-11;7205;2206;0;137760;70066;0;7.9;4.0;0.0
13;2021-03-12;8201;2083;0;145961;72149;0;8.4;4.1;0.0
13;2021-03-13;6213;739;0;152174;72888;0;8.7;4.2;0.0
13;2021-03-14;2223;176;0;154397;73064;0;8.8;4.2;0.0
13;2021-03-15;6159;1248;0;160556;74312;0;9.2;4.3;0.0
13;2021-03-16;4937;1565;0;165493;75877;0;9.5;4.3;0.0
13;2021-03-17;5085;1428;0;170578;77305;0;9.8;4.4;0.0
13;2021-03-18;5711;1806;0;176289;79111;0;10.1;4.5;0.0
13;2021-03-19;6664;1585;0;182953;80696;0;10.5;4.6;0.0
13;2021-03-20;3943;681;0;186896;81377;0;10.7;4.7;0.0
13;2021-03-21;763;91;0;187659;81468;0;10.7;4.7;0.0
13;2021-03-22;6923;1528;0;194582;82996;0;11.1;4.7;0.0
13;2021-03-23;8876;1729;0;203458;84725;0;11.6;4.8;0.0
13;2021-03-24;8611;2148;0;212069;86873;0;12.1;5.0;0.0
13;2021-03-25;10691;2062;0;222760;88935;0;12.7;5.1;0.0
13;2021-03-26;10381;1869;0;233141;90804;0;13.3;5.2;0.0
13;2021-03-27;4693;811;0;237834;91615;0;13.6;5.2;0.0
13;2021-03-28;1088;82;0;238922;91697;0;13.7;5.2;0.0
13;2021-03-29;7171;1958;0;246093;93655;0;14.1;5.4;0.0
13;2021-03-30;11969;2522;0;258062;96177;0;14.8;5.5;0.0
13;2021-03-31;10356;3186;0;268418;99363;0;15.4;5.7;0.0
13;2021-04-01;11740;3053;0;280158;102416;0;16.0;5.9;0.0
13;2021-04-02;9454;3785;0;289612;106201;0;16.6;6.1;0.0
13;2021-04-03;3874;2725;0;293486;108926;0;16.8;6.2;0.0
13;2021-04-04;625;314;0;294111;109240;0;16.8;6.3;0.0
13;2021-04-05;3416;721;0;297527;109961;0;17.0;6.3;0.0
13;2021-04-06;8285;4139;0;305812;114100;0;17.5;6.5;0.0
13;2021-04-07;9722;4600;0;315534;118700;0;18.1;6.8;0.0
13;2021-04-08;9765;5363;0;325299;124063;0;18.6;7.1;0.0
13;2021-04-09;10839;5017;0;336138;129080;0;19.2;7.4;0.0
13;2021-04-10;7019;2122;0;343157;131202;0;19.6;7.5;0.0
13;2021-04-11;1385;555;0;344542;131757;0;19.7;7.5;0.0
13;2021-04-12;7678;4667;0;352220;136424;0;20.2;7.8;0.0
13;2021-04-13;8797;5361;0;361017;141785;0;20.7;8.1;0.0
13;2021-04-14;9219;5706;0;370236;147491;0;21.2;8.4;0.0
13;2021-04-15;9570;5777;0;379806;153268;0;21.7;8.8;0.0
13;2021-04-16;9581;5461;0;389387;158729;0;22.3;9.1;0.0
13;2021-04-17;4020;1991;0;393407;160720;0;22.5;9.2;0.0
13;2021-04-18;2454;1405;0;395861;162125;0;22.7;9.3;0.0
13;2021-04-19;6231;6138;0;402092;168263;0;23.0;9.6;0.0
13;2021-04-20;7203;7289;0;409295;175552;0;23.4;10.0;0.0
13;2021-04-21;7589;7106;0;416884;182658;0;23.9;10.5;0.0
13;2021-04-22;8139;7606;0;425023;190264;0;24.3;10.9;0.0
13;2021-04-23;8117;6614;0;433140;196878;0;24.8;11.3;0.0
13;2021-04-24;4537;3653;0;437677;200531;0;25.0;11.5;0.0
13;2021-04-25;914;534;0;438591;201065;0;25.1;11.5;0.0
13;2021-04-26;6002;6754;0;444593;207819;0;25.4;11.9;0.0
13;2021-04-27;7113;7611;0;451706;215430;0;25.8;12.3;0.0
13;2021-04-28;9159;7443;0;460865;222873;0;26.4;12.8;0.0
13;2021-04-29;11184;7388;0;472049;230261;0;27.0;13.2;0.0
13;2021-04-30;10564;7124;0;482613;237385;0;27.6;13.6;0.0
13;2021-05-01;5080;3588;0;487693;240973;0;27.9;13.8;0.0
13;2021-05-02;2053;735;0;489746;241708;0;28.0;13.8;0.0
13;2021-05-03;6969;7554;0;496715;249262;0;28.4;14.3;0.0
13;2021-05-04;8105;8337;0;504820;257599;0;28.9;14.7;0.0
13;2021-05-05;7955;8721;0;512775;266320;0;29.3;15.2;0.0
13;2021-05-06;9897;8393;0;522672;274713;0;29.9;15.7;0.0
13;2021-05-07;8641;9681;0;531313;284394;0;30.4;16.3;0.0
13;2021-05-08;4464;3772;0;535777;288166;0;30.7;16.5;0.0
13;2021-05-09;979;701;0;536756;288867;0;30.7;16.5;0.0
13;2021-05-10;7422;8490;0;544178;297357;0;31.1;17.0;0.0
13;2021-05-11;10641;9243;0;554819;306600;0;31.7;17.5;0.0
13;2021-05-12;12320;8528;0;567139;315128;0;32.5;18.0;0.0
13;2021-05-13;9162;3504;0;576301;318632;0;33.0;18.2;0.0
13;2021-05-14;12832;6305;0;589133;324937;0;33.7;18.6;0.0
13;2021-05-15;9728;4373;0;598861;329310;0;34.3;18.8;0.0
13;2021-05-16;3171;789;0;602032;330099;0;34.4;18.9;0.0
13;2021-05-17;10027;6648;0;612059;336747;0;35.0;19.3;0.0
13;2021-05-18;11372;6373;0;623431;343120;0;35.7;19.6;0.0
13;2021-05-19;11644;6202;0;635075;349322;0;36.3;20.0;0.0
13;2021-05-20;12666;6243;0;647741;355565;0;37.1;20.3;0.0
13;2021-05-21;12302;6611;0;660043;362176;0;37.8;20.7;0.0
13;2021-05-22;7394;3561;0;667437;365737;0;38.2;20.9;0.0
13;2021-05-23;1111;665;0;668548;366402;0;38.3;21.0;0.0
13;2021-05-24;6463;2362;0;675011;368764;0;38.6;21.1;0.0
13;2021-05-25;8772;7359;0;683783;376123;0;39.1;21.5;0.0
13;2021-05-26;9687;7617;0;693470;383740;0;39.7;22.0;0.0
13;2021-05-27;9776;8208;0;703246;391948;0;40.2;22.4;0.0
13;2021-05-28;8839;8928;0;712085;400876;0;40.7;22.9;0.0
13;2021-05-29;6707;4541;0;718792;405417;0;41.1;23.2;0.0
13;2021-05-30;934;551;0;719726;405968;0;41.2;23.2;0.0
13;2021-05-31;7753;7701;0;727479;413669;0;41.6;23.7;0.0
13;2021-06-01;9223;8960;0;736702;422629;0;42.2;24.2;0.0
13;2021-06-02;9450;8413;0;746152;431042;0;42.7;24.7;0.0
13;2021-06-03;11747;9207;0;757899;440249;0;43.4;25.2;0.0
13;2021-06-04;11501;9780;0;769400;450029;0;44.0;25.8;0.0
13;2021-06-05;7040;5455;0;776440;455484;0;44.4;26.1;0.0
13;2021-06-06;1689;902;0;778129;456386;0;44.5;26.1;0.0
13;2021-06-07;6563;9477;0;784692;465863;0;44.9;26.7;0.0
13;2021-06-08;8146;9671;0;792838;475534;0;45.4;27.2;0.0
13;2021-06-09;8110;9435;0;800948;484969;0;45.8;27.8;0.0
13;2021-06-10;8731;9479;0;809679;494448;0;46.3;28.3;0.0
13;2021-06-11;8020;12124;0;817699;506572;0;46.8;29.0;0.0
13;2021-06-12;5599;6475;0;823298;513047;0;47.1;29.4;0.0
13;2021-06-13;988;1222;0;824286;514269;0;47.2;29.4;0.0
13;2021-06-14;5766;10614;0;830052;524883;0;47.5;30.0;0.0
13;2021-06-15;7027;10927;0;837079;535810;0;47.9;30.7;0.0
13;2021-06-16;6899;9577;0;843978;545387;0;48.3;31.2;0.0
13;2021-06-17;7164;10353;0;851142;555740;0;48.7;31.8;0.0
13;2021-06-18;7081;10668;0;858223;566408;0;49.1;32.4;0.0
13;2021-06-19;4494;7212;0;862717;573620;0;49.4;32.8;0.0
13;2021-06-20;947;1033;0;863664;574653;0;49.4;32.9;0.0
13;2021-06-21;4362;11738;0;868026;586391;0;49.7;33.6;0.0
13;2021-06-22;4687;13492;0;872713;599883;0;49.9;34.3;0.0
13;2021-06-23;4822;13067;0;877535;612950;0;50.2;35.1;0.0
13;2021-06-24;5068;12160;0;882603;625110;0;50.5;35.8;0.0
13;2021-06-25;4881;13954;0;887484;639064;0;50.8;36.6;0.0
13;2021-06-26;2903;9232;0;890387;648296;0;50.9;37.1;0.0
13;2021-06-27;528;1024;0;890915;649320;0;51.0;37.2;0.0
13;2021-06-28;3620;12032;0;894535;661352;0;51.2;37.8;0.0
13;2021-06-29;4269;12551;0;898804;673903;0;51.4;38.6;0.0
13;2021-06-30;4725;12291;0;903529;686194;0;51.7;39.3;0.0
13;2021-07-01;5665;10991;0;909194;697185;0;52.0;39.9;0.0
13;2021-07-02;5576;11903;0;914770;709088;0;52.3;40.6;0.0
13;2021-07-03;3333;8797;0;918103;717885;0;52.5;41.1;0.0
13;2021-07-04;554;986;0;918657;718871;0;52.6;41.1;0.0
13;2021-07-05;3773;10925;0;922430;729796;0;52.8;41.8;0.0
13;2021-07-06;5260;11131;0;927690;740927;0;53.1;42.4;0.0
13;2021-07-07;5353;10226;1;933043;751153;1;53.4;43.0;0.0
13;2021-07-08;5921;9749;2;938964;760902;3;53.7;43.5;0.0
13;2021-07-09;5850;11349;0;944814;772251;3;54.1;44.2;0.0
13;2021-07-10;3113;8321;0;947927;780572;3;54.2;44.7;0.0
13;2021-07-11;538;1092;0;948465;781664;3;54.3;44.7;0.0
13;2021-07-12;4415;10641;0;952880;792305;3;54.5;45.3;0.0
13;2021-07-13;8738;12817;0;961618;805122;3;55.0;46.1;0.0
13;2021-07-14;5444;4566;0;967062;809688;3;55.3;46.3;0.0
13;2021-07-15;10888;12468;0;977950;822156;3;56.0;47.0;0.0
13;2021-07-16;11859;12513;0;989809;834669;3;56.6;47.8;0.0
13;2021-07-17;6467;8281;0;996276;842950;3;57.0;48.2;0.0
13;2021-07-18;936;1126;0;997212;844076;3;57.1;48.3;0.0
13;2021-07-19;9438;10717;0;1006650;854793;3;57.6;48.9;0.0
13;2021-07-20;11621;11141;0;1018271;865934;3;58.3;49.6;0.0
13;2021-07-21;12038;9992;0;1030309;875926;3;59.0;50.1;0.0
13;2021-07-22;13731;9891;0;1044040;885817;3;59.7;50.7;0.0
13;2021-07-23;13773;10563;0;1057813;896380;3;60.5;51.3;0.0
13;2021-07-24;7995;7394;0;1065808;903774;3;61.0;51.7;0.0
13;2021-07-25;1169;835;0;1066977;904609;3;61.1;51.8;0.0
13;2021-07-26;10553;8635;0;1077530;913244;3;61.7;52.3;0.0
13;2021-07-27;12716;8829;0;1090246;922073;3;62.4;52.8;0.0
13;2021-07-28;11855;7781;0;1102101;929854;3;63.1;53.2;0.0
13;2021-07-29;13184;7720;0;1115285;937574;3;63.8;53.6;0.0
13;2021-07-30;12968;8390;0;1128253;945964;3;64.6;54.1;0.0
13;2021-07-31;8181;5622;0;1136434;951586;3;65.0;54.5;0.0
13;2021-08-01;1215;733;0;1137649;952319;3;65.1;54.5;0.0
13;2021-08-02;10074;6477;0;1147723;958796;3;65.7;54.9;0.0
13;2021-08-03;10891;7100;0;1158614;965896;3;66.3;55.3;0.0
13;2021-08-04;9359;6528;0;1167973;972424;3;66.8;55.6;0.0
13;2021-08-05;9124;7305;0;1177097;979729;3;67.4;56.1;0.0
13;2021-08-06;9046;8736;0;1186143;988465;3;67.9;56.6;0.0
13;2021-08-07;5258;5376;0;1191401;993841;3;68.2;56.9;0.0
13;2021-08-08;976;887;0;1192377;994728;3;68.2;56.9;0.0
13;2021-08-09;7903;8602;0;1200280;1003330;3;68.7;57.4;0.0
13;2021-08-10;8540;8651;0;1208820;1011981;3;69.2;57.9;0.0
13;2021-08-11;7480;8374;0;1216300;1020355;3;69.6;58.4;0.0
13;2021-08-12;7324;9231;0;1223624;1029586;3;70.0;58.9;0.0
13;2021-08-13;6628;8670;0;1230252;1038256;3;70.4;59.4;0.0
13;2021-08-14;3771;6277;0;1234023;1044533;3;70.6;59.8;0.0
13;2021-08-15;526;701;0;1234549;1045234;3;70.6;59.8;0.0
13;2021-08-16;6194;10533;0;1240743;1055767;3;71.0;60.4;0.0
13;2021-08-17;6274;10157;0;1247017;1065924;3;71.4;61.0;0.0
13;2021-08-18;6020;9662;0;1253037;1075586;3;71.7;61.5;0.0
13;2021-08-19;6157;10168;0;1259194;1085754;3;72.1;62.1;0.0
13;2021-08-20;5476;10707;0;1264670;1096461;3;72.4;62.7;0.0
13;2021-08-21;2533;6948;0;1267203;1103409;3;72.5;63.1;0.0
13;2021-08-22;402;1010;0;1267605;1104419;3;72.5;63.2;0.0
13;2021-08-23;4591;10754;0;1272196;1115173;3;72.8;63.8;0.0
13;2021-08-24;4985;10605;0;1277181;1125778;3;73.1;64.4;0.0
13;2021-08-25;4769;9799;0;1281950;1135577;3;73.4;65.0;0.0
13;2021-08-26;4666;9427;0;1286616;1145004;3;73.6;65.5;0.0
13;2021-08-27;4681;10277;0;1291297;1155281;3;73.9;66.1;0.0
13;2021-08-28;2275;6379;0;1293572;1161660;3;74.0;66.5;0.0
13;2021-08-29;344;1211;0;1293916;1162871;3;74.0;66.5;0.0
13;2021-08-30;3905;9370;147;1297821;1172241;150;74.3;67.1;0.0
13;2021-08-31;4176;9616;219;1301997;1181857;369;74.5;67.6;0.0
13;2021-09-01;4669;8051;359;1306666;1189908;728;74.8;68.1;0.0
13;2021-09-02;4035;7590;544;1310701;1197498;1272;75.0;68.5;0.1
13;2021-09-03;4100;8272;790;1314801;1205770;2062;75.2;69.0;0.1
13;2021-09-04;2192;5480;182;1316993;1211250;2244;75.4;69.3;0.1
13;2021-09-05;225;467;54;1317218;1211717;2298;75.4;69.3;0.1
13;2021-09-06;3171;5612;717;1320389;1217329;3015;75.6;69.7;0.2
13;2021-09-07;3076;5972;1078;1323465;1223301;4093;75.7;70.0;0.2
13;2021-09-08;3338;6084;851;1326803;1229385;4944;75.9;70.3;0.3
13;2021-09-09;2938;5330;1081;1329741;1234715;6025;76.1;70.7;0.3
13;2021-09-10;3424;6402;1083;1333165;1241117;7108;76.3;71.0;0.4
13;2021-09-11;2247;4976;340;1335412;1246093;7448;76.4;71.3;0.4
13;2021-09-12;265;388;53;1335677;1246481;7501;76.4;71.3;0.4
13;2021-09-13;2527;3976;996;1338204;1250457;8497;76.6;71.6;0.5
13;2021-09-14;3029;4351;1951;1341233;1254808;10448;76.7;71.8;0.6
13;2021-09-15;2797;5054;2015;1344030;1259862;12463;76.9;72.1;0.7
13;2021-09-16;2113;3589;2083;1346143;1263451;14546;77.0;72.3;0.8
13;2021-09-17;2264;4536;1676;1348407;1267987;16222;77.2;72.6;0.9
13;2021-09-18;1511;4067;539;1349918;1272054;16761;77.2;72.8;1.0
13;2021-09-19;101;188;56;1350019;1272242;16817;77.3;72.8;1.0
13;2021-09-20;1471;3043;1525;1351490;1275285;18342;77.3;73.0;1.0
13;2021-09-21;1430;2768;1832;1352920;1278053;20174;77.4;73.1;1.2
13;2021-09-22;1594;4178;1426;1354514;1282231;21600;77.5;73.4;1.2
13;2021-09-23;1496;3343;2076;1356010;1285574;23676;77.6;73.6;1.4
13;2021-09-24;1502;3824;1369;1357512;1289398;25045;77.7;73.8;1.4
13;2021-09-25;1142;3689;484;1358654;1293087;25529;77.7;74.0;1.5
13;2021-09-26;101;255;49;1358755;1293342;25578;77.8;74.0;1.5
13;2021-09-27;1196;2717;1258;1359951;1296059;26836;77.8;74.2;1.5
13;2021-09-28;1225;2423;1288;1361176;1298482;28124;77.9;74.3;1.6
13;2021-09-29;1521;3289;1390;1362697;1301771;29514;78.0;74.5;1.7
13;2021-09-30;1340;2868;1778;1364037;1304639;31292;78.1;74.7;1.8
13;2021-10-01;2225;3140;1644;1366262;1307779;32936;78.2;74.8;1.9
13;2021-10-02;1177;2646;613;1367439;1310425;33549;78.2;75.0;1.9
13;2021-10-03;110;218;30;1367549;1310643;33579;78.3;75.0;1.9
13;2021-10-04;976;1553;1171;1368525;1312196;34750;78.3;75.1;2.0
13;2021-10-05;1214;2307;1993;1369739;1314503;36743;78.4;75.2;2.1
13;2021-10-06;1334;2737;1975;1371073;1317240;38718;78.5;75.4;2.2
13;2021-10-07;1099;2204;2262;1372172;1319444;40980;78.5;75.5;2.3
13;2021-10-08;1482;2746;2406;1373654;1322190;43386;78.6;75.7;2.5
13;2021-10-09;941;2092;916;1374595;1324282;44302;78.7;75.8;2.5
13;2021-10-10;96;138;66;1374691;1324420;44368;78.7;75.8;2.5
13;2021-10-11;976;1692;1901;1375667;1326112;46269;78.7;75.9;2.6
13;2021-10-12;1144;1751;2255;1376811;1327863;48524;78.8;76.0;2.8
13;2021-10-13;1220;2092;2365;1378031;1329955;50889;78.9;76.1;2.9
13;2021-10-14;1050;1785;2445;1379081;1331740;53334;78.9;76.2;3.1
13;2021-10-15;1441;2188;3348;1380522;1333928;56682;79.0;76.3;3.2
13;2021-10-16;906;1526;973;1381428;1335454;57655;79.0;76.4;3.3
13;2021-10-17;80;132;57;1381508;1335586;57712;79.1;76.4;3.3
13;2021-10-18;910;1381;2070;1382418;1336967;59782;79.1;76.5;3.4
13;2021-10-19;936;1463;2573;1383354;1338430;62355;79.2;76.6;3.6
13;2021-10-20;1151;1696;3046;1384505;1340126;65401;79.2;76.7;3.7
13;2021-10-21;903;1464;3011;1385408;1341590;68412;79.3;76.8;3.9
13;2021-10-22;1200;1933;3936;1386608;1343523;72348;79.3;76.9;4.1
13;2021-10-23;728;1174;1329;1387336;1344697;73677;79.4;76.9;4.2
13;2021-10-24;105;134;138;1387441;1344831;73815;79.4;77.0;4.2
13;2021-10-25;804;1122;2699;1388245;1345953;76514;79.4;77.0;4.4
13;2021-10-26;819;1075;2931;1389064;1347028;79445;79.5;77.1;4.5
13;2021-10-27;895;1269;3269;1389959;1348297;82714;79.5;77.2;4.7
13;2021-10-28;736;1038;3331;1390695;1349335;86045;79.6;77.2;4.9
13;2021-10-29;953;1371;3860;1391648;1350706;89905;79.6;77.3;5.1
13;2021-10-30;606;959;1582;1392254;1351665;91487;79.7;77.3;5.2
13;2021-10-31;65;93;128;1392319;1351758;91615;79.7;77.4;5.2
13;2021-11-01;188;166;104;1392507;1351924;91719;79.7;77.4;5.2
13;2021-11-02;812;1199;3261;1393319;1353123;94980;79.7;77.4;5.4
13;2021-11-03;932;1300;3758;1394251;1354423;98738;79.8;77.5;5.6
13;2021-11-04;864;1059;4008;1395115;1355482;102746;79.8;77.6;5.9
13;2021-11-05;971;1346;4439;1396086;1356828;107185;79.9;77.6;6.1
13;2021-11-06;665;919;2003;1396751;1357747;109188;79.9;77.7;6.2
13;2021-11-07;67;128;104;1396818;1357875;109292;79.9;77.7;6.3
13;2021-11-08;633;1055;3702;1397451;1358930;112994;80.0;77.8;6.5
13;2021-11-09;820;1302;5361;1398271;1360232;118355;80.0;77.8;6.8
13;2021-11-10;1051;1521;6477;1399322;1361753;124832;80.1;77.9;7.1
13;2021-11-11;149;207;750;1399471;1361960;125582;80.1;77.9;7.2
13;2021-11-12;855;1219;6460;1400326;1363179;132042;80.1;78.0;7.6
13;2021-11-13;580;783;2346;1400906;1363962;134388;80.2;78.0;7.7
13;2021-11-14;70;151;288;1400976;1364113;134676;80.2;78.1;7.7
13;2021-11-15;626;1051;4854;1401602;1365164;139530;80.2;78.1;8.0
13;2021-11-16;801;1117;6777;1402403;1366281;146307;80.2;78.2;8.4
13;2021-11-17;1018;1173;6970;1403421;1367454;153277;80.3;78.2;8.8
13;2021-11-18;841;1085;6668;1404262;1368539;159945;80.4;78.3;9.2
13;2021-11-19;996;1200;7674;1405258;1369739;167619;80.4;78.4;9.6
13;2021-11-20;809;949;3435;1406067;1370688;171054;80.5;78.4;9.8
13;2021-11-21;63;104;297;1406130;1370792;171351;80.5;78.4;9.8
13;2021-11-22;745;784;5542;1406875;1371576;176893;80.5;78.5;10.1
13;2021-11-23;861;995;7824;1407736;1372571;184717;80.6;78.5;10.6
13;2021-11-24;1136;1252;8101;1408872;1373823;192818;80.6;78.6;11.0
13;2021-11-25;901;1026;9602;1409773;1374849;202420;80.7;78.7;11.6
13;2021-11-26;1071;1150;11677;1410844;1375999;214097;80.7;78.7;12.3
13;2021-11-27;765;974;5999;1411609;1376973;220096;80.8;78.8;12.6
13;2021-11-28;48;136;453;1411657;1377109;220549;80.8;78.8;12.6
13;2021-11-29;820;925;12293;1412477;1378034;232842;80.8;78.9;13.3
13;2021-11-30;908;975;14561;1413385;1379009;247403;80.9;78.9;14.2
13;2021-12-01;960;1070;17218;1414345;1380079;264621;80.9;79.0;15.1
13;2021-12-02;874;937;16935;1415219;1381016;281556;81.0;79.0;16.1
13;2021-12-03;986;1242;20074;1416205;1382258;301630;81.0;79.1;17.3
13;2021-12-04;652;852;9804;1416857;1383110;311434;81.1;79.1;17.8
13;2021-12-05;109;177;1087;1416966;1383287;312521;81.1;79.2;17.9
13;2021-12-06;770;999;16969;1417736;1384286;329490;81.1;79.2;18.9
13;2021-12-07;979;1163;21376;1418715;1385449;350866;81.2;79.3;20.1
13;2021-12-08;1084;1367;20481;1419799;1386816;371347;81.2;79.4;21.2
13;2021-12-09;917;1168;18612;1420716;1387984;389959;81.3;79.4;22.3
13;2021-12-10;1084;1277;22209;1421800;1389261;412168;81.4;79.5;23.6
13;2021-12-11;598;925;11566;1422398;1390186;423734;81.4;79.5;24.2
13;2021-12-12;128;185;1509;1422526;1390371;425243;81.4;79.6;24.3
13;2021-12-13;778;986;17485;1423304;1391357;442728;81.4;79.6;25.3
13;2021-12-14;1009;1208;22468;1424313;1392565;465196;81.5;79.7;26.6
13;2021-12-15;1137;1346;21744;1425450;1393911;486940;81.6;79.8;27.9
13;2021-12-16;1076;1216;20247;1426526;1395127;507187;81.6;79.8;29.0
13;2021-12-17;1200;1422;22702;1427726;1396549;529889;81.7;79.9;30.3
13;2021-12-18;737;957;11956;1428463;1397506;541845;81.7;80.0;31.0
13;2021-12-19;153;247;2011;1428616;1397753;543856;81.7;80.0;31.1
14;2020-12-27;0;0;0;0;0;0;0.0;0.0;0.0
14;2020-12-28;1;0;0;1;0;0;0.0;0.0;0.0
14;2020-12-29;0;0;0;1;0;0;0.0;0.0;0.0
14;2020-12-30;0;0;0;1;0;0;0.0;0.0;0.0
14;2020-12-31;5;0;0;6;0;0;0.0;0.0;0.0
14;2021-01-01;3;0;0;9;0;0;0.0;0.0;0.0
14;2021-01-02;2;0;0;11;0;0;0.0;0.0;0.0
14;2021-01-03;0;0;0;11;0;0;0.0;0.0;0.0
14;2021-01-04;5;0;0;16;0;0;0.0;0.0;0.0
14;2021-01-05;28;0;0;44;0;0;0.0;0.0;0.0
14;2021-01-06;351;0;0;395;0;0;0.1;0.0;0.0
14;2021-01-07;421;1;0;816;1;0;0.1;0.0;0.0
14;2021-01-08;651;5;0;1467;6;0;0.2;0.0;0.0
14;2021-01-09;134;0;0;1601;6;0;0.3;0.0;0.0
14;2021-01-10;49;0;0;1650;6;0;0.3;0.0;0.0
14;2021-01-11;678;6;0;2328;12;0;0.4;0.0;0.0
14;2021-01-12;949;6;0;3277;18;0;0.5;0.0;0.0
14;2021-01-13;886;1;0;4163;19;0;0.7;0.0;0.0
14;2021-01-14;2747;29;0;6910;48;0;1.1;0.0;0.0
14;2021-01-15;1832;22;0;8742;70;0;1.5;0.0;0.0
14;2021-01-16;274;3;0;9016;73;0;1.5;0.0;0.0
14;2021-01-17;169;7;0;9185;80;0;1.5;0.0;0.0
14;2021-01-18;1084;6;0;10269;86;0;1.7;0.0;0.0
14;2021-01-19;1155;4;0;11424;90;0;1.9;0.0;0.0
14;2021-01-20;1900;5;0;13324;95;0;2.2;0.0;0.0
14;2021-01-21;1796;9;0;15120;104;0;2.5;0.0;0.0
14;2021-01-22;1432;7;0;16552;111;0;2.7;0.0;0.0
14;2021-01-23;299;1;0;16851;112;0;2.8;0.0;0.0
14;2021-01-24;98;0;0;16949;112;0;2.8;0.0;0.0
14;2021-01-25;929;14;0;17878;126;0;3.0;0.0;0.0
14;2021-01-26;839;42;0;18717;168;0;3.1;0.0;0.0
14;2021-01-27;856;161;0;19573;329;0;3.2;0.1;0.0
14;2021-01-28;755;160;0;20328;489;0;3.4;0.1;0.0
14;2021-01-29;728;245;0;21056;734;0;3.5;0.1;0.0
14;2021-01-30;271;18;0;21327;752;0;3.5;0.1;0.0
14;2021-01-31;62;6;0;21389;758;0;3.6;0.1;0.0
14;2021-02-01;691;233;0;22080;991;0;3.7;0.2;0.0
14;2021-02-02;731;414;0;22811;1405;0;3.8;0.2;0.0
14;2021-02-03;719;431;0;23530;1836;0;3.9;0.3;0.0
14;2021-02-04;1098;1954;0;24628;3790;0;4.1;0.6;0.0
14;2021-02-05;1223;1266;0;25851;5056;0;4.3;0.8;0.0
14;2021-02-06;391;223;0;26242;5279;0;4.4;0.9;0.0
14;2021-02-07;179;80;0;26421;5359;0;4.4;0.9;0.0
14;2021-02-08;728;824;0;27149;6183;0;4.5;1.0;0.0
14;2021-02-09;677;1017;0;27826;7200;0;4.6;1.2;0.0
14;2021-02-10;802;1576;0;28628;8776;0;4.8;1.5;0.0
14;2021-02-11;1281;1445;0;29909;10221;0;5.0;1.7;0.0
14;2021-02-12;1254;1081;0;31163;11302;0;5.2;1.9;0.0
14;2021-02-13;303;222;0;31466;11524;0;5.2;1.9;0.0
14;2021-02-14;84;87;0;31550;11611;0;5.2;1.9;0.0
14;2021-02-15;442;1060;0;31992;12671;0;5.3;2.1;0.0
14;2021-02-16;676;1005;0;32668;13676;0;5.4;2.3;0.0
14;2021-02-17;388;956;0;33056;14632;0;5.5;2.4;0.0
14;2021-02-18;719;882;0;33775;15514;0;5.6;2.6;0.0
14;2021-02-19;708;757;0;34483;16271;0;5.7;2.7;0.0
14;2021-02-20;95;276;0;34578;16547;0;5.7;2.7;0.0
14;2021-02-21;5;101;0;34583;16648;0;5.7;2.8;0.0
14;2021-02-22;416;975;0;34999;17623;0;5.8;2.9;0.0
14;2021-02-23;467;886;0;35466;18509;0;5.9;3.1;0.0
14;2021-02-24;439;890;0;35905;19399;0;6.0;3.2;0.0
14;2021-02-25;1187;1117;0;37092;20516;0;6.2;3.4;0.0
14;2021-02-26;1498;1107;0;38590;21623;0;6.4;3.6;0.0
14;2021-02-27;508;282;0;39098;21905;0;6.5;3.6;0.0
14;2021-02-28;33;49;0;39131;21954;0;6.5;3.6;0.0
14;2021-03-01;519;851;0;39650;22805;0;6.6;3.8;0.0
14;2021-03-02;980;769;0;40630;23574;0;6.7;3.9;0.0
14;2021-03-03;1061;798;0;41691;24372;0;6.9;4.0;0.0
14;2021-03-04;1916;784;0;43607;25156;0;7.2;4.2;0.0
14;2021-03-05;2420;803;0;46027;25959;0;7.6;4.3;0.0
14;2021-03-06;3000;202;0;49027;26161;0;8.1;4.3;0.0
14;2021-03-07;1158;67;0;50185;26228;0;8.3;4.4;0.0
14;2021-03-08;1178;772;0;51363;27000;0;8.5;4.5;0.0
14;2021-03-09;1752;676;0;53115;27676;0;8.8;4.6;0.0
14;2021-03-10;1798;577;0;54913;28253;0;9.1;4.7;0.0
14;2021-03-11;2705;456;0;57618;28709;0;9.6;4.8;0.0
14;2021-03-12;3842;541;0;61460;29250;0;10.2;4.9;0.0
14;2021-03-13;1931;177;0;63391;29427;0;10.5;4.9;0.0
14;2021-03-14;96;41;0;63487;29468;0;10.5;4.9;0.0
14;2021-03-15;1982;143;0;65469;29611;0;10.9;4.9;0.0
14;2021-03-16;1434;280;0;66903;29891;0;11.1;5.0;0.0
14;2021-03-17;1127;192;0;68030;30083;0;11.3;5.0;0.0
14;2021-03-18;1407;287;0;69437;30370;0;11.5;5.0;0.0
14;2021-03-19;2532;261;0;71969;30631;0;11.9;5.1;0.0
14;2021-03-20;2593;45;0;74562;30676;0;12.4;5.1;0.0
14;2021-03-21;480;10;0;75042;30686;0;12.5;5.1;0.0
14;2021-03-22;1813;365;0;76855;31051;0;12.8;5.2;0.0
14;2021-03-23;2203;333;0;79058;31384;0;13.1;5.2;0.0
14;2021-03-24;2430;207;0;81488;31591;0;13.5;5.2;0.0
14;2021-03-25;3212;327;0;84700;31918;0;14.1;5.3;0.0
14;2021-03-26;4464;460;0;89164;32378;0;14.8;5.4;0.0
14;2021-03-27;2337;210;0;91501;32588;0;15.2;5.4;0.0
14;2021-03-28;116;7;0;91617;32595;0;15.2;5.4;0.0
14;2021-03-29;1656;508;0;93273;33103;0;15.5;5.5;0.0
14;2021-03-30;2696;535;0;95969;33638;0;15.9;5.6;0.0
14;2021-03-31;2318;937;0;98287;34575;0;16.3;5.7;0.0
14;2021-04-01;4073;1668;0;102360;36243;0;17.0;6.0;0.0
14;2021-04-02;3700;1264;0;106060;37507;0;17.6;6.2;0.0
14;2021-04-03;1111;1173;0;107171;38680;0;17.8;6.4;0.0
14;2021-04-04;53;443;0;107224;39123;0;17.8;6.5;0.0
14;2021-04-05;1133;304;0;108357;39427;0;18.0;6.5;0.0
14;2021-04-06;2338;1037;0;110695;40464;0;18.4;6.7;0.0
14;2021-04-07;2568;1040;0;113263;41504;0;18.8;6.9;0.0
14;2021-04-08;4120;1132;0;117383;42636;0;19.5;7.1;0.0
14;2021-04-09;5674;1120;0;123057;43756;0;20.4;7.3;0.0
14;2021-04-10;2861;462;0;125918;44218;0;20.9;7.3;0.0
14;2021-04-11;593;157;0;126511;44375;0;21.0;7.4;0.0
14;2021-04-12;2761;1560;0;129272;45935;0;21.5;7.6;0.0
14;2021-04-13;3334;1461;0;132606;47396;0;22.0;7.9;0.0
14;2021-04-14;2948;1148;0;135554;48544;0;22.5;8.1;0.0
14;2021-04-15;4242;1467;0;139796;50011;0;23.2;8.3;0.0
14;2021-04-16;4370;1504;0;144166;51515;0;23.9;8.6;0.0
14;2021-04-17;2349;1623;0;146515;53138;0;24.3;8.8;0.0
14;2021-04-18;520;344;0;147035;53482;0;24.4;8.9;0.0
14;2021-04-19;2643;1645;0;149678;55127;0;24.8;9.2;0.0
14;2021-04-20;3268;1861;0;152946;56988;0;25.4;9.5;0.0
14;2021-04-21;2836;1461;0;155782;58449;0;25.9;9.7;0.0
14;2021-04-22;4002;2071;0;159784;60520;0;26.5;10.0;0.0
14;2021-04-23;4433;2249;0;164217;62769;0;27.3;10.4;0.0
14;2021-04-24;1856;1793;0;166073;64562;0;27.6;10.7;0.0
14;2021-04-25;462;79;0;166535;64641;0;27.6;10.7;0.0
14;2021-04-26;3152;1567;0;169687;66208;0;28.2;11.0;0.0
14;2021-04-27;3382;2500;0;173069;68708;0;28.7;11.4;0.0
14;2021-04-28;3111;1839;0;176180;70547;0;29.2;11.7;0.0
14;2021-04-29;4309;2259;0;180489;72806;0;30.0;12.1;0.0
14;2021-04-30;4872;2605;0;185361;75411;0;30.8;12.5;0.0
14;2021-05-01;3495;222;0;188856;75633;0;31.4;12.6;0.0
14;2021-05-02;1227;76;0;190083;75709;0;31.6;12.6;0.0
14;2021-05-03;2277;2653;0;192360;78362;0;31.9;13.0;0.0
14;2021-05-04;2925;2858;0;195285;81220;0;32.4;13.5;0.0
14;2021-05-05;3523;2594;0;198808;83814;0;33.0;13.9;0.0
14;2021-05-06;4679;3383;0;203487;87197;0;33.8;14.5;0.0
14;2021-05-07;4551;3638;0;208038;90835;0;34.5;15.1;0.0
14;2021-05-08;2788;1220;0;210826;92055;0;35.0;15.3;0.0
14;2021-05-09;1879;615;0;212705;92670;0;35.3;15.4;0.0
14;2021-05-10;3431;3035;0;216136;95705;0;35.9;15.9;0.0
14;2021-05-11;4094;3460;0;220230;99165;0;36.6;16.5;0.0
14;2021-05-12;3961;3103;0;224191;102268;0;37.2;17.0;0.0
14;2021-05-13;4304;1047;0;228495;103315;0;37.9;17.2;0.0
14;2021-05-14;6210;2482;0;234705;105797;0;39.0;17.6;0.0
14;2021-05-15;5109;841;0;239814;106638;0;39.8;17.7;0.0
14;2021-05-16;2381;136;0;242195;106774;0;40.2;17.7;0.0
14;2021-05-17;2750;2121;0;244945;108895;0;40.7;18.1;0.0
14;2021-05-18;3903;2143;0;248848;111038;0;41.3;18.4;0.0
14;2021-05-19;3747;1951;0;252595;112989;0;41.9;18.8;0.0
14;2021-05-20;4383;2620;0;256978;115609;0;42.7;19.2;0.0
14;2021-05-21;4124;3319;0;261102;118928;0;43.3;19.7;0.0
14;2021-05-22;1861;865;0;262963;119793;0;43.7;19.9;0.0
14;2021-05-23;831;83;0;263794;119876;0;43.8;19.9;0.0
14;2021-05-24;2751;688;0;266545;120564;0;44.2;20.0;0.0
14;2021-05-25;3521;3268;0;270066;123832;0;44.8;20.6;0.0
14;2021-05-26;3332;2300;0;273398;126132;0;45.4;20.9;0.0
14;2021-05-27;4529;3146;0;277927;129278;0;46.1;21.5;0.0
14;2021-05-28;4804;3711;0;282731;132989;0;46.9;22.1;0.0
14;2021-05-29;2372;2465;0;285103;135454;0;47.3;22.5;0.0
14;2021-05-30;845;268;0;285948;135722;0;47.5;22.5;0.0
14;2021-05-31;3859;2831;0;289807;138553;0;48.1;23.0;0.0
14;2021-06-01;5382;3120;0;295189;141673;0;49.0;23.5;0.0
14;2021-06-02;4728;2743;0;299917;144416;0;49.8;24.0;0.0
14;2021-06-03;6165;3907;0;306082;148323;0;50.8;24.6;0.0
14;2021-06-04;6058;4929;0;312140;153252;0;51.8;25.4;0.0
14;2021-06-05;4168;1832;0;316308;155084;0;52.5;25.7;0.0
14;2021-06-06;2021;137;0;318329;155221;0;52.8;25.8;0.0
14;2021-06-07;4125;3261;0;322454;158482;0;53.5;26.3;0.0
14;2021-06-08;4924;2966;0;327378;161448;0;54.3;26.8;0.0
14;2021-06-09;4027;2871;0;331405;164319;0;55.0;27.3;0.0
14;2021-06-10;4789;2904;0;336194;167223;0;55.8;27.8;0.0
14;2021-06-11;4638;4674;0;340832;171897;0;56.6;28.5;0.0
14;2021-06-12;3562;4482;0;344394;176379;0;57.2;29.3;0.0
14;2021-06-13;933;1149;0;345327;177528;0;57.3;29.5;0.0
14;2021-06-14;2206;3516;0;347533;181044;0;57.7;30.1;0.0
14;2021-06-15;3194;3728;0;350727;184772;0;58.2;30.7;0.0
14;2021-06-16;3330;4386;0;354057;189158;0;58.8;31.4;0.0
14;2021-06-17;4035;5087;0;358092;194245;0;59.4;32.2;0.0
14;2021-06-18;3668;5824;0;361760;200069;0;60.1;33.2;0.0
14;2021-06-19;2600;2965;0;364360;203034;0;60.5;33.7;0.0
14;2021-06-20;643;1601;0;365003;204635;0;60.6;34.0;0.0
14;2021-06-21;2063;4149;0;367066;208784;0;60.9;34.7;0.0
14;2021-06-22;2445;4980;0;369511;213764;0;61.3;35.5;0.0
14;2021-06-23;2434;4247;0;371945;218011;0;61.7;36.2;0.0
14;2021-06-24;3283;5599;0;375228;223610;0;62.3;37.1;0.0
14;2021-06-25;2642;6951;0;377870;230561;0;62.7;38.3;0.0
14;2021-06-26;2104;4588;0;379974;235149;0;63.1;39.0;0.0
14;2021-06-27;467;1975;0;380441;237124;0;63.2;39.4;0.0
14;2021-06-28;1276;3836;0;381717;240960;0;63.4;40.0;0.0
14;2021-06-29;1721;5128;0;383438;246088;0;63.7;40.9;0.0
14;2021-06-30;1906;4588;0;385344;250676;0;64.0;41.6;0.0
14;2021-07-01;2821;5080;0;388165;255756;0;64.4;42.5;0.0
14;2021-07-02;2458;6404;0;390623;262160;0;64.8;43.5;0.0
14;2021-07-03;1406;2796;0;392029;264956;0;65.1;44.0;0.0
14;2021-07-04;466;908;0;392495;265864;0;65.2;44.1;0.0
14;2021-07-05;1192;4595;0;393687;270459;0;65.4;44.9;0.0
14;2021-07-06;2030;5815;0;395717;276274;0;65.7;45.9;0.0
14;2021-07-07;2137;4389;0;397854;280663;0;66.0;46.6;0.0
14;2021-07-08;2752;5363;0;400606;286026;0;66.5;47.5;0.0
14;2021-07-09;2665;6144;0;403271;292170;0;66.9;48.5;0.0
14;2021-07-10;1935;3232;0;405206;295402;0;67.3;49.0;0.0
14;2021-07-11;928;976;0;406134;296378;0;67.4;49.2;0.0
14;2021-07-12;1522;5653;0;407656;302031;0;67.7;50.1;0.0
14;2021-07-13;2930;7101;0;410586;309132;0;68.2;51.3;0.0
14;2021-07-14;2156;2890;0;412742;312022;0;68.5;51.8;0.0
14;2021-07-15;3908;7243;0;416650;319265;0;69.2;53.0;0.0
14;2021-07-16;4541;7297;0;421191;326562;0;69.9;54.2;0.0
14;2021-07-17;2099;4036;0;423290;330598;0;70.3;54.9;0.0
14;2021-07-18;817;1929;0;424107;332527;0;70.4;55.2;0.0
14;2021-07-19;2576;5809;0;426683;338336;0;70.8;56.2;0.0
14;2021-07-20;3245;6876;0;429928;345212;0;71.4;57.3;0.0
14;2021-07-21;3975;5594;0;433903;350806;0;72.0;58.2;0.0
14;2021-07-22;4849;6210;0;438752;357016;0;72.8;59.3;0.0
14;2021-07-23;5175;6490;0;443927;363506;0;73.7;60.3;0.0
14;2021-07-24;2900;3666;0;446827;367172;0;74.2;61.0;0.0
14;2021-07-25;1457;1308;0;448284;368480;0;74.4;61.2;0.0
14;2021-07-26;4324;3941;0;452608;372421;0;75.1;61.8;0.0
14;2021-07-27;5078;4218;0;457686;376639;0;76.0;62.5;0.0
14;2021-07-28;4913;3803;0;462599;380442;0;76.8;63.2;0.0
14;2021-07-29;6074;4624;0;468673;385066;0;77.8;63.9;0.0
14;2021-07-30;5460;4768;0;474133;389834;0;78.7;64.7;0.0
14;2021-07-31;2736;2445;0;476869;392279;0;79.2;65.1;0.0
14;2021-08-01;1793;943;0;478662;393222;0;79.5;65.3;0.0
14;2021-08-02;3664;4028;0;482326;397250;0;80.1;65.9;0.0
14;2021-08-03;4242;3869;0;486568;401119;0;80.8;66.6;0.0
14;2021-08-04;4207;3311;0;490775;404430;0;81.5;67.1;0.0
14;2021-08-05;4317;3791;0;495092;408221;0;82.2;67.8;0.0
14;2021-08-06;4023;4537;0;499115;412758;0;82.9;68.5;0.0
14;2021-08-07;1944;2170;0;501059;414928;0;83.2;68.9;0.0
14;2021-08-08;672;890;0;501731;415818;0;83.3;69.0;0.0
14;2021-08-09;2074;2831;0;503805;418649;0;83.6;69.5;0.0
14;2021-08-10;3353;3802;0;507158;422451;0;84.2;70.1;0.0
14;2021-08-11;2806;3192;0;509964;425643;0;84.7;70.7;0.0
14;2021-08-12;3096;4178;0;513060;429821;0;85.2;71.4;0.0
14;2021-08-13;2399;3957;0;515459;433778;0;85.6;72.0;0.0
14;2021-08-14;1290;1911;0;516749;435689;0;85.8;72.3;0.0
14;2021-08-15;365;1414;0;517114;437103;0;85.8;72.6;0.0
14;2021-08-16;1691;2810;0;518805;439913;0;86.1;73.0;0.0
14;2021-08-17;2062;4340;0;520867;444253;0;86.5;73.7;0.0
14;2021-08-18;1863;4277;0;522730;448530;0;86.8;74.5;0.0
14;2021-08-19;2147;4843;0;524877;453373;0;87.1;75.3;0.0
14;2021-08-20;1969;5129;0;526846;458502;0;87.5;76.1;0.0
14;2021-08-21;933;2782;0;527779;461284;0;87.6;76.6;0.0
14;2021-08-22;195;1628;0;527974;462912;0;87.6;76.8;0.0
14;2021-08-23;1142;4051;0;529116;466963;0;87.8;77.5;0.0
14;2021-08-24;1243;4208;0;530359;471171;0;88.0;78.2;0.0
14;2021-08-25;1298;4018;0;531657;475189;0;88.3;78.9;0.0
14;2021-08-26;1318;4684;0;532975;479873;0;88.5;79.7;0.0
14;2021-08-27;1348;4972;0;534323;484845;0;88.7;80.5;0.0
14;2021-08-28;713;2819;0;535036;487664;0;88.8;81.0;0.0
14;2021-08-29;201;1048;0;535237;488712;0;88.9;81.1;0.0
14;2021-08-30;921;3384;71;536158;492096;71;89.0;81.7;0.0
14;2021-08-31;1224;4423;155;537382;496519;226;89.2;82.4;0.0
14;2021-09-01;998;3415;349;538380;499934;575;89.4;83.0;0.1
14;2021-09-02;814;2813;312;539194;502747;887;89.5;83.5;0.1
14;2021-09-03;1051;3497;479;540245;506244;1366;89.7;84.0;0.2
14;2021-09-04;676;2200;144;540921;508444;1510;89.8;84.4;0.3
14;2021-09-05;145;432;54;541066;508876;1564;89.8;84.5;0.3
14;2021-09-06;447;1735;375;541513;510611;1939;89.9;84.8;0.3
14;2021-09-07;472;1798;348;541985;512409;2287;90.0;85.1;0.4
14;2021-09-08;643;2529;430;542628;514938;2717;90.1;85.5;0.5
14;2021-09-09;567;1674;399;543195;516612;3116;90.2;85.8;0.5
14;2021-09-10;732;2291;579;543927;518903;3695;90.3;86.1;0.6
14;2021-09-11;511;1427;142;544438;520330;3837;90.4;86.4;0.6
14;2021-09-12;71;265;51;544509;520595;3888;90.4;86.4;0.6
14;2021-09-13;319;1083;506;544828;521678;4394;90.4;86.6;0.7
14;2021-09-14;632;1223;839;545460;522901;5233;90.6;86.8;0.9
14;2021-09-15;688;1864;711;546148;524765;5944;90.7;87.1;1.0
14;2021-09-16;526;1178;743;546674;525943;6687;90.8;87.3;1.1
14;2021-09-17;570;1322;634;547244;527265;7321;90.8;87.5;1.2
14;2021-09-18;249;985;110;547493;528250;7431;90.9;87.7;1.2
14;2021-09-19;45;150;10;547538;528400;7441;90.9;87.7;1.2
14;2021-09-20;330;727;705;547868;529127;8146;91.0;87.8;1.4
14;2021-09-21;463;766;841;548331;529893;8987;91.0;88.0;1.5
14;2021-09-22;404;1564;809;548735;531457;9796;91.1;88.2;1.6
14;2021-09-23;393;720;772;549128;532177;10568;91.2;88.3;1.8
14;2021-09-24;411;1229;928;549539;533406;11496;91.2;88.5;1.9
14;2021-09-25;200;713;118;549739;534119;11614;91.3;88.7;1.9
14;2021-09-26;41;144;18;549780;534263;11632;91.3;88.7;1.9
14;2021-09-27;270;681;645;550050;534944;12277;91.3;88.8;2.0
14;2021-09-28;345;640;669;550395;535584;12946;91.4;88.9;2.1
14;2021-09-29;301;881;628;550696;536465;13574;91.4;89.1;2.3
14;2021-09-30;313;614;896;551009;537079;14470;91.5;89.2;2.4
14;2021-10-01;440;787;625;551449;537866;15095;91.5;89.3;2.5
14;2021-10-02;263;545;189;551712;538411;15284;91.6;89.4;2.5
14;2021-10-03;35;67;13;551747;538478;15297;91.6;89.4;2.5
14;2021-10-04;267;458;671;552014;538936;15968;91.6;89.5;2.7
14;2021-10-05;261;452;793;552275;539388;16761;91.7;89.5;2.8
14;2021-10-06;366;765;790;552641;540153;17551;91.7;89.7;2.9
14;2021-10-07;218;409;642;552859;540562;18193;91.8;89.7;3.0
14;2021-10-08;380;761;947;553239;541323;19140;91.8;89.9;3.2
14;2021-10-09;192;355;150;553431;541678;19290;91.9;89.9;3.2
14;2021-10-10;8;8;5;553439;541686;19295;91.9;89.9;3.2
14;2021-10-11;173;444;635;553612;542130;19930;91.9;90.0;3.3
14;2021-10-12;286;552;1027;553898;542682;20957;92.0;90.1;3.5
14;2021-10-13;329;471;819;554227;543153;21776;92.0;90.2;3.6
14;2021-10-14;195;417;732;554422;543570;22508;92.0;90.2;3.7
14;2021-10-15;419;549;1375;554841;544119;23883;92.1;90.3;4.0
14;2021-10-16;185;261;552;555026;544380;24435;92.1;90.4;4.1
14;2021-10-17;3;9;11;555029;544389;24446;92.1;90.4;4.1
14;2021-10-18;199;326;729;555228;544715;25175;92.2;90.4;4.2
14;2021-10-19;194;403;980;555422;545118;26155;92.2;90.5;4.3
14;2021-10-20;215;326;902;555637;545444;27057;92.2;90.5;4.5
14;2021-10-21;216;459;975;555853;545903;28032;92.3;90.6;4.7
14;2021-10-22;343;473;1375;556196;546376;29407;92.3;90.7;4.9
14;2021-10-23;166;246;309;556362;546622;29716;92.4;90.7;4.9
14;2021-10-24;10;11;78;556372;546633;29794;92.4;90.7;4.9
14;2021-10-25;193;271;1233;556565;546904;31027;92.4;90.8;5.2
14;2021-10-26;181;218;950;556746;547122;31977;92.4;90.8;5.3
14;2021-10-27;202;436;1447;556948;547558;33424;92.5;90.9;5.5
14;2021-10-28;139;162;823;557087;547720;34247;92.5;90.9;5.7
14;2021-10-29;281;412;1733;557368;548132;35980;92.5;91.0;6.0
14;2021-10-30;97;188;238;557465;548320;36218;92.5;91.0;6.0
14;2021-10-31;2;7;15;557467;548327;36233;92.5;91.0;6.0
14;2021-11-01;6;4;10;557473;548331;36243;92.5;91.0;6.0
14;2021-11-02;184;297;1025;557657;548628;37268;92.6;91.1;6.2
14;2021-11-03;218;318;1443;557875;548946;38711;92.6;91.1;6.4
14;2021-11-04;156;217;1220;558031;549163;39931;92.6;91.2;6.6
14;2021-11-05;257;365;1825;558288;549528;41756;92.7;91.2;6.9
14;2021-11-06;88;150;326;558376;549678;42082;92.7;91.3;7.0
14;2021-11-07;11;14;16;558387;549692;42098;92.7;91.3;7.0
14;2021-11-08;109;243;1710;558496;549935;43808;92.7;91.3;7.3
14;2021-11-09;180;316;2328;558676;550251;46136;92.7;91.3;7.7
14;2021-11-10;259;384;2168;558935;550635;48304;92.8;91.4;8.0
14;2021-11-11;18;22;41;558953;550657;48345;92.8;91.4;8.0
14;2021-11-12;241;375;2138;559194;551032;50483;92.8;91.5;8.4
14;2021-11-13;128;210;696;559322;551242;51179;92.9;91.5;8.5
14;2021-11-14;8;11;30;559330;551253;51209;92.9;91.5;8.5
14;2021-11-15;134;262;2399;559464;551515;53608;92.9;91.6;8.9
14;2021-11-16;173;205;2577;559637;551720;56185;92.9;91.6;9.3
14;2021-11-17;259;312;2838;559896;552032;59023;92.9;91.6;9.8
14;2021-11-18;174;219;2235;560070;552251;61258;93.0;91.7;10.2
14;2021-11-19;359;430;4028;560429;552681;65286;93.0;91.7;10.8
14;2021-11-20;150;156;822;560579;552837;66108;93.1;91.8;11.0
14;2021-11-21;15;19;42;560594;552856;66150;93.1;91.8;11.0
14;2021-11-22;138;139;2392;560732;552995;68542;93.1;91.8;11.4
14;2021-11-23;231;164;3382;560963;553159;71924;93.1;91.8;11.9
14;2021-11-24;332;306;2878;561295;553465;74802;93.2;91.9;12.4
14;2021-11-25;177;143;2650;561472;553608;77452;93.2;91.9;12.9
14;2021-11-26;292;353;6061;561764;553961;83513;93.3;92.0;13.9
14;2021-11-27;144;171;2809;561908;554132;86322;93.3;92.0;14.3
14;2021-11-28;45;25;1570;561953;554157;87892;93.3;92.0;14.6
14;2021-11-29;128;159;4274;562081;554316;92166;93.3;92.0;15.3
14;2021-11-30;237;216;7160;562318;554532;99326;93.3;92.1;16.5
14;2021-12-01;236;223;7158;562554;554755;106484;93.4;92.1;17.7
14;2021-12-02;193;166;7993;562747;554921;114477;93.4;92.1;19.0
14;2021-12-03;211;245;10325;562958;555166;124802;93.5;92.2;20.7
14;2021-12-04;106;135;3922;563064;555301;128724;93.5;92.2;21.4
14;2021-12-05;33;25;2161;563097;555326;130885;93.5;92.2;21.7
14;2021-12-06;116;146;5393;563213;555472;136278;93.5;92.2;22.6
14;2021-12-07;206;199;8775;563419;555671;145053;93.5;92.2;24.1
14;2021-12-08;188;231;7438;563607;555902;152491;93.6;92.3;25.3
14;2021-12-09;194;200;8575;563801;556102;161066;93.6;92.3;26.7
14;2021-12-10;237;345;10485;564038;556447;171551;93.6;92.4;28.5
14;2021-12-11;99;131;3613;564137;556578;175164;93.7;92.4;29.1
14;2021-12-12;48;52;2108;564185;556630;177272;93.7;92.4;29.4
14;2021-12-13;146;185;6519;564331;556815;183791;93.7;92.4;30.5
14;2021-12-14;217;266;9818;564548;557081;193609;93.7;92.5;32.1
14;2021-12-15;209;301;8691;564757;557382;202300;93.8;92.5;33.6
14;2021-12-16;191;217;9143;564948;557599;211443;93.8;92.6;35.1
14;2021-12-17;272;415;12058;565220;558014;223501;93.8;92.6;37.1
14;2021-12-18;155;157;5921;565375;558171;229422;93.9;92.7;38.1
14;2021-12-19;62;64;2284;565437;558235;231706;93.9;92.7;38.5
15;2020-12-27;0;0;0;0;0;0;0.0;0.0;0.0
15;2020-12-28;0;0;0;0;0;0;0.0;0.0;0.0
15;2020-12-29;0;0;0;0;0;0;0.0;0.0;0.0
15;2020-12-30;0;0;0;0;0;0;0.0;0.0;0.0
15;2020-12-31;0;0;0;0;0;0;0.0;0.0;0.0
15;2021-01-01;1;0;0;1;0;0;0.0;0.0;0.0
15;2021-01-02;0;0;0;1;0;0;0.0;0.0;0.0
15;2021-01-03;0;0;0;1;0;0;0.0;0.0;0.0
15;2021-01-04;0;0;0;1;0;0;0.0;0.0;0.0
15;2021-01-05;0;0;0;1;0;0;0.0;0.0;0.0
15;2021-01-06;1;0;0;2;0;0;0.0;0.0;0.0
15;2021-01-07;71;1;0;73;1;0;0.1;0.0;0.0
15;2021-01-08;102;2;0;175;3;0;0.1;0.0;0.0
15;2021-01-09;1;0;0;176;3;0;0.1;0.0;0.0
15;2021-01-10;3;0;0;179;3;0;0.1;0.0;0.0
15;2021-01-11;95;1;0;274;4;0;0.2;0.0;0.0
15;2021-01-12;98;0;0;372;4;0;0.3;0.0;0.0
15;2021-01-13;246;0;0;618;4;0;0.5;0.0;0.0
15;2021-01-14;305;5;0;923;9;0;0.7;0.0;0.0
15;2021-01-15;137;0;0;1060;9;0;0.8;0.0;0.0
15;2021-01-16;83;0;0;1143;9;0;0.9;0.0;0.0
15;2021-01-17;0;0;0;1143;9;0;0.9;0.0;0.0
15;2021-01-18;384;3;0;1527;12;0;1.2;0.0;0.0
15;2021-01-19;483;0;0;2010;12;0;1.6;0.0;0.0
15;2021-01-20;577;2;0;2587;14;0;2.0;0.0;0.0
15;2021-01-21;522;4;0;3109;18;0;2.4;0.0;0.0
15;2021-01-22;496;4;0;3605;22;0;2.8;0.0;0.0
15;2021-01-23;400;1;0;4005;23;0;3.1;0.0;0.0
15;2021-01-24;4;0;0;4009;23;0;3.1;0.0;0.0
15;2021-01-25;382;0;0;4391;23;0;3.4;0.0;0.0
15;2021-01-26;418;0;0;4809;23;0;3.8;0.0;0.0
15;2021-01-27;755;8;0;5564;31;0;4.3;0.0;0.0
15;2021-01-28;628;50;0;6192;81;0;4.8;0.1;0.0
15;2021-01-29;332;73;0;6524;154;0;5.1;0.1;0.0
15;2021-01-30;200;2;0;6724;156;0;5.3;0.1;0.0
15;2021-01-31;0;0;0;6724;156;0;5.3;0.1;0.0
15;2021-02-01;230;90;0;6954;246;0;5.4;0.2;0.0
15;2021-02-02;177;86;0;7131;332;0;5.6;0.3;0.0
15;2021-02-03;263;177;0;7394;509;0;5.8;0.4;0.0
15;2021-02-04;621;196;0;8015;705;0;6.3;0.6;0.0
15;2021-02-05;277;236;0;8292;941;0;6.5;0.7;0.0
15;2021-02-06;89;70;0;8381;1011;0;6.5;0.8;0.0
15;2021-02-07;0;0;0;8381;1011;0;6.5;0.8;0.0
15;2021-02-08;220;106;0;8601;1117;0;6.7;0.9;0.0
15;2021-02-09;192;100;0;8793;1217;0;6.9;1.0;0.0
15;2021-02-10;339;234;0;9132;1451;0;7.1;1.1;0.0
15;2021-02-11;132;211;0;9264;1662;0;7.2;1.3;0.0
15;2021-02-12;141;164;0;9405;1826;0;7.3;1.4;0.0
15;2021-02-13;91;74;0;9496;1900;0;7.4;1.5;0.0
15;2021-02-14;0;0;0;9496;1900;0;7.4;1.5;0.0
15;2021-02-15;62;216;0;9558;2116;0;7.5;1.7;0.0
15;2021-02-16;54;278;0;9612;2394;0;7.5;1.9;0.0
15;2021-02-17;130;448;0;9742;2842;0;7.6;2.2;0.0
15;2021-02-18;105;738;0;9847;3580;0;7.7;2.8;0.0
15;2021-02-19;101;421;0;9948;4001;0;7.8;3.1;0.0
15;2021-02-20;19;242;0;9967;4243;0;7.8;3.3;0.0
15;2021-02-21;0;1;0;9967;4244;0;7.8;3.3;0.0
15;2021-02-22;25;485;0;9992;4729;0;7.8;3.7;0.0
15;2021-02-23;181;448;0;10173;5177;0;7.9;4.0;0.0
15;2021-02-24;48;426;0;10221;5603;0;8.0;4.4;0.0
15;2021-02-25;220;949;0;10441;6552;0;8.2;5.1;0.0
15;2021-02-26;176;446;0;10617;6998;0;8.3;5.5;0.0
15;2021-02-27;123;81;0;10740;7079;0;8.4;5.5;0.0
15;2021-02-28;1;0;0;10741;7079;0;8.4;5.5;0.0
15;2021-03-01;112;214;0;10853;7293;0;8.5;5.7;0.0
15;2021-03-02;248;300;0;11101;7593;0;8.7;5.9;0.0
15;2021-03-03;237;37;0;11338;7630;0;8.9;6.0;0.0
15;2021-03-04;253;265;0;11591;7895;0;9.1;6.2;0.0
15;2021-03-05;348;162;0;11939;8057;0;9.3;6.3;0.0
15;2021-03-06;669;14;0;12608;8071;0;9.9;6.3;0.0
15;2021-03-07;98;3;0;12706;8074;0;9.9;6.3;0.0
15;2021-03-08;102;106;0;12808;8180;0;10.0;6.4;0.0
15;2021-03-09;293;282;0;13101;8462;0;10.2;6.6;0.0
15;2021-03-10;455;174;0;13556;8636;0;10.6;6.7;0.0
15;2021-03-11;417;307;0;13973;8943;0;10.9;7.0;0.0
15;2021-03-12;536;102;0;14509;9045;0;11.3;7.1;0.0
15;2021-03-13;354;9;0;14863;9054;0;11.6;7.1;0.0
15;2021-03-14;18;1;0;14881;9055;0;11.6;7.1;0.0
15;2021-03-15;557;60;0;15438;9115;0;12.1;7.1;0.0
15;2021-03-16;333;31;0;15771;9146;0;12.3;7.1;0.0
15;2021-03-17;204;42;0;15975;9188;0;12.5;7.2;0.0
15;2021-03-18;245;113;0;16220;9301;0;12.7;7.3;0.0
15;2021-03-19;698;48;0;16918;9349;0;13.2;7.3;0.0
15;2021-03-20;140;34;0;17058;9383;0;13.3;7.3;0.0
15;2021-03-21;7;0;0;17065;9383;0;13.3;7.3;0.0
15;2021-03-22;591;79;0;17656;9462;0;13.8;7.4;0.0
15;2021-03-23;774;100;0;18430;9562;0;14.4;7.5;0.0
15;2021-03-24;922;44;0;19352;9606;0;15.1;7.5;0.0
15;2021-03-25;1245;50;0;20597;9656;0;16.1;7.5;0.0
15;2021-03-26;1003;66;0;21600;9722;0;16.9;7.6;0.0
15;2021-03-27;311;8;0;21911;9730;0;17.1;7.6;0.0
15;2021-03-28;25;0;0;21936;9730;0;17.1;7.6;0.0
15;2021-03-29;734;24;0;22670;9754;0;17.7;7.6;0.0
15;2021-03-30;1097;191;0;23767;9945;0;18.6;7.8;0.0
15;2021-03-31;928;41;0;24695;9986;0;19.3;7.8;0.0
15;2021-04-01;1199;103;0;25894;10089;0;20.2;7.9;0.0
15;2021-04-02;1083;70;0;26977;10159;0;21.1;7.9;0.0
15;2021-04-03;133;24;0;27110;10183;0;21.2;8.0;0.0
15;2021-04-04;4;0;0;27114;10183;0;21.2;8.0;0.0
15;2021-04-05;37;2;0;27151;10185;0;21.2;8.0;0.0
15;2021-04-06;783;102;0;27934;10287;0;21.8;8.0;0.0
15;2021-04-07;679;105;0;28613;10392;0;22.4;8.1;0.0
15;2021-04-08;1135;187;0;29748;10579;0;23.2;8.3;0.0
15;2021-04-09;1171;126;0;30919;10705;0;24.2;8.4;0.0
15;2021-04-10;341;41;0;31260;10746;0;24.4;8.4;0.0
15;2021-04-11;35;2;0;31295;10748;0;24.5;8.4;0.0
15;2021-04-12;611;462;0;31906;11210;0;24.9;8.8;0.0
15;2021-04-13;1087;333;0;32993;11543;0;25.8;9.0;0.0
15;2021-04-14;1012;238;0;34005;11781;0;26.6;9.2;0.0
15;2021-04-15;1124;342;0;35129;12123;0;27.4;9.5;0.0
15;2021-04-16;977;562;0;36106;12685;0;28.2;9.9;0.0
15;2021-04-17;414;23;0;36520;12708;0;28.5;9.9;0.0
15;2021-04-18;11;12;0;36531;12720;0;28.5;9.9;0.0
15;2021-04-19;527;529;0;37058;13249;0;29.0;10.4;0.0
15;2021-04-20;798;617;0;37856;13866;0;29.6;10.8;0.0
15;2021-04-21;608;599;0;38464;14465;0;30.1;11.3;0.0
15;2021-04-22;674;789;0;39138;15254;0;30.6;11.9;0.0
15;2021-04-23;719;649;0;39857;15903;0;31.1;12.4;0.0
15;2021-04-24;376;138;0;40233;16041;0;31.4;12.5;0.0
15;2021-04-25;9;9;0;40242;16050;0;31.4;12.5;0.0
15;2021-04-26;328;601;0;40570;16651;0;31.7;13.0;0.0
15;2021-04-27;489;874;0;41059;17525;0;32.1;13.7;0.0
15;2021-04-28;430;755;0;41489;18280;0;32.4;14.3;0.0
15;2021-04-29;647;999;0;42136;19279;0;32.9;15.1;0.0
15;2021-04-30;556;1029;0;42692;20308;0;33.4;15.9;0.0
15;2021-05-01;324;35;0;43016;20343;0;33.6;15.9;0.0
15;2021-05-02;38;5;0;43054;20348;0;33.6;15.9;0.0
15;2021-05-03;849;320;0;43903;20668;0;34.3;16.1;0.0
15;2021-05-04;789;792;0;44692;21460;0;34.9;16.8;0.0
15;2021-05-05;701;653;0;45393;22113;0;35.5;17.3;0.0
15;2021-05-06;857;913;0;46250;23026;0;36.1;18.0;0.0
15;2021-05-07;1115;841;0;47365;23867;0;37.0;18.6;0.0
15;2021-05-08;506;68;0;47871;23935;0;37.4;18.7;0.0
15;2021-05-09;45;25;0;47916;23960;0;37.4;18.7;0.0
15;2021-05-10;627;844;0;48543;24804;0;37.9;19.4;0.0
15;2021-05-11;1111;1140;0;49654;25944;0;38.8;20.3;0.0
15;2021-05-12;1080;813;0;50734;26757;0;39.6;20.9;0.0
15;2021-05-13;1082;398;0;51816;27155;0;40.5;21.2;0.0
15;2021-05-14;1422;562;0;53238;27717;0;41.6;21.7;0.0
15;2021-05-15;1294;396;0;54532;28113;0;42.6;22.0;0.0
15;2021-05-16;23;15;0;54555;28128;0;42.6;22.0;0.0
15;2021-05-17;1029;578;0;55584;28706;0;43.4;22.4;0.0
15;2021-05-18;1212;884;0;56796;29590;0;44.4;23.1;0.0
15;2021-05-19;1050;455;0;57846;30045;0;45.2;23.5;0.0
15;2021-05-20;1230;757;0;59076;30802;0;46.2;24.1;0.0
15;2021-05-21;1322;702;0;60398;31504;0;47.2;24.6;0.0
15;2021-05-22;508;182;0;60906;31686;0;47.6;24.8;0.0
15;2021-05-23;26;19;0;60932;31705;0;47.6;24.8;0.0
15;2021-05-24;671;241;0;61603;31946;0;48.1;25.0;0.0
15;2021-05-25;1124;602;0;62727;32548;0;49.0;25.4;0.0
15;2021-05-26;1094;478;0;63821;33026;0;49.9;25.8;0.0
15;2021-05-27;1268;690;0;65089;33716;0;50.9;26.3;0.0
15;2021-05-28;1468;893;0;66557;34609;0;52.0;27.0;0.0
15;2021-05-29;930;355;0;67487;34964;0;52.7;27.3;0.0
15;2021-05-30;55;34;0;67542;34998;0;52.8;27.3;0.0
15;2021-05-31;1155;488;0;68697;35486;0;53.7;27.7;0.0
15;2021-06-01;1332;580;0;70029;36066;0;54.7;28.2;0.0
15;2021-06-02;859;433;0;70888;36499;0;55.4;28.5;0.0
15;2021-06-03;903;734;0;71791;37233;0;56.1;29.1;0.0
15;2021-06-04;1047;726;0;72838;37959;0;56.9;29.7;0.0
15;2021-06-05;638;268;0;73476;38227;0;57.4;29.9;0.0
15;2021-06-06;35;32;0;73511;38259;0;57.4;29.9;0.0
15;2021-06-07;749;375;0;74260;38634;0;58.0;30.2;0.0
15;2021-06-08;491;418;0;74751;39052;0;58.4;30.5;0.0
15;2021-06-09;441;412;0;75192;39464;0;58.7;30.8;0.0
15;2021-06-10;309;519;0;75501;39983;0;59.0;31.2;0.0
15;2021-06-11;608;1078;0;76109;41061;0;59.5;32.1;0.0
15;2021-06-12;373;486;0;76482;41547;0;59.8;32.5;0.0
15;2021-06-13;25;25;0;76507;41572;0;59.8;32.5;0.0
15;2021-06-14;517;930;0;77024;42502;0;60.2;33.2;0.0
15;2021-06-15;438;1141;0;77462;43643;0;60.5;34.1;0.0
15;2021-06-16;604;899;0;78066;44542;0;61.0;34.8;0.0
15;2021-06-17;304;972;0;78370;45514;0;61.2;35.6;0.0
15;2021-06-18;733;1181;0;79103;46695;0;61.8;36.5;0.0
15;2021-06-19;502;698;0;79605;47393;0;62.2;37.0;0.0
15;2021-06-20;22;18;0;79627;47411;0;62.2;37.0;0.0
15;2021-06-21;280;982;0;79907;48393;0;62.4;37.8;0.0
15;2021-06-22;237;1384;0;80144;49777;0;62.6;38.9;0.0
15;2021-06-23;354;1400;0;80498;51177;0;62.9;40.0;0.0
15;2021-06-24;294;1105;0;80792;52282;0;63.1;40.8;0.0
15;2021-06-25;367;1566;0;81159;53848;0;63.4;42.1;0.0
15;2021-06-26;163;879;0;81322;54727;0;63.5;42.8;0.0
15;2021-06-27;6;27;0;81328;54754;0;63.5;42.8;0.0
15;2021-06-28;188;1236;0;81516;55990;0;63.7;43.7;0.0
15;2021-06-29;280;1223;0;81796;57213;0;63.9;44.7;0.0
15;2021-06-30;300;1017;0;82096;58230;0;64.1;45.5;0.0
15;2021-07-01;373;1206;0;82469;59436;0;64.4;46.4;0.0
15;2021-07-02;397;1332;0;82866;60768;0;64.7;47.5;0.0
15;2021-07-03;240;690;0;83106;61458;0;64.9;48.0;0.0
15;2021-07-04;4;21;0;83110;61479;0;64.9;48.0;0.0
15;2021-07-05;227;1214;0;83337;62693;0;65.1;49.0;0.0
15;2021-07-06;244;1437;0;83581;64130;0;65.3;50.1;0.0
15;2021-07-07;277;1311;0;83858;65441;0;65.5;51.1;0.0
15;2021-07-08;459;1327;0;84317;66768;0;65.9;52.2;0.0
15;2021-07-09;459;1707;0;84776;68475;0;66.2;53.5;0.0
15;2021-07-10;216;871;1;84992;69346;1;66.4;54.2;0.0
15;2021-07-11;9;27;0;85001;69373;1;66.4;54.2;0.0
15;2021-07-12;246;1422;0;85247;70795;1;66.6;55.3;0.0
15;2021-07-13;565;1658;0;85812;72453;1;67.0;56.6;0.0
15;2021-07-14;47;133;0;85859;72586;1;67.1;56.7;0.0
15;2021-07-15;1043;750;0;86902;73336;1;67.9;57.3;0.0
15;2021-07-16;1060;1227;0;87962;74563;1;68.7;58.3;0.0
15;2021-07-17;752;898;0;88714;75461;1;69.3;59.0;0.0
15;2021-07-18;37;18;0;88751;75479;1;69.3;59.0;0.0
15;2021-07-19;971;1159;0;89722;76638;1;70.1;59.9;0.0
15;2021-07-20;1409;554;0;91131;77192;1;71.2;60.3;0.0
15;2021-07-21;1050;594;0;92181;77786;1;72.0;60.8;0.0
15;2021-07-22;818;528;0;92999;78314;1;72.7;61.2;0.0
15;2021-07-23;1220;1013;0;94219;79327;1;73.6;62.0;0.0
15;2021-07-24;615;732;0;94834;80059;1;74.1;62.5;0.0
15;2021-07-25;25;43;0;94859;80102;1;74.1;62.6;0.0
15;2021-07-26;1064;491;0;95923;80593;1;74.9;63.0;0.0
15;2021-07-27;1424;529;0;97347;81122;1;76.1;63.4;0.0
15;2021-07-28;1089;531;0;98436;81653;1;76.9;63.8;0.0
15;2021-07-29;791;433;0;99227;82086;1;77.5;64.1;0.0
15;2021-07-30;912;1029;0;100139;83115;1;78.2;64.9;0.0
15;2021-07-31;562;596;0;100701;83711;1;78.7;65.4;0.0
15;2021-08-01;42;24;0;100743;83735;1;78.7;65.4;0.0
15;2021-08-02;932;486;0;101675;84221;1;79.4;65.8;0.0
15;2021-08-03;980;358;0;102655;84579;1;80.2;66.1;0.0
15;2021-08-04;770;382;0;103425;84961;1;80.8;66.4;0.0
15;2021-08-05;441;311;0;103866;85272;1;81.1;66.6;0.0
15;2021-08-06;750;1130;0;104616;86402;1;81.7;67.5;0.0
15;2021-08-07;249;1064;0;104865;87466;1;81.9;68.3;0.0
15;2021-08-08;9;19;0;104874;87485;1;81.9;68.4;0.0
15;2021-08-09;462;1002;0;105336;88487;1;82.3;69.1;0.0
15;2021-08-10;382;652;0;105718;89139;1;82.6;69.6;0.0
15;2021-08-11;431;872;0;106149;90011;1;82.9;70.3;0.0
15;2021-08-12;488;1098;0;106637;91109;1;83.3;71.2;0.0
15;2021-08-13;608;1001;0;107245;92110;1;83.8;72.0;0.0
15;2021-08-14;169;538;0;107414;92648;1;83.9;72.4;0.0
15;2021-08-15;32;30;0;107446;92678;1;83.9;72.4;0.0
15;2021-08-16;357;981;0;107803;93659;1;84.2;73.2;0.0
15;2021-08-17;366;1016;0;108169;94675;1;84.5;74.0;0.0
15;2021-08-18;391;747;0;108560;95422;1;84.8;74.6;0.0
15;2021-08-19;276;834;0;108836;96256;1;85.0;75.2;0.0
15;2021-08-20;518;1101;0;109354;97357;1;85.4;76.1;0.0
15;2021-08-21;190;765;0;109544;98122;1;85.6;76.7;0.0
15;2021-08-22;16;39;0;109560;98161;1;85.6;76.7;0.0
15;2021-08-23;214;570;0;109774;98731;1;85.8;77.1;0.0
15;2021-08-24;226;534;0;110000;99265;1;85.9;77.6;0.0
15;2021-08-25;199;511;0;110199;99776;1;86.1;78.0;0.0
15;2021-08-26;139;454;0;110338;100230;1;86.2;78.3;0.0
15;2021-08-27;325;1229;0;110663;101459;1;86.5;79.3;0.0
15;2021-08-28;191;806;0;110854;102265;1;86.6;79.9;0.0
15;2021-08-29;14;22;0;110868;102287;1;86.6;79.9;0.0
15;2021-08-30;202;977;3;111070;103264;4;86.8;80.7;0.0
15;2021-08-31;358;651;18;111428;103915;22;87.1;81.2;0.0
15;2021-09-01;183;420;42;111611;104335;64;87.2;81.5;0.1
15;2021-09-02;103;308;36;111714;104643;100;87.3;81.8;0.1
15;2021-09-03;186;814;117;111900;105457;217;87.4;82.4;0.2
15;2021-09-04;148;332;66;112048;105789;283;87.5;82.7;0.2
15;2021-09-05;4;20;1;112052;105809;284;87.5;82.7;0.2
15;2021-09-06;104;318;170;112156;106127;454;87.6;82.9;0.4
15;2021-09-07;106;204;68;112262;106331;522;87.7;83.1;0.4
15;2021-09-08;200;416;186;112462;106747;708;87.9;83.4;0.6
15;2021-09-09;111;365;84;112573;107112;792;88.0;83.7;0.6
15;2021-09-10;211;671;238;112784;107783;1030;88.1;84.2;0.8
15;2021-09-11;92;275;68;112876;108058;1098;88.2;84.4;0.9
15;2021-09-12;4;9;1;112880;108067;1099;88.2;84.4;0.9
15;2021-09-13;93;252;150;112973;108319;1249;88.3;84.6;1.0
15;2021-09-14;126;124;138;113099;108443;1387;88.4;84.7;1.1
15;2021-09-15;74;243;109;113173;108686;1496;88.4;84.9;1.2
15;2021-09-16;45;136;188;113218;108822;1684;88.5;85.0;1.3
15;2021-09-17;238;548;271;113456;109370;1955;88.6;85.4;1.5
15;2021-09-18;71;333;75;113527;109703;2030;88.7;85.7;1.6
15;2021-09-19;2;7;1;113529;109710;2031;88.7;85.7;1.6
15;2021-09-20;103;205;207;113632;109915;2238;88.8;85.9;1.7
15;2021-09-21;41;110;135;113673;110025;2373;88.8;86.0;1.9
15;2021-09-22;79;312;212;113752;110337;2585;88.9;86.2;2.0
15;2021-09-23;41;109;162;113793;110446;2747;88.9;86.3;2.1
15;2021-09-24;128;311;299;113921;110757;3046;89.0;86.5;2.4
15;2021-09-25;38;208;66;113959;110965;3112;89.0;86.7;2.4
15;2021-09-26;2;5;0;113961;110970;3112;89.0;86.7;2.4
15;2021-09-27;84;134;173;114045;111104;3285;89.1;86.8;2.6
15;2021-09-28;79;130;82;114124;111234;3367;89.2;86.9;2.6
15;2021-09-29;67;206;210;114191;111440;3577;89.2;87.1;2.8
15;2021-09-30;31;92;109;114222;111532;3686;89.2;87.1;2.9
15;2021-10-01;113;205;224;114335;111737;3910;89.3;87.3;3.1
15;2021-10-02;29;138;58;114364;111875;3968;89.4;87.4;3.1
15;2021-10-03;0;2;0;114364;111877;3968;89.4;87.4;3.1
15;2021-10-04;54;61;138;114418;111938;4106;89.4;87.5;3.2
15;2021-10-05;32;64;164;114450;112002;4270;89.4;87.5;3.3
15;2021-10-06;71;117;200;114521;112119;4470;89.5;87.6;3.5
15;2021-10-07;39;87;146;114560;112206;4616;89.5;87.7;3.6
15;2021-10-08;52;148;133;114612;112354;4749;89.5;87.8;3.7
15;2021-10-09;53;101;87;114665;112455;4836;89.6;87.9;3.8
15;2021-10-10;1;6;5;114666;112461;4841;89.6;87.9;3.8
15;2021-10-11;48;148;168;114714;112609;5009;89.6;88.0;3.9
15;2021-10-12;37;56;138;114751;112665;5147;89.7;88.0;4.0
15;2021-10-13;74;160;221;114825;112825;5368;89.7;88.1;4.2
15;2021-10-14;25;26;84;114850;112851;5452;89.7;88.2;4.3
15;2021-10-15;61;109;224;114911;112960;5676;89.8;88.3;4.4
15;2021-10-16;47;97;85;114958;113057;5761;89.8;88.3;4.5
15;2021-10-17;1;2;0;114959;113059;5761;89.8;88.3;4.5
15;2021-10-18;44;110;229;115003;113169;5990;89.9;88.4;4.7
15;2021-10-19;22;62;216;115025;113231;6206;89.9;88.5;4.8
15;2021-10-20;28;76;323;115053;113307;6529;89.9;88.5;5.1
15;2021-10-21;28;40;200;115081;113347;6729;89.9;88.6;5.3
15;2021-10-22;16;68;191;115097;113415;6920;89.9;88.6;5.4
15;2021-10-23;15;70;171;115112;113485;7091;89.9;88.7;5.5
15;2021-10-24;0;0;10;115112;113485;7101;89.9;88.7;5.5
15;2021-10-25;28;54;205;115140;113539;7306;90.0;88.7;5.7
15;2021-10-26;15;35;176;115155;113574;7482;90.0;88.7;5.8
15;2021-10-27;31;81;441;115186;113655;7923;90.0;88.8;6.2
15;2021-10-28;13;9;88;115199;113664;8011;90.0;88.8;6.3
15;2021-10-29;18;57;160;115217;113721;8171;90.0;88.8;6.4
15;2021-10-30;13;49;227;115230;113770;8398;90.0;88.9;6.6
15;2021-10-31;1;1;4;115231;113771;8402;90.0;88.9;6.6
15;2021-11-01;0;1;2;115231;113772;8404;90.0;88.9;6.6
15;2021-11-02;18;56;262;115249;113828;8666;90.0;88.9;6.8
15;2021-11-03;40;86;463;115289;113914;9129;90.1;89.0;7.1
15;2021-11-04;39;40;382;115328;113954;9511;90.1;89.0;7.4
15;2021-11-05;20;30;242;115348;113984;9753;90.1;89.1;7.6
15;2021-11-06;19;42;202;115367;114026;9955;90.1;89.1;7.8
15;2021-11-07;0;0;10;115367;114026;9965;90.1;89.1;7.8
15;2021-11-08;36;95;531;115403;114121;10496;90.2;89.2;8.2
15;2021-11-09;16;32;387;115419;114153;10883;90.2;89.2;8.5
15;2021-11-10;32;43;774;115451;114196;11657;90.2;89.2;9.1
15;2021-11-11;0;6;16;115451;114202;11673;90.2;89.2;9.1
15;2021-11-12;12;29;285;115463;114231;11958;90.2;89.2;9.3
15;2021-11-13;29;36;347;115492;114267;12305;90.2;89.3;9.6
15;2021-11-14;0;3;13;115492;114270;12318;90.2;89.3;9.6
15;2021-11-15;14;20;446;115506;114290;12764;90.2;89.3;10.0
15;2021-11-16;22;23;799;115528;114313;13563;90.3;89.3;10.6
15;2021-11-17;42;44;859;115570;114357;14422;90.3;89.3;11.3
15;2021-11-18;27;35;700;115597;114392;15122;90.3;89.4;11.8
15;2021-11-19;23;29;405;115620;114421;15527;90.3;89.4;12.1
15;2021-11-20;27;22;527;115647;114443;16054;90.4;89.4;12.5
15;2021-11-21;0;1;15;115647;114444;16069;90.4;89.4;12.6
15;2021-11-22;17;21;535;115664;114465;16604;90.4;89.4;13.0
15;2021-11-23;23;25;579;115687;114490;17183;90.4;89.4;13.4
15;2021-11-24;47;43;1034;115734;114533;18217;90.4;89.5;14.2
15;2021-11-25;28;14;531;115762;114547;18748;90.4;89.5;14.6
15;2021-11-26;31;25;826;115793;114572;19574;90.5;89.5;15.3
15;2021-11-27;51;35;1172;115844;114607;20746;90.5;89.5;16.2
15;2021-11-28;3;1;54;115847;114608;20800;90.5;89.5;16.3
15;2021-11-29;24;22;826;115871;114630;21626;90.5;89.6;16.9
15;2021-11-30;24;23;1004;115895;114653;22630;90.5;89.6;17.7
15;2021-12-01;24;46;1908;115919;114699;24538;90.6;89.6;19.2
15;2021-12-02;26;28;1199;115945;114727;25737;90.6;89.6;20.1
15;2021-12-03;30;29;948;115975;114756;26685;90.6;89.7;20.8
15;2021-12-04;18;28;1288;115993;114784;27973;90.6;89.7;21.9
15;2021-12-05;4;0;77;115997;114784;28050;90.6;89.7;21.9
15;2021-12-06;23;36;2140;116020;114820;30190;90.6;89.7;23.6
15;2021-12-07;20;19;1404;116040;114839;31594;90.7;89.7;24.7
15;2021-12-08;27;53;2062;116067;114892;33656;90.7;89.8;26.3
15;2021-12-09;20;20;1218;116087;114912;34874;90.7;89.8;27.2
15;2021-12-10;49;26;1805;116136;114938;36679;90.7;89.8;28.7
15;2021-12-11;25;28;1455;116161;114966;38134;90.8;89.8;29.8
15;2021-12-12;3;3;91;116164;114969;38225;90.8;89.8;29.9
15;2021-12-13;32;17;2314;116196;114986;40539;90.8;89.8;31.7
15;2021-12-14;37;22;2015;116233;115008;42554;90.8;89.9;33.2
15;2021-12-15;36;56;2344;116269;115064;44898;90.8;89.9;35.1
15;2021-12-16;29;39;1735;116298;115103;46633;90.9;89.9;36.4
15;2021-12-17;30;27;1942;116328;115130;48575;90.9;89.9;38.0
15;2021-12-18;30;52;1689;116358;115182;50264;90.9;90.0;39.3
15;2021-12-19;0;1;68;116358;115183;50332;90.9;90.0;39.3
16;2020-12-27;0;0;0;0;0;0;0.0;0.0;0.0
16;2020-12-28;0;0;0;0;0;0;0.0;0.0;0.0
16;2020-12-29;0;0;0;0;0;0;0.0;0.0;0.0
16;2020-12-30;1;0;0;1;0;0;0.0;0.0;0.0
16;2020-12-31;0;0;0;1;0;0;0.0;0.0;0.0
16;2021-01-01;0;0;0;1;0;0;0.0;0.0;0.0
16;2021-01-02;0;0;0;1;0;0;0.0;0.0;0.0
16;2021-01-03;0;0;0;1;0;0;0.0;0.0;0.0
16;2021-01-04;2;0;0;3;0;0;0.0;0.0;0.0
16;2021-01-05;10;0;0;13;0;0;0.0;0.0;0.0
16;2021-01-06;81;0;0;94;0;0;0.0;0.0;0.0
16;2021-01-07;237;0;0;331;0;0;0.1;0.0;0.0
16;2021-01-08;428;2;0;759;2;0;0.2;0.0;0.0
16;2021-01-09;2;0;0;761;2;0;0.2;0.0;0.0
16;2021-01-10;2;0;0;763;2;0;0.2;0.0;0.0
16;2021-01-11;300;0;0;1063;2;0;0.3;0.0;0.0
16;2021-01-12;406;1;0;1469;3;0;0.5;0.0;0.0
16;2021-01-13;460;1;0;1929;4;0;0.6;0.0;0.0
16;2021-01-14;576;7;0;2505;11;0;0.8;0.0;0.0
16;2021-01-15;482;4;0;2987;15;0;1.0;0.0;0.0
16;2021-01-16;1;0;0;2988;15;0;1.0;0.0;0.0
16;2021-01-17;0;0;0;2988;15;0;1.0;0.0;0.0
16;2021-01-18;426;5;0;3414;20;0;1.1;0.0;0.0
16;2021-01-19;793;1;0;4207;21;0;1.4;0.0;0.0
16;2021-01-20;1153;2;0;5360;23;0;1.7;0.0;0.0
16;2021-01-21;1337;13;0;6697;36;0;2.2;0.0;0.0
16;2021-01-22;1132;5;0;7829;41;0;2.5;0.0;0.0
16;2021-01-23;173;1;0;8002;42;0;2.6;0.0;0.0
16;2021-01-24;2;0;0;8004;42;0;2.6;0.0;0.0
16;2021-01-25;586;3;0;8590;45;0;2.8;0.0;0.0
16;2021-01-26;935;2;0;9525;47;0;3.1;0.0;0.0
16;2021-01-27;1276;95;0;10801;142;0;3.5;0.0;0.0
16;2021-01-28;1182;72;0;11983;214;0;3.9;0.1;0.0
16;2021-01-29;742;137;0;12725;351;0;4.1;0.1;0.0
16;2021-01-30;41;1;0;12766;352;0;4.2;0.1;0.0
16;2021-01-31;0;1;0;12766;353;0;4.2;0.1;0.0
16;2021-02-01;382;202;0;13148;555;0;4.3;0.2;0.0
16;2021-02-02;555;174;0;13703;729;0;4.5;0.2;0.0
16;2021-02-03;548;318;0;14251;1047;0;4.6;0.3;0.0
16;2021-02-04;491;265;0;14742;1312;0;4.8;0.4;0.0
16;2021-02-05;458;265;0;15200;1577;0;4.9;0.5;0.0
16;2021-02-06;4;74;0;15204;1651;0;5.0;0.5;0.0
16;2021-02-07;37;3;0;15241;1654;0;5.0;0.5;0.0
16;2021-02-08;361;232;0;15602;1886;0;5.1;0.6;0.0
16;2021-02-09;641;370;0;16243;2256;0;5.3;0.7;0.0
16;2021-02-10;684;704;0;16927;2960;0;5.5;1.0;0.0
16;2021-02-11;795;611;0;17722;3571;0;5.8;1.2;0.0
16;2021-02-12;606;784;0;18328;4355;0;6.0;1.4;0.0
16;2021-02-13;44;65;0;18372;4420;0;6.0;1.4;0.0
16;2021-02-14;0;6;0;18372;4426;0;6.0;1.4;0.0
16;2021-02-15;211;642;0;18583;5068;0;6.1;1.7;0.0
16;2021-02-16;367;933;0;18950;6001;0;6.2;2.0;0.0
16;2021-02-17;323;1179;0;19273;7180;0;6.3;2.3;0.0
16;2021-02-18;480;1147;0;19753;8327;0;6.4;2.7;0.0
16;2021-02-19;377;791;0;20130;9118;0;6.6;3.0;0.0
16;2021-02-20;3;12;0;20133;9130;0;6.6;3.0;0.0
16;2021-02-21;3;0;0;20136;9130;0;6.6;3.0;0.0
16;2021-02-22;149;508;0;20285;9638;0;6.6;3.1;0.0
16;2021-02-23;214;888;0;20499;10526;0;6.7;3.4;0.0
16;2021-02-24;252;792;0;20751;11318;0;6.8;3.7;0.0
16;2021-02-25;403;674;0;21154;11992;0;6.9;3.9;0.0
16;2021-02-26;470;478;0;21624;12470;0;7.0;4.1;0.0
16;2021-02-27;239;4;0;21863;12474;0;7.1;4.1;0.0
16;2021-02-28;5;4;0;21868;12478;0;7.1;4.1;0.0
16;2021-03-01;156;326;0;22024;12804;0;7.2;4.2;0.0
16;2021-03-02;258;633;0;22282;13437;0;7.3;4.4;0.0
16;2021-03-03;392;680;0;22674;14117;0;7.4;4.6;0.0
16;2021-03-04;826;560;0;23500;14677;0;7.7;4.8;0.0
16;2021-03-05;1118;544;0;24618;15221;0;8.0;5.0;0.0
16;2021-03-06;699;8;0;25317;15229;0;8.2;5.0;0.0
16;2021-03-07;110;19;0;25427;15248;0;8.3;5.0;0.0
16;2021-03-08;431;319;0;25858;15567;0;8.4;5.1;0.0
16;2021-03-09;790;693;0;26648;16260;0;8.7;5.3;0.0
16;2021-03-10;615;626;0;27263;16886;0;8.9;5.5;0.0
16;2021-03-11;1425;506;0;28688;17392;0;9.3;5.7;0.0
16;2021-03-12;1174;454;0;29862;17846;0;9.7;5.8;0.0
16;2021-03-13;718;13;0;30580;17859;0;10.0;5.8;0.0
16;2021-03-14;5;0;0;30585;17859;0;10.0;5.8;0.0
16;2021-03-15;483;178;0;31068;18037;0;10.1;5.9;0.0
16;2021-03-16;829;407;0;31897;18444;0;10.4;6.0;0.0
16;2021-03-17;585;251;0;32482;18695;0;10.6;6.1;0.0
16;2021-03-18;987;285;0;33469;18980;0;10.9;6.2;0.0
16;2021-03-19;1080;230;0;34549;19210;0;11.2;6.3;0.0
16;2021-03-20;392;9;0;34941;19219;0;11.4;6.3;0.0
16;2021-03-21;10;0;0;34951;19219;0;11.4;6.3;0.0
16;2021-03-22;761;112;0;35712;19331;0;11.6;6.3;0.0
16;2021-03-23;1417;112;0;37129;19443;0;12.1;6.3;0.0
16;2021-03-24;1143;163;0;38272;19606;0;12.5;6.4;0.0
16;2021-03-25;2032;97;0;40304;19703;0;13.1;6.4;0.0
16;2021-03-26;1926;105;0;42230;19808;0;13.7;6.4;0.0
16;2021-03-27;436;23;0;42666;19831;0;13.9;6.5;0.0
16;2021-03-28;1;0;0;42667;19831;0;13.9;6.5;0.0
16;2021-03-29;931;64;0;43598;19895;0;14.2;6.5;0.0
16;2021-03-30;1867;184;0;45465;20079;0;14.8;6.5;0.0
16;2021-03-31;1506;137;0;46971;20216;0;15.3;6.6;0.0
16;2021-04-01;1927;408;0;48898;20624;0;15.9;6.7;0.0
16;2021-04-02;1431;365;0;50329;20989;0;16.4;6.8;0.0
16;2021-04-03;284;7;0;50613;20996;0;16.5;6.8;0.0
16;2021-04-04;7;0;0;50620;20996;0;16.5;6.8;0.0
16;2021-04-05;38;1;0;50658;20997;0;16.5;6.8;0.0
16;2021-04-06;1973;560;0;52631;21557;0;17.1;7.0;0.0
16;2021-04-07;1871;402;0;54502;21959;0;17.7;7.1;0.0
16;2021-04-08;2713;574;0;57215;22533;0;18.6;7.3;0.0
16;2021-04-09;2627;518;0;59842;23051;0;19.5;7.5;0.0
16;2021-04-10;1234;41;0;61076;23092;0;19.9;7.5;0.0
16;2021-04-11;24;3;0;61100;23095;0;19.9;7.5;0.0
16;2021-04-12;1351;326;0;62451;23421;0;20.3;7.6;0.0
16;2021-04-13;2072;795;0;64523;24216;0;21.0;7.9;0.0
16;2021-04-14;1924;621;0;66447;24837;0;21.6;8.1;0.0
16;2021-04-15;1999;959;0;68446;25796;0;22.3;8.4;0.0
16;2021-04-16;2001;772;0;70447;26568;0;22.9;8.7;0.0
16;2021-04-17;1392;98;0;71839;26666;0;23.4;8.7;0.0
16;2021-04-18;210;8;0;72049;26674;0;23.5;8.7;0.0
16;2021-04-19;1309;536;0;73358;27210;0;23.9;8.9;0.0
16;2021-04-20;1953;1187;0;75311;28397;0;24.5;9.2;0.0
16;2021-04-21;1678;755;0;76989;29152;0;25.1;9.5;0.0
16;2021-04-22;2126;1009;0;79115;30161;0;25.8;9.8;0.0
16;2021-04-23;2234;1134;0;81349;31295;0;26.5;10.2;0.0
16;2021-04-24;779;55;0;82128;31350;0;26.7;10.2;0.0
16;2021-04-25;122;10;0;82250;31360;0;26.8;10.2;0.0
16;2021-04-26;1292;802;0;83542;32162;0;27.2;10.5;0.0
16;2021-04-27;1998;1370;0;85540;33532;0;27.9;10.9;0.0
16;2021-04-28;1561;1124;0;87101;34656;0;28.4;11.3;0.0
16;2021-04-29;2152;1433;0;89253;36089;0;29.1;11.8;0.0
16;2021-04-30;2689;1304;0;91942;37393;0;29.9;12.2;0.0
16;2021-05-01;387;77;0;92329;37470;0;30.1;12.2;0.0
16;2021-05-02;155;17;0;92484;37487;0;30.1;12.2;0.0
16;2021-05-03;2462;563;0;94946;38050;0;30.9;12.4;0.0
16;2021-05-04;1954;2007;0;96900;40057;0;31.6;13.0;0.0
16;2021-05-05;1641;1750;0;98541;41807;0;32.1;13.6;0.0
16;2021-05-06;1758;2181;0;100299;43988;0;32.7;14.3;0.0
16;2021-05-07;2827;2046;0;103126;46034;0;33.6;15.0;0.0
16;2021-05-08;1070;438;0;104196;46472;0;33.9;15.1;0.0
16;2021-05-09;475;27;0;104671;46499;0;34.1;15.1;0.0
16;2021-05-10;1782;1533;0;106453;48032;0;34.7;15.6;0.0
16;2021-05-11;2273;1905;0;108726;49937;0;35.4;16.3;0.0
16;2021-05-12;1704;1725;0;110430;51662;0;36.0;16.8;0.0
16;2021-05-13;1380;349;0;111810;52011;0;36.4;16.9;0.0
16;2021-05-14;1872;1477;0;113682;53488;0;37.0;17.4;0.0
16;2021-05-15;590;813;0;114272;54301;0;37.2;17.7;0.0
16;2021-05-16;198;32;0;114470;54333;0;37.3;17.7;0.0
16;2021-05-17;1568;1155;0;116038;55488;0;37.8;18.1;0.0
16;2021-05-18;2650;1342;0;118688;56830;0;38.6;18.5;0.0
16;2021-05-19;1969;1167;0;120657;57997;0;39.3;18.9;0.0
16;2021-05-20;2788;1350;0;123445;59347;0;40.2;19.3;0.0
16;2021-05-21;2860;1377;0;126305;60724;0;41.1;19.8;0.0
16;2021-05-22;488;635;0;126793;61359;0;41.3;20.0;0.0
16;2021-05-23;278;15;0;127071;61374;0;41.4;20.0;0.0
16;2021-05-24;1342;223;0;128413;61597;0;41.8;20.1;0.0
16;2021-05-25;2737;1399;0;131150;62996;0;42.7;20.5;0.0
16;2021-05-26;1844;1140;0;132994;64136;0;43.3;20.9;0.0
16;2021-05-27;2469;1560;0;135463;65696;0;44.1;21.4;0.0
16;2021-05-28;2830;1506;0;138293;67202;0;45.0;21.9;0.0
16;2021-05-29;828;867;0;139121;68069;0;45.3;22.2;0.0
16;2021-05-30;98;10;0;139219;68079;0;45.3;22.2;0.0
16;2021-05-31;1964;1096;0;141183;69175;0;46.0;22.5;0.0
16;2021-06-01;2323;1663;0;143506;70838;0;46.7;23.1;0.0
16;2021-06-02;1900;1448;0;145406;72286;0;47.3;23.5;0.0
16;2021-06-03;2680;1763;0;148086;74049;0;48.2;24.1;0.0
16;2021-06-04;2791;1998;0;150877;76047;0;49.1;24.8;0.0
16;2021-06-05;1041;568;0;151918;76615;0;49.5;24.9;0.0
16;2021-06-06;203;34;0;152121;76649;0;49.5;25.0;0.0
16;2021-06-07;1944;1256;0;154065;77905;0;50.2;25.4;0.0
16;2021-06-08;2378;1934;0;156443;79839;0;50.9;26.0;0.0
16;2021-06-09;2498;1573;0;158941;81412;0;51.8;26.5;0.0
16;2021-06-10;2536;1930;0;161477;83342;0;52.6;27.1;0.0
16;2021-06-11;2158;2585;0;163635;85927;0;53.3;28.0;0.0
16;2021-06-12;1545;539;0;165180;86466;0;53.8;28.2;0.0
16;2021-06-13;288;85;0;165468;86551;0;53.9;28.2;0.0
16;2021-06-14;850;2645;0;166318;89196;0;54.2;29.0;0.0
16;2021-06-15;1844;2507;0;168162;91703;0;54.8;29.9;0.0
16;2021-06-16;1613;1961;0;169775;93664;0;55.3;30.5;0.0
16;2021-06-17;2016;2342;0;171791;96006;0;55.9;31.3;0.0
16;2021-06-18;2005;3023;0;173796;99029;0;56.6;32.2;0.0
16;2021-06-19;1278;1227;0;175074;100256;0;57.0;32.6;0.0
16;2021-06-20;252;65;0;175326;100321;0;57.1;32.7;0.0
16;2021-06-21;1368;2083;0;176694;102404;0;57.5;33.3;0.0
16;2021-06-22;1659;2863;0;178353;105267;0;58.1;34.3;0.0
16;2021-06-23;1503;2021;0;179856;107288;0;58.6;34.9;0.0
16;2021-06-24;1914;2140;0;181770;109428;0;59.2;35.6;0.0
16;2021-06-25;1893;2599;0;183663;112027;0;59.8;36.5;0.0
16;2021-06-26;1007;762;0;184670;112789;0;60.1;36.7;0.0
16;2021-06-27;146;101;0;184816;112890;0;60.2;36.8;0.0
16;2021-06-28;1111;1962;0;185927;114852;0;60.5;37.4;0.0
16;2021-06-29;1193;3348;0;187120;118200;0;60.9;38.5;0.0
16;2021-06-30;1299;2669;0;188419;120869;0;61.3;39.4;0.0
16;2021-07-01;1804;3082;0;190223;123951;0;61.9;40.4;0.0
16;2021-07-02;1374;3529;0;191597;127480;0;62.4;41.5;0.0
16;2021-07-03;647;1128;0;192244;128608;0;62.6;41.9;0.0
16;2021-07-04;28;96;0;192272;128704;0;62.6;41.9;0.0
16;2021-07-05;805;2329;0;193077;131033;0;62.9;42.7;0.0
16;2021-07-06;1239;3325;0;194316;134358;0;63.3;43.7;0.0
16;2021-07-07;859;2337;0;195175;136695;0;63.5;44.5;0.0
16;2021-07-08;1194;2734;0;196369;139429;0;63.9;45.4;0.0
16;2021-07-09;1136;3601;0;197505;143030;0;64.3;46.6;0.0
16;2021-07-10;347;1345;0;197852;144375;0;64.4;47.0;0.0
16;2021-07-11;32;86;0;197884;144461;0;64.4;47.0;0.0
16;2021-07-12;658;2473;0;198542;146934;0;64.6;47.8;0.0
16;2021-07-13;1359;3486;0;199901;150420;0;65.1;49.0;0.0
16;2021-07-14;813;902;0;200714;151322;0;65.4;49.3;0.0
16;2021-07-15;1294;3366;0;202008;154688;0;65.8;50.4;0.0
16;2021-07-16;1558;3367;0;203566;158055;0;66.3;51.5;0.0
16;2021-07-17;613;1234;0;204179;159289;0;66.5;51.9;0.0
16;2021-07-18;60;73;0;204239;159362;0;66.5;51.9;0.0
16;2021-07-19;720;2817;0;204959;162179;0;66.7;52.8;0.0
16;2021-07-20;1255;3216;0;206214;165395;0;67.1;53.9;0.0
16;2021-07-21;1272;2638;0;207486;168033;0;67.6;54.7;0.0
16;2021-07-22;1962;2853;0;209448;170886;0;68.2;55.6;0.0
16;2021-07-23;1636;3466;0;211084;174352;0;68.7;56.8;0.0
16;2021-07-24;734;1214;0;211818;175566;0;69.0;57.2;0.0
16;2021-07-25;103;71;0;211921;175637;0;69.0;57.2;0.0
16;2021-07-26;1612;2132;0;213533;177769;0;69.5;57.9;0.0
16;2021-07-27;2066;2788;0;215599;180557;0;70.2;58.8;0.0
16;2021-07-28;2029;2286;0;217628;182843;0;70.9;59.5;0.0
16;2021-07-29;2447;2418;0;220075;185261;0;71.7;60.3;0.0
16;2021-07-30;2602;3001;0;222677;188262;0;72.5;61.3;0.0
16;2021-07-31;1052;1321;0;223729;189583;0;72.8;61.7;0.0
16;2021-08-01;273;46;0;224002;189629;0;72.9;61.7;0.0
16;2021-08-02;2197;1789;0;226199;191418;0;73.6;62.3;0.0
16;2021-08-03;2293;2274;0;228492;193692;0;74.4;63.1;0.0
16;2021-08-04;2281;1791;0;230773;195483;0;75.1;63.6;0.0
16;2021-08-05;2888;1586;0;233661;197069;0;76.1;64.2;0.0
16;2021-08-06;2615;2307;0;236276;199376;0;76.9;64.9;0.0
16;2021-08-07;885;628;0;237161;200004;0;77.2;65.1;0.0
16;2021-08-08;99;75;0;237260;200079;0;77.3;65.1;0.0
16;2021-08-09;2177;1126;0;239437;201205;0;78.0;65.5;0.0
16;2021-08-10;2857;1551;0;242294;202756;0;78.9;66.0;0.0
16;2021-08-11;2540;1207;0;244834;203963;0;79.7;66.4;0.0
16;2021-08-12;2034;1706;0;246868;205669;0;80.4;67.0;0.0
16;2021-08-13;2488;1423;0;249356;207092;0;81.2;67.4;0.0
16;2021-08-14;767;481;0;250123;207573;0;81.4;67.6;0.0
16;2021-08-15;62;44;0;250185;207617;0;81.5;67.6;0.0
16;2021-08-16;1293;1613;0;251478;209230;0;81.9;68.1;0.0
16;2021-08-17;1637;1686;0;253115;210916;0;82.4;68.7;0.0
16;2021-08-18;1513;1527;0;254628;212443;0;82.9;69.2;0.0
16;2021-08-19;1422;1867;0;256050;214310;0;83.4;69.8;0.0
16;2021-08-20;1451;1973;0;257501;216283;0;83.8;70.4;0.0
16;2021-08-21;523;842;0;258024;217125;0;84.0;70.7;0.0
16;2021-08-22;15;67;0;258039;217192;0;84.0;70.7;0.0
16;2021-08-23;912;2113;0;258951;219305;0;84.3;71.4;0.0
16;2021-08-24;998;2445;0;259949;221750;0;84.6;72.2;0.0
16;2021-08-25;810;1884;0;260759;223634;0;84.9;72.8;0.0
16;2021-08-26;828;2596;0;261587;226230;0;85.2;73.7;0.0
16;2021-08-27;813;2530;0;262400;228760;0;85.4;74.5;0.0
16;2021-08-28;277;846;0;262677;229606;0;85.5;74.8;0.0
16;2021-08-29;15;67;0;262692;229673;0;85.5;74.8;0.0
16;2021-08-30;610;2369;22;263302;232042;22;85.7;75.6;0.0
16;2021-08-31;669;2657;79;263971;234699;101;85.9;76.4;0.0
16;2021-09-01;480;2338;182;264451;237037;283;86.1;77.2;0.1
16;2021-09-02;538;2108;290;264989;239145;573;86.3;77.9;0.2
16;2021-09-03;531;2509;273;265520;241654;846;86.5;78.7;0.3
16;2021-09-04;328;935;56;265848;242589;902;86.6;79.0;0.3
16;2021-09-05;14;55;3;265862;242644;905;86.6;79.0;0.3
16;2021-09-06;287;1400;291;266149;244044;1196;86.7;79.5;0.4
16;2021-09-07;355;1615;319;266504;245659;1515;86.8;80.0;0.5
16;2021-09-08;359;1890;216;266863;247549;1731;86.9;80.6;0.6
16;2021-09-09;335;1478;217;267198;249027;1948;87.0;81.1;0.6
16;2021-09-10;416;1688;317;267614;250715;2265;87.1;81.6;0.7
16;2021-09-11;197;764;69;267811;251479;2334;87.2;81.9;0.8
16;2021-09-12;17;28;1;267828;251507;2335;87.2;81.9;0.8
16;2021-09-13;241;972;348;268069;252479;2683;87.3;82.2;0.9
16;2021-09-14;365;925;650;268434;253404;3333;87.4;82.5;1.1
16;2021-09-15;354;1299;418;268788;254703;3751;87.5;82.9;1.2
16;2021-09-16;319;830;759;269107;255533;4510;87.6;83.2;1.5
16;2021-09-17;471;1254;400;269578;256787;4910;87.8;83.6;1.6
16;2021-09-18;107;511;46;269685;257298;4956;87.8;83.8;1.6
16;2021-09-19;3;17;5;269688;257315;4961;87.8;83.8;1.6
16;2021-09-20;175;635;583;269863;257950;5544;87.9;84.0;1.8
16;2021-09-21;183;662;633;270046;258612;6177;87.9;84.2;2.0
16;2021-09-22;187;921;361;270233;259533;6538;88.0;84.5;2.1
16;2021-09-23;159;518;458;270392;260051;6996;88.0;84.7;2.3
16;2021-09-24;300;973;466;270692;261024;7462;88.1;85.0;2.4
16;2021-09-25;74;424;42;270766;261448;7504;88.2;85.1;2.4
16;2021-09-26;3;10;26;270769;261458;7530;88.2;85.1;2.5
16;2021-09-27;184;541;559;270953;261999;8089;88.2;85.3;2.6
16;2021-09-28;128;509;538;271081;262508;8627;88.3;85.5;2.8
16;2021-09-29;179;552;584;271260;263060;9211;88.3;85.7;3.0
16;2021-09-30;111;455;498;271371;263515;9709;88.4;85.8;3.2
16;2021-10-01;244;481;457;271615;263996;10166;88.4;86.0;3.3
16;2021-10-02;83;308;74;271698;264304;10240;88.5;86.1;3.3
16;2021-10-03;1;12;9;271699;264316;10249;88.5;86.1;3.3
16;2021-10-04;123;323;398;271822;264639;10647;88.5;86.2;3.5
16;2021-10-05;129;357;449;271951;264996;11096;88.5;86.3;3.6
16;2021-10-06;176;482;428;272127;265478;11524;88.6;86.4;3.8
16;2021-10-07;126;311;326;272253;265789;11850;88.6;86.5;3.9
16;2021-10-08;227;624;640;272480;266413;12490;88.7;86.7;4.1
16;2021-10-09;75;167;74;272555;266580;12564;88.7;86.8;4.1
16;2021-10-10;2;13;13;272557;266593;12577;88.7;86.8;4.1
16;2021-10-11;108;246;556;272665;266839;13133;88.8;86.9;4.3
16;2021-10-12;103;229;404;272768;267068;13537;88.8;87.0;4.4
16;2021-10-13;190;323;458;272958;267391;13995;88.9;87.1;4.6
16;2021-10-14;94;182;347;273052;267573;14342;88.9;87.1;4.7
16;2021-10-15;192;397;600;273244;267970;14942;89.0;87.3;4.9
16;2021-10-16;84;107;125;273328;268077;15067;89.0;87.3;4.9
16;2021-10-17;6;6;7;273334;268083;15074;89.0;87.3;4.9
16;2021-10-18;127;268;542;273461;268351;15616;89.0;87.4;5.1
16;2021-10-19;105;145;578;273566;268496;16194;89.1;87.4;5.3
16;2021-10-20;121;213;522;273687;268709;16716;89.1;87.5;5.4
16;2021-10-21;66;138;419;273753;268847;17135;89.1;87.5;5.6
16;2021-10-22;232;323;641;273985;269170;17776;89.2;87.6;5.8
16;2021-10-23;76;106;79;274061;269276;17855;89.2;87.7;5.8
16;2021-10-24;1;4;5;274062;269280;17860;89.2;87.7;5.8
16;2021-10-25;123;170;682;274185;269450;18542;89.3;87.7;6.0
16;2021-10-26;58;123;506;274243;269573;19048;89.3;87.8;6.2
16;2021-10-27;107;159;462;274350;269732;19510;89.3;87.8;6.4
16;2021-10-28;102;124;473;274452;269856;19983;89.4;87.9;6.5
16;2021-10-29;173;221;940;274625;270077;20923;89.4;87.9;6.8
16;2021-10-30;51;86;170;274676;270163;21093;89.4;88.0;6.9
16;2021-10-31;2;5;12;274678;270168;21105;89.4;88.0;6.9
16;2021-11-01;3;3;20;274681;270171;21125;89.4;88.0;6.9
16;2021-11-02;105;148;852;274786;270319;21977;89.5;88.0;7.2
16;2021-11-03;96;142;482;274882;270461;22459;89.5;88.1;7.3
16;2021-11-04;87;114;570;274969;270575;23029;89.5;88.1;7.5
16;2021-11-05;148;197;941;275117;270772;23970;89.6;88.2;7.8
16;2021-11-06;61;80;262;275178;270852;24232;89.6;88.2;7.9
16;2021-11-07;2;10;17;275180;270862;24249;89.6;88.2;7.9
16;2021-11-08;50;118;896;275230;270980;25145;89.6;88.2;8.2
16;2021-11-09;75;112;1008;275305;271092;26153;89.6;88.3;8.5
16;2021-11-10;94;133;971;275399;271225;27124;89.7;88.3;8.8
16;2021-11-11;4;6;27;275403;271231;27151;89.7;88.3;8.8
16;2021-11-12;83;151;1022;275486;271382;28173;89.7;88.4;9.2
16;2021-11-13;38;75;244;275524;271457;28417;89.7;88.4;9.3
16;2021-11-14;0;2;10;275524;271459;28427;89.7;88.4;9.3
16;2021-11-15;48;115;1100;275572;271574;29527;89.7;88.4;9.6
16;2021-11-16;73;102;1051;275645;271676;30578;89.7;88.5;10.0
16;2021-11-17;114;152;1068;275759;271828;31646;89.8;88.5;10.3
16;2021-11-18;79;130;1078;275838;271958;32724;89.8;88.5;10.7
16;2021-11-19;153;226;1467;275991;272184;34191;89.9;88.6;11.1
16;2021-11-20;59;88;483;276050;272272;34674;89.9;88.7;11.3
16;2021-11-21;2;2;34;276052;272274;34708;89.9;88.7;11.3
16;2021-11-22;71;64;1246;276123;272338;35954;89.9;88.7;11.7
16;2021-11-23;100;90;1467;276223;272428;37421;89.9;88.7;12.2
16;2021-11-24;123;121;1434;276346;272549;38855;90.0;88.7;12.7
16;2021-11-25;115;92;1605;276461;272641;40460;90.0;88.8;13.2
16;2021-11-26;143;151;2113;276604;272792;42573;90.1;88.8;13.9
16;2021-11-27;95;121;1715;276699;272913;44288;90.1;88.9;14.4
16;2021-11-28;35;18;1065;276734;272931;45353;90.1;88.9;14.8
16;2021-11-29;76;81;1845;276810;273012;47198;90.1;88.9;15.4
16;2021-11-30;106;97;2555;276916;273109;49753;90.2;88.9;16.2
16;2021-12-01;111;112;2501;277027;273221;52254;90.2;89.0;17.0
16;2021-12-02;102;72;3203;277129;273293;55457;90.2;89.0;18.1
16;2021-12-03;98;119;3180;277227;273412;58637;90.3;89.0;19.1
16;2021-12-04;76;68;1477;277303;273480;60114;90.3;89.0;19.6
16;2021-12-05;6;4;364;277309;273484;60478;90.3;89.0;19.7
16;2021-12-06;61;79;2604;277370;273563;63082;90.3;89.1;20.5
16;2021-12-07;58;80;3207;277428;273643;66289;90.3;89.1;21.6
16;2021-12-08;123;113;3067;277551;273756;69356;90.4;89.1;22.6
16;2021-12-09;103;105;4193;277654;273861;73549;90.4;89.2;23.9
16;2021-12-10;99;145;4324;277753;274006;77873;90.4;89.2;25.4
16;2021-12-11;84;62;2476;277837;274068;80349;90.5;89.2;26.2
16;2021-12-12;34;15;1368;277871;274083;81717;90.5;89.2;26.6
16;2021-12-13;82;97;3439;277953;274180;85156;90.5;89.3;27.7
16;2021-12-14;105;127;4309;278058;274307;89465;90.5;89.3;29.1
16;2021-12-15;113;144;3619;278171;274451;93084;90.6;89.4;30.3
16;2021-12-16;107;108;4539;278278;274559;97623;90.6;89.4;31.8
16;2021-12-17;118;220;4743;278396;274779;102366;90.6;89.5;33.3
16;2021-12-18;104;79;2618;278500;274858;104984;90.7;89.5;34.2
16;2021-12-19;30;18;1042;278530;274876;106026;90.7;89.5;34.5
17;2020-12-27;2;0;0;2;0;0;0.0;0.0;0.0
17;2020-12-28;1;0;0;3;0;0;0.0;0.0;0.0
17;2020-12-29;0;0;0;3;0;0;0.0;0.0;0.0
17;2020-12-30;0;0;0;3;0;0;0.0;0.0;0.0
17;2020-12-31;0;0;0;3;0;0;0.0;0.0;0.0
17;2021-01-01;2;0;0;5;0;0;0.0;0.0;0.0
17;2021-01-02;0;0;0;5;0;0;0.0;0.0;0.0
17;2021-01-03;0;0;0;5;0;0;0.0;0.0;0.0
17;2021-01-04;52;0;0;57;0;0;0.0;0.0;0.0
17;2021-01-05;87;0;0;144;0;0;0.0;0.0;0.0
17;2021-01-06;124;0;0;268;0;0;0.0;0.0;0.0
17;2021-01-07;470;1;0;738;1;0;0.1;0.0;0.0
17;2021-01-08;428;1;0;1166;2;0;0.2;0.0;0.0
17;2021-01-09;8;0;0;1174;2;0;0.2;0.0;0.0
17;2021-01-10;4;0;0;1178;2;0;0.2;0.0;0.0
17;2021-01-11;388;2;0;1566;4;0;0.3;0.0;0.0
17;2021-01-12;705;1;0;2271;5;0;0.4;0.0;0.0
17;2021-01-13;660;2;0;2931;7;0;0.5;0.0;0.0
17;2021-01-14;641;11;0;3572;18;0;0.6;0.0;0.0
17;2021-01-15;718;2;0;4290;20;0;0.7;0.0;0.0
17;2021-01-16;129;2;0;4419;22;0;0.8;0.0;0.0
17;2021-01-17;19;0;0;4438;22;0;0.8;0.0;0.0
17;2021-01-18;847;5;0;5285;27;0;0.9;0.0;0.0
17;2021-01-19;1870;18;0;7155;45;0;1.2;0.0;0.0
17;2021-01-20;2265;4;0;9420;49;0;1.6;0.0;0.0
17;2021-01-21;2409;12;0;11829;61;0;2.1;0.0;0.0
17;2021-01-22;1829;15;0;13658;76;0;2.4;0.0;0.0
17;2021-01-23;709;2;0;14367;78;0;2.5;0.0;0.0
17;2021-01-24;45;0;0;14412;78;0;2.5;0.0;0.0
17;2021-01-25;1374;6;0;15786;84;0;2.7;0.0;0.0
17;2021-01-26;2043;5;0;17829;89;0;3.1;0.0;0.0
17;2021-01-27;1683;38;0;19512;127;0;3.4;0.0;0.0
17;2021-01-28;2437;231;0;21949;358;0;3.8;0.1;0.0
17;2021-01-29;1715;223;0;23664;581;0;4.1;0.1;0.0
17;2021-01-30;517;5;0;24181;586;0;4.2;0.1;0.0
17;2021-01-31;34;5;0;24215;591;0;4.2;0.1;0.0
17;2021-02-01;735;211;0;24950;802;0;4.3;0.1;0.0
17;2021-02-02;1167;343;0;26117;1145;0;4.5;0.2;0.0
17;2021-02-03;1249;412;0;27366;1557;0;4.8;0.3;0.0
17;2021-02-04;1118;502;0;28484;2059;0;5.0;0.4;0.0
17;2021-02-05;615;766;0;29099;2825;0;5.1;0.5;0.0
17;2021-02-06;25;45;0;29124;2870;0;5.1;0.5;0.0
17;2021-02-07;35;3;0;29159;2873;0;5.1;0.5;0.0
17;2021-02-08;690;428;0;29849;3301;0;5.2;0.6;0.0
17;2021-02-09;1104;1261;0;30953;4562;0;5.4;0.8;0.0
17;2021-02-10;839;1242;0;31792;5804;0;5.5;1.0;0.0
17;2021-02-11;1235;1279;0;33027;7083;0;5.8;1.2;0.0
17;2021-02-12;778;985;0;33805;8068;0;5.9;1.4;0.0
17;2021-02-13;49;137;0;33854;8205;0;5.9;1.4;0.0
17;2021-02-14;2;10;0;33856;8215;0;5.9;1.4;0.0
17;2021-02-15;612;1177;0;34468;9392;0;6.0;1.6;0.0
17;2021-02-16;758;1797;0;35226;11189;0;6.1;1.9;0.0
17;2021-02-17;774;1371;0;36000;12560;0;6.3;2.2;0.0
17;2021-02-18;947;2163;0;36947;14723;0;6.4;2.6;0.0
17;2021-02-19;1050;1533;0;37997;16256;0;6.6;2.8;0.0
17;2021-02-20;103;333;0;38100;16589;0;6.6;2.9;0.0
17;2021-02-21;8;0;0;38108;16589;0;6.6;2.9;0.0
17;2021-02-22;641;1592;0;38749;18181;0;6.8;3.2;0.0
17;2021-02-23;729;1511;0;39478;19692;0;6.9;3.4;0.0
17;2021-02-24;1066;1559;0;40544;21251;0;7.1;3.7;0.0
17;2021-02-25;1097;1660;0;41641;22911;0;7.3;4.0;0.0
17;2021-02-26;1320;1279;0;42961;24190;0;7.5;4.2;0.0
17;2021-02-27;517;234;0;43478;24424;0;7.6;4.3;0.0
17;2021-02-28;24;9;0;43502;24433;0;7.6;4.3;0.0
17;2021-03-01;629;1040;0;44131;25473;0;7.7;4.4;0.0
17;2021-03-02;1087;870;0;45218;26343;0;7.9;4.6;0.0
17;2021-03-03;1593;778;0;46811;27121;0;8.2;4.7;0.0
17;2021-03-04;2403;1130;0;49214;28251;0;8.6;4.9;0.0
17;2021-03-05;2606;683;0;51820;28934;0;9.0;5.0;0.0
17;2021-03-06;1058;38;0;52878;28972;0;9.2;5.0;0.0
17;2021-03-07;182;48;0;53060;29020;0;9.2;5.1;0.0
17;2021-03-08;1016;835;0;54076;29855;0;9.4;5.2;0.0
17;2021-03-09;1715;630;0;55791;30485;0;9.7;5.3;0.0
17;2021-03-10;2065;659;0;57856;31144;0;10.1;5.4;0.0
17;2021-03-11;3200;982;0;61056;32126;0;10.6;5.6;0.0
17;2021-03-12;3300;632;0;64356;32758;0;11.2;5.7;0.0
17;2021-03-13;1211;19;0;65567;32777;0;11.4;5.7;0.0
17;2021-03-14;51;1;0;65618;32778;0;11.4;5.7;0.0
17;2021-03-15;1245;979;0;66863;33757;0;11.6;5.9;0.0
17;2021-03-16;906;538;0;67769;34295;0;11.8;6.0;0.0
17;2021-03-17;1483;715;0;69252;35010;0;12.1;6.1;0.0
17;2021-03-18;1691;751;0;70943;35761;0;12.4;6.2;0.0
17;2021-03-19;2080;536;0;73023;36297;0;12.7;6.3;0.0
17;2021-03-20;1095;54;0;74118;36351;0;12.9;6.3;0.0
17;2021-03-21;38;40;0;74156;36391;0;12.9;6.3;0.0
17;2021-03-22;1553;679;0;75709;37070;0;13.2;6.5;0.0
17;2021-03-23;2451;573;0;78160;37643;0;13.6;6.6;0.0
17;2021-03-24;3465;831;0;81625;38474;0;14.2;6.7;0.0
17;2021-03-25;4630;641;0;86255;39115;0;15.0;6.8;0.0
17;2021-03-26;4841;472;0;91096;39587;0;15.9;6.9;0.0
17;2021-03-27;1719;68;0;92815;39655;0;16.2;6.9;0.0
17;2021-03-28;366;42;0;93181;39697;0;16.2;6.9;0.0
17;2021-03-29;2340;559;0;95521;40256;0;16.6;7.0;0.0
17;2021-03-30;2615;976;0;98136;41232;0;17.1;7.2;0.0
17;2021-03-31;3764;892;0;101900;42124;0;17.8;7.3;0.0
17;2021-04-01;3976;1169;0;105876;43293;0;18.4;7.5;0.0
17;2021-04-02;3610;844;0;109486;44137;0;19.1;7.7;0.0
17;2021-04-03;1153;185;0;110639;44322;0;19.3;7.7;0.0
17;2021-04-04;464;12;0;111103;44334;0;19.4;7.7;0.0
17;2021-04-05;435;120;0;111538;44454;0;19.4;7.7;0.0
17;2021-04-06;3365;1028;0;114903;45482;0;20.0;7.9;0.0
17;2021-04-07;4033;1155;0;118936;46637;0;20.7;8.1;0.0
17;2021-04-08;4530;1468;0;123466;48105;0;21.5;8.4;0.0
17;2021-04-09;6318;840;0;129784;48945;0;22.6;8.5;0.0
17;2021-04-10;2557;86;0;132341;49031;0;23.1;8.5;0.0
17;2021-04-11;749;23;0;133090;49054;0;23.2;8.5;0.0
17;2021-04-12;2876;1615;0;135966;50669;0;23.7;8.8;0.0
17;2021-04-13;4091;1270;0;140057;51939;0;24.4;9.0;0.0
17;2021-04-14;4282;1193;0;144339;53132;0;25.1;9.3;0.0
17;2021-04-15;4541;1164;0;148880;54296;0;25.9;9.5;0.0
17;2021-04-16;4183;1166;0;153063;55462;0;26.7;9.7;0.0
17;2021-04-17;1711;377;0;154774;55839;0;27.0;9.7;0.0
17;2021-04-18;440;79;0;155214;55918;0;27.0;9.7;0.0
17;2021-04-19;2323;2007;0;157537;57925;0;27.4;10.1;0.0
17;2021-04-20;2864;2485;0;160401;60410;0;27.9;10.5;0.0
17;2021-04-21;2963;1878;0;163364;62288;0;28.5;10.9;0.0
17;2021-04-22;3173;2307;0;166537;64595;0;29.0;11.3;0.0
17;2021-04-23;2450;2676;0;168987;67271;0;29.4;11.7;0.0
17;2021-04-24;1667;939;0;170654;68210;0;29.7;11.9;0.0
17;2021-04-25;621;227;0;171275;68437;0;29.8;11.9;0.0
17;2021-04-26;2548;2529;0;173823;70966;0;30.3;12.4;0.0
17;2021-04-27;3112;2604;0;176935;73570;0;30.8;12.8;0.0
17;2021-04-28;3131;2879;0;180066;76449;0;31.4;13.3;0.0
17;2021-04-29;4151;2781;0;184217;79230;0;32.1;13.8;0.0
17;2021-04-30;4415;2566;0;188632;81796;0;32.9;14.2;0.0
17;2021-05-01;898;525;0;189530;82321;0;33.0;14.3;0.0
17;2021-05-02;561;760;0;190091;83081;0;33.1;14.5;0.0
17;2021-05-03;2622;2892;0;192713;85973;0;33.6;15.0;0.0
17;2021-05-04;2399;3657;0;195112;89630;0;34.0;15.6;0.0
17;2021-05-05;2951;3693;0;198063;93323;0;34.5;16.3;0.0
17;2021-05-06;4136;3367;0;202199;96690;0;35.2;16.8;0.0
17;2021-05-07;4405;3651;0;206604;100341;0;36.0;17.5;0.0
17;2021-05-08;1376;775;0;207980;101116;0;36.2;17.6;0.0
17;2021-05-09;1280;676;0;209260;101792;0;36.5;17.7;0.0
17;2021-05-10;2759;3638;0;212019;105430;0;36.9;18.4;0.0
17;2021-05-11;3510;3935;0;215529;109365;0;37.5;19.1;0.0
17;2021-05-12;3598;3704;0;219127;113069;0;38.2;19.7;0.0
17;2021-05-13;2665;694;0;221792;113763;0;38.6;19.8;0.0
17;2021-05-14;3119;2385;0;224911;116148;0;39.2;20.2;0.0
17;2021-05-15;2173;707;0;227084;116855;0;39.6;20.4;0.0
17;2021-05-16;1601;305;0;228685;117160;0;39.8;20.4;0.0
17;2021-05-17;4183;1986;0;232868;119146;0;40.6;20.8;0.0
17;2021-05-18;4721;1641;0;237589;120787;0;41.4;21.0;0.0
17;2021-05-19;5043;1300;0;242632;122087;0;42.3;21.3;0.0
17;2021-05-20;4815;1903;0;247447;123990;0;43.1;21.6;0.0
17;2021-05-21;4775;1904;0;252222;125894;0;43.9;21.9;0.0
17;2021-05-22;2102;546;0;254324;126440;0;44.3;22.0;0.0
17;2021-05-23;1555;110;0;255879;126550;0;44.6;22.0;0.0
17;2021-05-24;1267;211;0;257146;126761;0;44.8;22.1;0.0
17;2021-05-25;3795;1753;0;260941;128514;0;45.5;22.4;0.0
17;2021-05-26;4182;1986;0;265123;130500;0;46.2;22.7;0.0
17;2021-05-27;4934;2115;0;270057;132615;0;47.0;23.1;0.0
17;2021-05-28;4227;3283;0;274284;135898;0;47.8;23.7;0.0
17;2021-05-29;1501;1676;0;275785;137574;0;48.0;24.0;0.0
17;2021-05-30;650;369;0;276435;137943;0;48.2;24.0;0.0
17;2021-05-31;2896;2931;0;279331;140874;0;48.7;24.5;0.0
17;2021-06-01;4298;2878;0;283629;143752;0;49.4;25.0;0.0
17;2021-06-02;4301;3137;0;287930;146889;0;50.2;25.6;0.0
17;2021-06-03;5079;3106;0;293009;149995;0;51.0;26.1;0.0
17;2021-06-04;4537;3767;0;297546;153762;0;51.8;26.8;0.0
17;2021-06-05;2062;1575;0;299608;155337;0;52.2;27.1;0.0
17;2021-06-06;815;688;0;300423;156025;0;52.3;27.2;0.0
17;2021-06-07;3192;4179;0;303615;160204;0;52.9;27.9;0.0
17;2021-06-08;3846;4435;0;307461;164639;0;53.6;28.7;0.0
17;2021-06-09;4481;3077;0;311942;167716;0;54.3;29.2;0.0
17;2021-06-10;4881;2827;0;316823;170543;0;55.2;29.7;0.0
17;2021-06-11;4743;3707;0;321566;174250;0;56.0;30.4;0.0
17;2021-06-12;1977;1410;0;323543;175660;0;56.4;30.6;0.0
17;2021-06-13;621;412;0;324164;176072;0;56.5;30.7;0.0
17;2021-06-14;2688;4502;0;326852;180574;0;56.9;31.5;0.0
17;2021-06-15;3523;4325;0;330375;184899;0;57.6;32.2;0.0
17;2021-06-16;3961;3636;0;334336;188535;0;58.2;32.8;0.0
17;2021-06-17;4194;4117;0;338530;192652;0;59.0;33.6;0.0
17;2021-06-18;3939;4395;0;342469;197047;0;59.7;34.3;0.0
17;2021-06-19;1538;2007;0;344007;199054;0;59.9;34.7;0.0
17;2021-06-20;565;988;0;344572;200042;0;60.0;34.8;0.0
17;2021-06-21;2427;4323;0;346999;204365;0;60.4;35.6;0.0
17;2021-06-22;3339;4372;0;350338;208737;0;61.0;36.4;0.0
17;2021-06-23;3589;3990;0;353927;212727;0;61.7;37.1;0.0
17;2021-06-24;3383;3870;0;357310;216597;0;62.2;37.7;0.0
17;2021-06-25;2578;4909;0;359888;221506;0;62.7;38.6;0.0
17;2021-06-26;945;2302;0;360833;223808;0;62.9;39.0;0.0
17;2021-06-27;381;1747;0;361214;225555;0;62.9;39.3;0.0
17;2021-06-28;1445;5252;0;362659;230807;0;63.2;40.2;0.0
17;2021-06-29;1623;5714;0;364282;236521;0;63.5;41.2;0.0
17;2021-06-30;1961;5516;0;366243;242037;0;63.8;42.2;0.0
17;2021-07-01;2143;5358;0;368386;247395;0;64.2;43.1;0.0
17;2021-07-02;2328;5649;0;370714;253044;0;64.6;44.1;0.0
17;2021-07-03;655;2372;0;371369;255416;0;64.7;44.5;0.0
17;2021-07-04;139;1070;0;371508;256486;0;64.7;44.7;0.0
17;2021-07-05;1646;4783;0;373154;261269;0;65.0;45.5;0.0
17;2021-07-06;1952;5244;0;375106;266513;0;65.3;46.4;0.0
17;2021-07-07;2230;5289;0;377336;271802;0;65.7;47.3;0.0
17;2021-07-08;2590;5105;0;379926;276907;0;66.2;48.2;0.0
17;2021-07-09;2288;5741;0;382214;282648;0;66.6;49.2;0.0
17;2021-07-10;826;2400;0;383040;285048;0;66.7;49.7;0.0
17;2021-07-11;310;793;0;383350;285841;0;66.8;49.8;0.0
17;2021-07-12;1694;5305;0;385044;291146;0;67.1;50.7;0.0
17;2021-07-13;2070;6347;0;387114;297493;0;67.4;51.8;0.0
17;2021-07-14;211;240;0;387325;297733;0;67.5;51.9;0.0
17;2021-07-15;2006;6555;0;389331;304288;0;67.8;53.0;0.0
17;2021-07-16;2593;6509;0;391924;310797;0;68.3;54.1;0.0
17;2021-07-17;1054;2325;0;392978;313122;0;68.5;54.5;0.0
17;2021-07-18;320;936;0;393298;314058;0;68.5;54.7;0.0
17;2021-07-19;2351;5644;0;395649;319702;0;68.9;55.7;0.0
17;2021-07-20;2972;6015;0;398621;325717;0;69.4;56.7;0.0
17;2021-07-21;3468;5701;0;402089;331418;0;70.0;57.7;0.0
17;2021-07-22;3820;5801;0;405909;337219;0;70.7;58.7;0.0
17;2021-07-23;3588;6064;0;409497;343283;0;71.3;59.8;0.0
17;2021-07-24;1806;1575;0;411303;344858;0;71.6;60.1;0.0
17;2021-07-25;798;345;0;412101;345203;0;71.8;60.1;0.0
17;2021-07-26;3187;4969;0;415288;350172;0;72.3;61.0;0.0
17;2021-07-27;4208;4900;0;419496;355072;0;73.1;61.9;0.0
17;2021-07-28;4700;4674;0;424196;359746;0;73.9;62.7;0.0
17;2021-07-29;4690;4752;0;428886;364498;0;74.7;63.5;0.0
17;2021-07-30;4833;4998;0;433719;369496;0;75.6;64.4;0.0
17;2021-07-31;1920;1215;0;435639;370711;0;75.9;64.6;0.0
17;2021-08-01;857;298;0;436496;371009;0;76.0;64.6;0.0
17;2021-08-02;4010;3736;0;440506;374745;0;76.7;65.3;0.0
17;2021-08-03;4993;3518;0;445499;378263;0;77.6;65.9;0.0
17;2021-08-04;5487;2720;0;450986;380983;0;78.6;66.4;0.0
17;2021-08-05;5552;2548;0;456538;383531;0;79.5;66.8;0.0
17;2021-08-06;5137;2961;0;461675;386492;0;80.4;67.3;0.0
17;2021-08-07;1840;851;0;463515;387343;0;80.7;67.5;0.0
17;2021-08-08;764;144;0;464279;387487;0;80.9;67.5;0.0
17;2021-08-09;3476;2864;0;467755;390351;0;81.5;68.0;0.0
17;2021-08-10;4555;2824;0;472310;393175;0;82.3;68.5;0.0
17;2021-08-11;4389;3059;0;476699;396234;0;83.0;69.0;0.0
17;2021-08-12;4398;3153;0;481097;399387;0;83.8;69.6;0.0
17;2021-08-13;4042;3335;0;485139;402722;0;84.5;70.2;0.0
17;2021-08-14;1202;1269;0;486341;403991;0;84.7;70.4;0.0
17;2021-08-15;339;235;0;486680;404226;0;84.8;70.4;0.0
17;2021-08-16;2570;3250;0;489250;407476;0;85.2;71.0;0.0
17;2021-08-17;2781;3572;0;492031;411048;0;85.7;71.6;0.0
17;2021-08-18;2398;3837;0;494429;414885;0;86.1;72.3;0.0
17;2021-08-19;2454;3723;0;496883;418608;0;86.6;72.9;0.0
17;2021-08-20;2286;4245;0;499169;422853;0;87.0;73.7;0.0
17;2021-08-21;695;1336;0;499864;424189;0;87.1;73.9;0.0
17;2021-08-22;160;399;0;500024;424588;0;87.1;74.0;0.0
17;2021-08-23;1833;4339;0;501857;428927;0;87.4;74.7;0.0
17;2021-08-24;1795;4540;0;503652;433467;0;87.7;75.5;0.0
17;2021-08-25;1542;4966;0;505194;438433;0;88.0;76.4;0.0
17;2021-08-26;1553;5062;0;506747;443495;0;88.3;77.3;0.0
17;2021-08-27;1436;5446;0;508183;448941;0;88.5;78.2;0.0
17;2021-08-28;527;1495;0;508710;450436;0;88.6;78.5;0.0
17;2021-08-29;90;528;1;508800;450964;1;88.6;78.6;0.0
17;2021-08-30;1360;4729;50;510160;455693;51;88.9;79.4;0.0
17;2021-08-31;1246;4901;120;511406;460594;171;89.1;80.2;0.0
17;2021-09-01;1193;4534;323;512599;465128;494;89.3;81.0;0.1
17;2021-09-02;1081;3968;384;513680;469096;878;89.5;81.7;0.2
17;2021-09-03;1123;4653;385;514803;473749;1263;89.7;82.5;0.2
17;2021-09-04;331;1146;48;515134;474895;1311;89.7;82.7;0.2
17;2021-09-05;52;120;27;515186;475015;1338;89.7;82.7;0.2
17;2021-09-06;723;3064;513;515909;478079;1851;89.9;83.3;0.3
17;2021-09-07;711;2547;583;516620;480626;2434;90.0;83.7;0.4
17;2021-09-08;799;3478;525;517419;484104;2959;90.1;84.3;0.5
17;2021-09-09;777;2345;733;518196;486449;3692;90.3;84.7;0.6
17;2021-09-10;783;3233;590;518979;489682;4282;90.4;85.3;0.7
17;2021-09-11;322;1033;148;519301;490715;4430;90.5;85.5;0.8
17;2021-09-12;15;35;10;519316;490750;4440;90.5;85.5;0.8
17;2021-09-13;608;1889;864;519924;492639;5304;90.6;85.8;0.9
17;2021-09-14;605;1604;1267;520529;494243;6571;90.7;86.1;1.1
17;2021-09-15;867;2259;947;521396;496502;7518;90.8;86.5;1.3
17;2021-09-16;529;1429;894;521925;497931;8412;90.9;86.7;1.5
17;2021-09-17;627;1887;762;522552;499818;9174;91.0;87.1;1.6
17;2021-09-18;210;686;169;522762;500504;9343;91.1;87.2;1.6
17;2021-09-19;15;18;11;522777;500522;9354;91.1;87.2;1.6
17;2021-09-20;411;1216;949;523188;501738;10303;91.1;87.4;1.8
17;2021-09-21;340;873;784;523528;502611;11087;91.2;87.6;1.9
17;2021-09-22;417;1658;790;523945;504269;11877;91.3;87.8;2.1
17;2021-09-23;362;972;1080;524307;505241;12957;91.3;88.0;2.3
17;2021-09-24;386;1771;1164;524693;507012;14121;91.4;88.3;2.5
17;2021-09-25;155;568;237;524848;507580;14358;91.4;88.4;2.5
17;2021-09-26;9;28;2;524857;507608;14360;91.4;88.4;2.5
17;2021-09-27;402;1135;947;525259;508743;15307;91.5;88.6;2.7
17;2021-09-28;257;679;863;525516;509422;16170;91.5;88.7;2.8
17;2021-09-29;453;1217;956;525969;510639;17126;91.6;89.0;3.0
17;2021-09-30;350;694;895;526319;511333;18021;91.7;89.1;3.1
17;2021-10-01;390;765;800;526709;512098;18821;91.8;89.2;3.3
17;2021-10-02;135;378;147;526844;512476;18968;91.8;89.3;3.3
17;2021-10-03;4;30;2;526848;512506;18970;91.8;89.3;3.3
17;2021-10-04;359;812;1064;527207;513318;20034;91.8;89.4;3.5
17;2021-10-05;353;570;919;527560;513888;20953;91.9;89.5;3.7
17;2021-10-06;409;1070;1130;527969;514958;22083;92.0;89.7;3.8
17;2021-10-07;259;530;802;528228;515488;22885;92.0;89.8;4.0
17;2021-10-08;427;866;1060;528655;516354;23945;92.1;89.9;4.2
17;2021-10-09;170;347;215;528825;516701;24160;92.1;90.0;4.2
17;2021-10-10;6;19;5;528831;516720;24165;92.1;90.0;4.2
17;2021-10-11;352;535;814;529183;517255;24979;92.2;90.1;4.4
17;2021-10-12;227;383;834;529410;517638;25813;92.2;90.2;4.5
17;2021-10-13;354;655;1255;529764;518293;27068;92.3;90.3;4.7
17;2021-10-14;232;397;880;529996;518690;27948;92.3;90.4;4.9
17;2021-10-15;384;632;1237;530380;519322;29185;92.4;90.5;5.1
17;2021-10-16;108;176;243;530488;519498;29428;92.4;90.5;5.1
17;2021-10-17;10;12;0;530498;519510;29428;92.4;90.5;5.1
17;2021-10-18;322;338;951;530820;519848;30379;92.5;90.6;5.3
17;2021-10-19;226;346;935;531046;520194;31314;92.5;90.6;5.5
17;2021-10-20;340;580;1468;531386;520774;32782;92.6;90.7;5.7
17;2021-10-21;216;342;998;531602;521116;33780;92.6;90.8;5.9
17;2021-10-22;321;538;1359;531923;521654;35139;92.7;90.9;6.1
17;2021-10-23;96;179;283;532019;521833;35422;92.7;90.9;6.2
17;2021-10-24;0;5;3;532019;521838;35425;92.7;90.9;6.2
17;2021-10-25;233;339;1212;532252;522177;36637;92.7;91.0;6.4
17;2021-10-26;152;253;971;532404;522430;37608;92.7;91.0;6.6
17;2021-10-27;255;437;2062;532659;522867;39670;92.8;91.1;6.9
17;2021-10-28;161;243;1062;532820;523110;40732;92.8;91.1;7.1
17;2021-10-29;232;412;1742;533052;523522;42474;92.9;91.2;7.4
17;2021-10-30;74;131;413;533126;523653;42887;92.9;91.2;7.5
17;2021-10-31;9;8;3;533135;523661;42890;92.9;91.2;7.5
17;2021-11-01;15;16;22;533150;523677;42912;92.9;91.2;7.5
17;2021-11-02;237;318;1220;533387;523995;44132;92.9;91.3;7.7
17;2021-11-03;234;333;1676;533621;524328;45808;93.0;91.3;8.0
17;2021-11-04;136;209;1334;533757;524537;47142;93.0;91.4;8.2
17;2021-11-05;230;340;1645;533987;524877;48787;93.0;91.4;8.5
17;2021-11-06;83;137;359;534070;525014;49146;93.0;91.5;8.6
17;2021-11-07;1;6;8;534071;525020;49154;93.0;91.5;8.6
17;2021-11-08;190;414;2142;534261;525434;51296;93.1;91.5;8.9
17;2021-11-09;199;388;2331;534460;525822;53627;93.1;91.6;9.3
17;2021-11-10;302;464;2831;534762;526286;56458;93.2;91.7;9.8
17;2021-11-11;4;9;73;534766;526295;56531;93.2;91.7;9.8
17;2021-11-12;164;244;2116;534930;526539;58647;93.2;91.7;10.2
17;2021-11-13;61;63;557;534991;526602;59204;93.2;91.7;10.3
17;2021-11-14;2;25;15;534993;526627;59219;93.2;91.7;10.3
17;2021-11-15;186;234;2313;535179;526861;61532;93.2;91.8;10.7
17;2021-11-16;194;261;2479;535373;527122;64011;93.3;91.8;11.2
17;2021-11-17;295;361;2940;535668;527483;66951;93.3;91.9;11.7
17;2021-11-18;229;197;2592;535897;527680;69543;93.4;91.9;12.1
17;2021-11-19;262;364;2828;536159;528044;72371;93.4;92.0;12.6
17;2021-11-20;116;146;649;536275;528190;73020;93.4;92.0;12.7
17;2021-11-21;9;6;27;536284;528196;73047;93.4;92.0;12.7
17;2021-11-22;284;186;2987;536568;528382;76034;93.5;92.0;13.2
17;2021-11-23;280;212;3308;536848;528594;79342;93.5;92.1;13.8
17;2021-11-24;292;343;3223;537140;528937;82565;93.6;92.1;14.4
17;2021-11-25;276;213;3385;537416;529150;85950;93.6;92.2;15.0
17;2021-11-26;307;322;4124;537723;529472;90074;93.7;92.2;15.7
17;2021-11-27;89;104;1044;537812;529576;91118;93.7;92.3;15.9
17;2021-11-28;12;6;156;537824;529582;91274;93.7;92.3;15.9
17;2021-11-29;162;249;4057;537986;529831;95331;93.7;92.3;16.6
17;2021-11-30;236;200;5491;538222;530031;100822;93.8;92.3;17.6
17;2021-12-01;216;327;5535;538438;530358;106357;93.8;92.4;18.5
17;2021-12-02;209;180;5862;538647;530538;112219;93.8;92.4;19.5
17;2021-12-03;232;259;6191;538879;530797;118410;93.9;92.5;20.6
17;2021-12-04;65;78;1579;538944;530875;119989;93.9;92.5;20.9
17;2021-12-05;9;19;235;538953;530894;120224;93.9;92.5;20.9
17;2021-12-06;133;212;5822;539086;531106;126046;93.9;92.5;22.0
17;2021-12-07;196;189;7339;539282;531295;133385;93.9;92.6;23.2
17;2021-12-08;175;316;6905;539457;531611;140290;94.0;92.6;24.4
17;2021-12-09;192;234;7642;539649;531845;147932;94.0;92.6;25.8
17;2021-12-10;181;282;8330;539830;532127;156262;94.0;92.7;27.2
17;2021-12-11;104;107;2347;539934;532234;158609;94.1;92.7;27.6
17;2021-12-12;27;19;526;539961;532253;159135;94.1;92.7;27.7
17;2021-12-13;159;260;6963;540120;532513;166098;94.1;92.8;28.9
17;2021-12-14;236;336;9186;540356;532849;175284;94.1;92.8;30.5
17;2021-12-15;253;359;8354;540609;533208;183638;94.2;92.9;32.0
17;2021-12-16;273;322;9496;540882;533530;193134;94.2;92.9;33.6
17;2021-12-17;287;368;9114;541169;533898;202248;94.3;93.0;35.2
17;2021-12-18;137;144;2843;541306;534042;205091;94.3;93.0;35.7
17;2021-12-19;36;30;642;541342;534072;205733;94.3;93.0;35.8
18;2020-12-27;0;0;0;0;0;0;0.0;0.0;0.0
18;2020-12-28;0;0;0;0;0;0;0.0;0.0;0.0
18;2020-12-29;0;0;0;0;0;0;0.0;0.0;0.0
18;2020-12-30;1;0;0;1;0;0;0.0;0.0;0.0
18;2020-12-31;0;0;0;1;0;0;0.0;0.0;0.0
18;2021-01-01;0;0;0;1;0;0;0.0;0.0;0.0
18;2021-01-02;0;0;0;1;0;0;0.0;0.0;0.0
18;2021-01-03;0;0;0;1;0;0;0.0;0.0;0.0
18;2021-01-04;2;0;0;3;0;0;0.0;0.0;0.0
18;2021-01-05;5;0;0;8;0;0;0.0;0.0;0.0
18;2021-01-06;7;0;0;15;0;0;0.0;0.0;0.0
18;2021-01-07;36;1;0;51;1;0;0.0;0.0;0.0
18;2021-01-08;74;0;0;125;1;0;0.0;0.0;0.0
18;2021-01-09;214;0;0;339;1;0;0.1;0.0;0.0
18;2021-01-10;148;0;0;487;1;0;0.2;0.0;0.0
18;2021-01-11;185;0;0;672;1;0;0.3;0.0;0.0
18;2021-01-12;332;0;0;1004;1;0;0.4;0.0;0.0
18;2021-01-13;243;2;0;1247;3;0;0.5;0.0;0.0
18;2021-01-14;288;2;0;1535;5;0;0.6;0.0;0.0
18;2021-01-15;275;2;0;1810;7;0;0.7;0.0;0.0
18;2021-01-16;169;1;0;1979;8;0;0.8;0.0;0.0
18;2021-01-17;2;0;0;1981;8;0;0.8;0.0;0.0
18;2021-01-18;318;0;0;2299;8;0;0.9;0.0;0.0
18;2021-01-19;1281;4;0;3580;12;0;1.4;0.0;0.0
18;2021-01-20;1074;2;0;4654;14;0;1.8;0.0;0.0
18;2021-01-21;887;1;0;5541;15;0;2.1;0.0;0.0
18;2021-01-22;667;1;0;6208;16;0;2.4;0.0;0.0
18;2021-01-23;210;2;0;6418;18;0;2.5;0.0;0.0
18;2021-01-24;4;0;0;6422;18;0;2.5;0.0;0.0
18;2021-01-25;441;1;0;6863;19;0;2.6;0.0;0.0
18;2021-01-26;380;1;0;7243;20;0;2.8;0.0;0.0
18;2021-01-27;410;11;0;7653;31;0;2.9;0.0;0.0
18;2021-01-28;519;12;0;8172;43;0;3.1;0.0;0.0
18;2021-01-29;440;70;0;8612;113;0;3.3;0.0;0.0
18;2021-01-30;362;154;0;8974;267;0;3.5;0.1;0.0
18;2021-01-31;80;119;0;9054;386;0;3.5;0.1;0.0
18;2021-02-01;271;136;0;9325;522;0;3.6;0.2;0.0
18;2021-02-02;442;229;0;9767;751;0;3.8;0.3;0.0
18;2021-02-03;413;192;0;10180;943;0;3.9;0.4;0.0
18;2021-02-04;595;189;0;10775;1132;0;4.1;0.4;0.0
18;2021-02-05;382;169;0;11157;1301;0;4.3;0.5;0.0
18;2021-02-06;274;98;0;11431;1399;0;4.4;0.5;0.0
18;2021-02-07;108;2;0;11539;1401;0;4.4;0.5;0.0
18;2021-02-08;306;236;0;11845;1637;0;4.6;0.6;0.0
18;2021-02-09;593;740;0;12438;2377;0;4.8;0.9;0.0
18;2021-02-10;752;667;0;13190;3044;0;5.1;1.2;0.0
18;2021-02-11;670;456;0;13860;3500;0;5.3;1.3;0.0
18;2021-02-12;493;291;0;14353;3791;0;5.5;1.5;0.0
18;2021-02-13;274;122;0;14627;3913;0;5.6;1.5;0.0
18;2021-02-14;350;92;0;14977;4005;0;5.8;1.5;0.0
18;2021-02-15;370;404;0;15347;4409;0;5.9;1.7;0.0
18;2021-02-16;390;450;0;15737;4859;0;6.1;1.9;0.0
18;2021-02-17;410;500;0;16147;5359;0;6.2;2.1;0.0
18;2021-02-18;270;556;0;16417;5915;0;6.3;2.3;0.0
18;2021-02-19;323;368;0;16740;6283;0;6.4;2.4;0.0
18;2021-02-20;615;230;0;17355;6513;0;6.7;2.5;0.0
18;2021-02-21;313;5;0;17668;6518;0;6.8;2.5;0.0
18;2021-02-22;215;412;0;17883;6930;0;6.9;2.7;0.0
18;2021-02-23;237;384;0;18120;7314;0;7.0;2.8;0.0
18;2021-02-24;225;284;0;18345;7598;0;7.1;2.9;0.0
18;2021-02-25;329;571;0;18674;8169;0;7.2;3.1;0.0
18;2021-02-26;587;293;0;19261;8462;0;7.4;3.3;0.0
18;2021-02-27;495;390;0;19756;8852;0;7.6;3.4;0.0
18;2021-02-28;6;73;0;19762;8925;0;7.6;3.4;0.0
18;2021-03-01;249;426;0;20011;9351;0;7.7;3.6;0.0
18;2021-03-02;323;560;0;20334;9911;0;7.8;3.8;0.0
18;2021-03-03;360;610;0;20694;10521;0;8.0;4.0;0.0
18;2021-03-04;519;606;0;21213;11127;0;8.2;4.3;0.0
18;2021-03-05;588;365;0;21801;11492;0;8.4;4.4;0.0
18;2021-03-06;1077;341;0;22878;11833;0;8.8;4.6;0.0
18;2021-03-07;51;136;0;22929;11969;0;8.8;4.6;0.0
18;2021-03-08;339;379;0;23268;12348;0;9.0;4.7;0.0
18;2021-03-09;463;398;0;23731;12746;0;9.1;4.9;0.0
18;2021-03-10;493;465;0;24224;13211;0;9.3;5.1;0.0
18;2021-03-11;552;409;0;24776;13620;0;9.5;5.2;0.0
18;2021-03-12;799;322;0;25575;13942;0;9.8;5.4;0.0
18;2021-03-13;1192;241;0;26767;14183;0;10.3;5.5;0.0
18;2021-03-14;298;209;0;27065;14392;0;10.4;5.5;0.0
18;2021-03-15;528;393;0;27593;14785;0;10.6;5.7;0.0
18;2021-03-16;447;319;0;28040;15104;0;10.8;5.8;0.0
18;2021-03-17;408;415;0;28448;15519;0;10.9;6.0;0.0
18;2021-03-18;514;249;0;28962;15768;0;11.1;6.1;0.0
18;2021-03-19;793;243;0;29755;16011;0;11.4;6.2;0.0
18;2021-03-20;967;606;0;30722;16617;0;11.8;6.4;0.0
18;2021-03-21;310;304;0;31032;16921;0;11.9;6.5;0.0
18;2021-03-22;600;286;0;31632;17207;0;12.2;6.6;0.0
18;2021-03-23;829;278;0;32461;17485;0;12.5;6.7;0.0
18;2021-03-24;1118;284;0;33579;17769;0;12.9;6.8;0.0
18;2021-03-25;1242;308;0;34821;18077;0;13.4;7.0;0.0
18;2021-03-26;1314;347;0;36135;18424;0;13.9;7.1;0.0
18;2021-03-27;1479;312;0;37614;18736;0;14.5;7.2;0.0
18;2021-03-28;213;5;0;37827;18741;0;14.6;7.2;0.0
18;2021-03-29;1054;218;0;38881;18959;0;15.0;7.3;0.0
18;2021-03-30;1116;322;0;39997;19281;0;15.4;7.4;0.0
18;2021-03-31;1371;274;0;41368;19555;0;15.9;7.5;0.0
18;2021-04-01;1433;356;0;42801;19911;0;16.5;7.7;0.0
18;2021-04-02;1280;329;0;44081;20240;0;17.0;7.8;0.0
18;2021-04-03;623;174;0;44704;20414;0;17.2;7.9;0.0
18;2021-04-04;78;6;0;44782;20420;0;17.2;7.9;0.0
18;2021-04-05;205;2;0;44987;20422;0;17.3;7.9;0.0
18;2021-04-06;1088;368;0;46075;20790;0;17.7;8.0;0.0
18;2021-04-07;1290;412;0;47365;21202;0;18.2;8.2;0.0
18;2021-04-08;1728;368;0;49093;21570;0;18.9;8.3;0.0
18;2021-04-09;1902;329;0;50995;21899;0;19.6;8.4;0.0
18;2021-04-10;2552;654;0;53547;22553;0;20.6;8.7;0.0
18;2021-04-11;1878;324;0;55425;22877;0;21.3;8.8;0.0
18;2021-04-12;1382;423;0;56807;23300;0;21.9;9.0;0.0
18;2021-04-13;1720;494;0;58527;23794;0;22.5;9.2;0.0
18;2021-04-14;1361;529;0;59888;24323;0;23.0;9.4;0.0
18;2021-04-15;1501;579;0;61389;24902;0;23.6;9.6;0.0
18;2021-04-16;1692;637;0;63081;25539;0;24.3;9.8;0.0
18;2021-04-17;1501;526;0;64582;26065;0;24.8;10.0;0.0
18;2021-04-18;369;235;0;64951;26300;0;25.0;10.1;0.0
18;2021-04-19;1309;591;0;66260;26891;0;25.5;10.3;0.0
18;2021-04-20;1367;799;0;67627;27690;0;26.0;10.7;0.0
18;2021-04-21;1232;963;0;68859;28653;0;26.5;11.0;0.0
18;2021-04-22;1349;848;0;70208;29501;0;27.0;11.3;0.0
18;2021-04-23;1387;761;0;71595;30262;0;27.5;11.6;0.0
18;2021-04-24;1326;1253;0;72921;31515;0;28.1;12.1;0.0
18;2021-04-25;299;206;0;73220;31721;0;28.2;12.2;0.0
18;2021-04-26;1186;892;0;74406;32613;0;28.6;12.5;0.0
18;2021-04-27;1464;801;0;75870;33414;0;29.2;12.9;0.0
18;2021-04-28;1346;973;0;77216;34387;0;29.7;13.2;0.0
18;2021-04-29;1745;808;0;78961;35195;0;30.4;13.5;0.0
18;2021-04-30;1516;1045;0;80477;36240;0;31.0;13.9;0.0
18;2021-05-01;781;225;0;81258;36465;0;31.3;14.0;0.0
18;2021-05-02;764;63;0;82022;36528;0;31.6;14.1;0.0
18;2021-05-03;1637;1007;0;83659;37535;0;32.2;14.4;0.0
18;2021-05-04;1684;1333;0;85343;38868;0;32.8;15.0;0.0
18;2021-05-05;1673;1196;0;87016;40064;0;33.5;15.4;0.0
18;2021-05-06;2160;1377;0;89176;41441;0;34.3;15.9;0.0
18;2021-05-07;1284;1407;0;90460;42848;0;34.8;16.5;0.0
18;2021-05-08;976;1433;0;91436;44281;0;35.2;17.0;0.0
18;2021-05-09;482;2153;0;91918;46434;0;35.4;17.9;0.0
18;2021-05-10;1192;1500;0;93110;47934;0;35.8;18.4;0.0
18;2021-05-11;1740;1696;0;94850;49630;0;36.5;19.1;0.0
18;2021-05-12;1861;1387;0;96711;51017;0;37.2;19.6;0.0
18;2021-05-13;1082;323;0;97793;51340;0;37.6;19.7;0.0
18;2021-05-14;1440;981;0;99233;52321;0;38.2;20.1;0.0
18;2021-05-15;1882;1089;0;101115;53410;0;38.9;20.5;0.0
18;2021-05-16;544;555;0;101659;53965;0;39.1;20.8;0.0
18;2021-05-17;1292;1072;0;102951;55037;0;39.6;21.2;0.0
18;2021-05-18;2096;934;0;105047;55971;0;40.4;21.5;0.0
18;2021-05-19;2105;926;0;107152;56897;0;41.2;21.9;0.0
18;2021-05-20;2181;962;0;109333;57859;0;42.1;22.3;0.0
18;2021-05-21;1567;828;0;110900;58687;0;42.7;22.6;0.0
18;2021-05-22;1690;1044;0;112590;59731;0;43.3;23.0;0.0
18;2021-05-23;494;334;0;113084;60065;0;43.5;23.1;0.0
18;2021-05-24;575;302;0;113659;60367;0;43.7;23.2;0.0
18;2021-05-25;1712;1034;0;115371;61401;0;44.4;23.6;0.0
18;2021-05-26;2032;868;0;117403;62269;0;45.2;24.0;0.0
18;2021-05-27;1992;1164;0;119395;63433;0;45.9;24.4;0.0
18;2021-05-28;1708;1361;0;121103;64794;0;46.6;24.9;0.0
18;2021-05-29;2454;1616;0;123557;66410;0;47.5;25.5;0.0
18;2021-05-30;1481;488;0;125038;66898;0;48.1;25.7;0.0
18;2021-05-31;1587;679;0;126625;67577;0;48.7;26.0;0.0
18;2021-06-01;1929;953;0;128554;68530;0;49.5;26.4;0.0
18;2021-06-02;1876;1006;0;130430;69536;0;50.2;26.7;0.0
18;2021-06-03;2057;1217;0;132487;70753;0;51.0;27.2;0.0
18;2021-06-04;1817;1139;0;134304;71892;0;51.7;27.7;0.0
18;2021-06-05;2325;1397;0;136629;73289;0;52.6;28.2;0.0
18;2021-06-06;371;395;0;137000;73684;0;52.7;28.3;0.0
18;2021-06-07;1212;1189;0;138212;74873;0;53.2;28.8;0.0
18;2021-06-08;1481;1316;0;139693;76189;0;53.7;29.3;0.0
18;2021-06-09;1342;1057;0;141035;77246;0;54.3;29.7;0.0
18;2021-06-10;1548;1348;0;142583;78594;0;54.8;30.2;0.0
18;2021-06-11;1464;1401;0;144047;79995;0;55.4;30.8;0.0
18;2021-06-12;1205;2476;0;145252;82471;0;55.9;31.7;0.0
18;2021-06-13;145;258;0;145397;82729;0;55.9;31.8;0.0
18;2021-06-14;657;1851;0;146054;84580;0;56.2;32.5;0.0
18;2021-06-15;1187;1810;0;147241;86390;0;56.6;33.2;0.0
18;2021-06-16;1285;1444;0;148526;87834;0;57.1;33.8;0.0
18;2021-06-17;1327;1660;0;149853;89494;0;57.6;34.4;0.0
18;2021-06-18;1345;1733;0;151198;91227;0;58.2;35.1;0.0
18;2021-06-19;1510;1209;0;152708;92436;0;58.7;35.6;0.0
18;2021-06-20;250;179;0;152958;92615;0;58.8;35.6;0.0
18;2021-06-21;663;1689;0;153621;94304;0;59.1;36.3;0.0
18;2021-06-22;1094;1749;0;154715;96053;0;59.5;36.9;0.0
18;2021-06-23;1034;1703;0;155749;97756;0;59.9;37.6;0.0
18;2021-06-24;1053;1145;0;156802;98901;0;60.3;38.0;0.0
18;2021-06-25;961;1907;0;157763;100808;0;60.7;38.8;0.0
18;2021-06-26;1049;1534;0;158812;102342;0;61.1;39.4;0.0
18;2021-06-27;34;383;0;158846;102725;0;61.1;39.5;0.0
18;2021-06-28;433;1868;0;159279;104593;0;61.3;40.2;0.0
18;2021-06-29;612;2393;0;159891;106986;0;61.5;41.2;0.0
18;2021-06-30;642;2479;0;160533;109465;0;61.8;42.1;0.0
18;2021-07-01;1017;2057;0;161550;111522;0;62.1;42.9;0.0
18;2021-07-02;650;1664;0;162200;113186;0;62.4;43.5;0.0
18;2021-07-03;700;2436;0;162900;115622;0;62.7;44.5;0.0
18;2021-07-04;166;1006;0;163066;116628;0;62.7;44.9;0.0
18;2021-07-05;751;1819;0;163817;118447;0;63.0;45.6;0.0
18;2021-07-06;652;2306;0;164469;120753;0;63.3;46.5;0.0
18;2021-07-07;745;2059;0;165214;122812;0;63.6;47.2;0.0
18;2021-07-08;958;1877;0;166172;124689;0;63.9;48.0;0.0
18;2021-07-09;744;2347;0;166916;127036;0;64.2;48.9;0.0
18;2021-07-10;774;2984;0;167690;130020;0;64.5;50.0;0.0
18;2021-07-11;116;694;0;167806;130714;0;64.5;50.3;0.0
18;2021-07-12;280;2073;0;168086;132787;0;64.7;51.1;0.0
18;2021-07-13;708;2706;0;168794;135493;0;64.9;52.1;0.0
18;2021-07-14;255;902;0;169049;136395;0;65.0;52.5;0.0
18;2021-07-15;1486;2675;0;170535;139070;0;65.6;53.5;0.0
18;2021-07-16;1433;2177;0;171968;141247;0;66.2;54.3;0.0
18;2021-07-17;1127;2155;0;173095;143402;0;66.6;55.2;0.0
18;2021-07-18;259;334;0;173354;143736;0;66.7;55.3;0.0
18;2021-07-19;1263;1638;0;174617;145374;0;67.2;55.9;0.0
18;2021-07-20;1682;2324;0;176299;147698;0;67.8;56.8;0.0
18;2021-07-21;1866;2009;0;178165;149707;0;68.5;57.6;0.0
18;2021-07-22;2106;1955;0;180271;151662;0;69.3;58.3;0.0
18;2021-07-23;1518;1706;0;181789;153368;0;69.9;59.0;0.0
18;2021-07-24;1030;1516;0;182819;154884;0;70.3;59.6;0.0
18;2021-07-25;229;413;0;183048;155297;0;70.4;59.7;0.0
18;2021-07-26;1432;1493;0;184480;156790;0;71.0;60.3;0.0
18;2021-07-27;1875;1719;0;186355;158509;0;71.7;61.0;0.0
18;2021-07-28;2296;1863;0;188651;160372;0;72.6;61.7;0.0
18;2021-07-29;2205;1821;0;190856;162193;0;73.4;62.4;0.0
18;2021-07-30;1713;1437;0;192569;163630;0;74.1;62.9;0.0
18;2021-07-31;1169;1279;0;193738;164909;0;74.5;63.4;0.0
18;2021-08-01;125;39;0;193863;164948;0;74.6;63.5;0.0
18;2021-08-02;1491;825;0;195354;165773;0;75.1;63.8;0.0
18;2021-08-03;1858;1678;0;197212;167451;0;75.9;64.4;0.0
18;2021-08-04;2239;1101;0;199451;168552;0;76.7;64.8;0.0
18;2021-08-05;1720;1233;0;201171;169785;0;77.4;65.3;0.0
18;2021-08-06;1777;1155;0;202948;170940;0;78.1;65.8;0.0
18;2021-08-07;717;831;0;203665;171771;0;78.3;66.1;0.0
18;2021-08-08;62;79;0;203727;171850;0;78.4;66.1;0.0
18;2021-08-09;1120;1034;0;204847;172884;0;78.8;66.5;0.0
18;2021-08-10;1375;1640;0;206222;174524;0;79.3;67.1;0.0
18;2021-08-11;1704;1535;0;207926;176059;0;80.0;67.7;0.0
18;2021-08-12;1616;1620;0;209542;177679;0;80.6;68.3;0.0
18;2021-08-13;1097;1162;0;210639;178841;0;81.0;68.8;0.0
18;2021-08-14;770;656;0;211409;179497;0;81.3;69.0;0.0
18;2021-08-15;39;36;0;211448;179533;0;81.3;69.1;0.0
18;2021-08-16;815;1409;0;212263;180942;0;81.7;69.6;0.0
18;2021-08-17;1006;1973;0;213269;182915;0;82.0;70.4;0.0
18;2021-08-18;1141;1888;0;214410;184803;0;82.5;71.1;0.0
18;2021-08-19;1039;1724;0;215449;186527;0;82.9;71.8;0.0
18;2021-08-20;904;1761;0;216353;188288;0;83.2;72.4;0.0
18;2021-08-21;434;803;0;216787;189091;0;83.4;72.7;0.0
18;2021-08-22;24;88;0;216811;189179;0;83.4;72.8;0.0
18;2021-08-23;534;1663;0;217345;190842;0;83.6;73.4;0.0
18;2021-08-24;841;1734;0;218186;192576;0;83.9;74.1;0.0
18;2021-08-25;793;1880;0;218979;194456;0;84.2;74.8;0.0
18;2021-08-26;742;1696;0;219721;196152;0;84.5;75.5;0.0
18;2021-08-27;562;2059;0;220283;198211;0;84.7;76.2;0.0
18;2021-08-28;515;934;0;220798;199145;0;84.9;76.6;0.0
18;2021-08-29;92;181;0;220890;199326;0;85.0;76.7;0.0
18;2021-08-30;523;1387;33;221413;200713;33;85.2;77.2;0.0
18;2021-08-31;496;1532;47;221909;202245;80;85.4;77.8;0.0
18;2021-09-01;585;1600;130;222494;203845;210;85.6;78.4;0.1
18;2021-09-02;407;1264;154;222901;205109;364;85.7;78.9;0.1
18;2021-09-03;458;1191;165;223359;206300;529;85.9;79.4;0.2
18;2021-09-04;375;847;76;223734;207147;605;86.1;79.7;0.2
18;2021-09-05;32;62;23;223766;207209;628;86.1;79.7;0.2
18;2021-09-06;267;917;211;224033;208126;839;86.2;80.1;0.3
18;2021-09-07;314;946;163;224347;209072;1002;86.3;80.4;0.4
18;2021-09-08;397;1092;120;224744;210164;1122;86.5;80.8;0.4
18;2021-09-09;350;950;175;225094;211114;1297;86.6;81.2;0.5
18;2021-09-10;414;913;173;225508;212027;1470;86.7;81.6;0.6
18;2021-09-11;261;822;93;225769;212849;1563;86.8;81.9;0.6
18;2021-09-12;7;28;13;225776;212877;1576;86.8;81.9;0.6
18;2021-09-13;334;740;160;226110;213617;1736;87.0;82.2;0.7
18;2021-09-14;284;784;276;226394;214401;2012;87.1;82.5;0.8
18;2021-09-15;337;1027;340;226731;215428;2352;87.2;82.9;0.9
18;2021-09-16;466;852;293;227197;216280;2645;87.4;83.2;1.0
18;2021-09-17;349;704;362;227546;216984;3007;87.5;83.5;1.2
18;2021-09-18;197;654;132;227743;217638;3139;87.6;83.7;1.2
18;2021-09-19;8;10;11;227751;217648;3150;87.6;83.7;1.2
18;2021-09-20;153;546;288;227904;218194;3438;87.7;83.9;1.3
18;2021-09-21;127;453;270;228031;218647;3708;87.7;84.1;1.4
18;2021-09-22;182;774;358;228213;219421;4066;87.8;84.4;1.6
18;2021-09-23;246;440;526;228459;219861;4592;87.9;84.6;1.8
18;2021-09-24;139;491;355;228598;220352;4947;87.9;84.8;1.9
18;2021-09-25;150;710;173;228748;221062;5120;88.0;85.0;2.0
18;2021-09-26;16;96;48;228764;221158;5168;88.0;85.1;2.0
18;2021-09-27;111;323;276;228875;221481;5444;88.0;85.2;2.1
18;2021-09-28;85;286;306;228960;221767;5750;88.1;85.3;2.2
18;2021-09-29;83;298;226;229043;222065;5976;88.1;85.4;2.3
18;2021-09-30;120;280;529;229163;222345;6505;88.2;85.5;2.5
18;2021-10-01;169;302;336;229332;222647;6841;88.2;85.6;2.6
18;2021-10-02;80;212;77;229412;222859;6918;88.2;85.7;2.7
18;2021-10-03;8;13;32;229420;222872;6950;88.3;85.7;2.7
18;2021-10-04;141;422;364;229561;223294;7314;88.3;85.9;2.8
18;2021-10-05;137;310;418;229698;223604;7732;88.4;86.0;3.0
18;2021-10-06;134;420;459;229832;224024;8191;88.4;86.2;3.2
18;2021-10-07;109;382;343;229941;224406;8534;88.5;86.3;3.3
18;2021-10-08;160;501;571;230101;224907;9105;88.5;86.5;3.5
18;2021-10-09;123;298;159;230224;225205;9264;88.6;86.6;3.6
18;2021-10-10;6;13;36;230230;225218;9300;88.6;86.6;3.6
18;2021-10-11;152;201;510;230382;225419;9810;88.6;86.7;3.8
18;2021-10-12;146;197;630;230528;225616;10440;88.7;86.8;4.0
18;2021-10-13;156;226;451;230684;225842;10891;88.7;86.9;4.2
18;2021-10-14;63;231;328;230747;226073;11219;88.8;87.0;4.3
18;2021-10-15;165;287;768;230912;226360;11987;88.8;87.1;4.6
18;2021-10-16;152;244;825;231064;226604;12812;88.9;87.2;4.9
18;2021-10-17;8;19;36;231072;226623;12848;88.9;87.2;4.9
18;2021-10-18;124;169;464;231196;226792;13312;88.9;87.2;5.1
18;2021-10-19;101;105;447;231297;226897;13759;89.0;87.3;5.3
18;2021-10-20;143;131;651;231440;227028;14410;89.0;87.3;5.5
18;2021-10-21;66;82;404;231506;227110;14814;89.1;87.4;5.7
18;2021-10-22;126;188;583;231632;227298;15397;89.1;87.4;5.9
18;2021-10-23;92;91;313;231724;227389;15710;89.1;87.5;6.0
18;2021-10-24;6;7;27;231730;227396;15737;89.1;87.5;6.1
18;2021-10-25;104;145;543;231834;227541;16280;89.2;87.5;6.3
18;2021-10-26;88;146;431;231922;227687;16711;89.2;87.6;6.4
18;2021-10-27;110;159;601;232032;227846;17312;89.3;87.6;6.7
18;2021-10-28;58;78;531;232090;227924;17843;89.3;87.7;6.9
18;2021-10-29;131;166;641;232221;228090;18484;89.3;87.7;7.1
18;2021-10-30;80;114;200;232301;228204;18684;89.4;87.8;7.2
18;2021-10-31;0;1;2;232301;228205;18686;89.4;87.8;7.2
18;2021-11-01;5;10;2;232306;228215;18688;89.4;87.8;7.2
18;2021-11-02;71;145;508;232377;228360;19196;89.4;87.8;7.4
18;2021-11-03;102;219;796;232479;228579;19992;89.4;87.9;7.7
18;2021-11-04;63;73;459;232542;228652;20451;89.5;88.0;7.9
18;2021-11-05;72;134;721;232614;228786;21172;89.5;88.0;8.1
18;2021-11-06;76;144;1284;232690;228930;22456;89.5;88.1;8.6
18;2021-11-07;6;14;45;232696;228944;22501;89.5;88.1;8.7
18;2021-11-08;61;114;906;232757;229058;23407;89.5;88.1;9.0
18;2021-11-09;78;113;885;232835;229171;24292;89.6;88.2;9.3
18;2021-11-10;113;154;1051;232948;229325;25343;89.6;88.2;9.7
18;2021-11-11;1;2;11;232949;229327;25354;89.6;88.2;9.8
18;2021-11-12;67;127;701;233016;229454;26055;89.6;88.3;10.0
18;2021-11-13;50;106;385;233066;229560;26440;89.7;88.3;10.2
18;2021-11-14;0;3;7;233066;229563;26447;89.7;88.3;10.2
18;2021-11-15;73;111;1173;233139;229674;27620;89.7;88.3;10.6
18;2021-11-16;98;96;1453;233237;229770;29073;89.7;88.4;11.2
18;2021-11-17;157;156;1602;233394;229926;30675;89.8;88.4;11.8
18;2021-11-18;58;75;1074;233452;230001;31749;89.8;88.5;12.2
18;2021-11-19;102;147;1326;233554;230148;33075;89.8;88.5;12.7
18;2021-11-20;76;114;905;233630;230262;33980;89.9;88.6;13.1
18;2021-11-21;16;16;75;233646;230278;34055;89.9;88.6;13.1
18;2021-11-22;99;54;1216;233745;230332;35271;89.9;88.6;13.6
18;2021-11-23;112;89;1479;233857;230421;36750;90.0;88.6;14.1
18;2021-11-24;146;107;1503;234003;230528;38253;90.0;88.7;14.7
18;2021-11-25;52;75;1178;234055;230603;39431;90.0;88.7;15.2
18;2021-11-26;130;118;1796;234185;230721;41227;90.1;88.8;15.9
18;2021-11-27;109;80;990;234294;230801;42217;90.1;88.8;16.2
18;2021-11-28;9;13;416;234303;230814;42633;90.1;88.8;16.4
18;2021-11-29;107;75;2009;234410;230889;44642;90.2;88.8;17.2
18;2021-11-30;82;79;2269;234492;230968;46911;90.2;88.8;18.0
18;2021-12-01;78;112;2528;234570;231080;49439;90.2;88.9;19.0
18;2021-12-02;80;59;2752;234650;231139;52191;90.3;88.9;20.1
18;2021-12-03;75;81;2498;234725;231220;54689;90.3;88.9;21.0
18;2021-12-04;42;90;2190;234767;231310;56879;90.3;89.0;21.9
18;2021-12-05;6;3;118;234773;231313;56997;90.3;89.0;21.9
18;2021-12-06;42;91;2568;234815;231404;59565;90.3;89.0;22.9
18;2021-12-07;51;96;3636;234866;231500;63201;90.3;89.1;24.3
18;2021-12-08;61;141;3067;234927;231641;66268;90.4;89.1;25.5
18;2021-12-09;85;102;3327;235012;231743;69595;90.4;89.1;26.8
18;2021-12-10;79;144;3814;235091;231887;73409;90.4;89.2;28.2
18;2021-12-11;66;86;3177;235157;231973;76586;90.5;89.2;29.5
18;2021-12-12;28;21;689;235185;231994;77275;90.5;89.2;29.7
18;2021-12-13;50;113;2778;235235;232107;80053;90.5;89.3;30.8
18;2021-12-14;83;117;4078;235318;232224;84131;90.5;89.3;32.4
18;2021-12-15;105;139;4000;235423;232363;88131;90.6;89.4;33.9
18;2021-12-16;100;84;3799;235523;232447;91930;90.6;89.4;35.4
18;2021-12-17;90;180;3864;235613;232627;95794;90.6;89.5;36.8
18;2021-12-18;81;127;3588;235694;232754;99382;90.7;89.5;38.2
18;2021-12-19;22;19;566;235716;232773;99948;90.7;89.5;38.4
19;2020-12-27;0;0;0;0;0;0;0.0;0.0;0.0
19;2020-12-28;0;0;0;0;0;0;0.0;0.0;0.0
19;2020-12-29;1;0;0;1;0;0;0.0;0.0;0.0
19;2020-12-30;0;0;0;1;0;0;0.0;0.0;0.0
19;2020-12-31;0;0;0;1;0;0;0.0;0.0;0.0
19;2021-01-01;0;0;0;1;0;0;0.0;0.0;0.0
19;2021-01-02;0;0;0;1;0;0;0.0;0.0;0.0
19;2021-01-03;0;0;0;1;0;0;0.0;0.0;0.0
19;2021-01-04;0;0;0;1;0;0;0.0;0.0;0.0
19;2021-01-05;0;0;0;1;0;0;0.0;0.0;0.0
19;2021-01-06;0;0;0;1;0;0;0.0;0.0;0.0
19;2021-01-07;323;2;0;324;2;0;0.2;0.0;0.0
19;2021-01-08;236;1;0;560;3;0;0.3;0.0;0.0
19;2021-01-09;2;0;0;562;3;0;0.3;0.0;0.0
19;2021-01-10;1;0;0;563;3;0;0.3;0.0;0.0
19;2021-01-11;45;0;0;608;3;0;0.3;0.0;0.0
19;2021-01-12;383;2;0;991;5;0;0.5;0.0;0.0
19;2021-01-13;340;2;0;1331;7;0;0.6;0.0;0.0
19;2021-01-14;452;1;0;1783;8;0;0.8;0.0;0.0
19;2021-01-15;229;18;0;2012;26;0;0.9;0.0;0.0
19;2021-01-16;11;0;0;2023;26;0;0.9;0.0;0.0
19;2021-01-17;3;0;0;2026;26;0;0.9;0.0;0.0
19;2021-01-18;263;1;0;2289;27;0;1.1;0.0;0.0
19;2021-01-19;470;0;0;2759;27;0;1.3;0.0;0.0
19;2021-01-20;884;10;0;3643;37;0;1.7;0.0;0.0
19;2021-01-21;468;4;0;4111;41;0;1.9;0.0;0.0
19;2021-01-22;1210;13;0;5321;54;0;2.5;0.0;0.0
19;2021-01-23;269;0;0;5590;54;0;2.6;0.0;0.0
19;2021-01-24;38;0;0;5628;54;0;2.6;0.0;0.0
19;2021-01-25;234;0;0;5862;54;0;2.7;0.0;0.0
19;2021-01-26;540;1;0;6402;55;0;3.0;0.0;0.0
19;2021-01-27;300;2;0;6702;57;0;3.1;0.0;0.0
19;2021-01-28;284;237;0;6986;294;0;3.3;0.1;0.0
19;2021-01-29;315;60;0;7301;354;0;3.4;0.2;0.0
19;2021-01-30;128;20;0;7429;374;0;3.5;0.2;0.0
19;2021-01-31;41;1;0;7470;375;0;3.5;0.2;0.0
19;2021-02-01;164;92;0;7634;467;0;3.6;0.2;0.0
19;2021-02-02;308;399;0;7942;866;0;3.7;0.4;0.0
19;2021-02-03;272;215;0;8214;1081;0;3.8;0.5;0.0
19;2021-02-04;262;353;0;8476;1434;0;4.0;0.7;0.0
19;2021-02-05;312;85;0;8788;1519;0;4.1;0.7;0.0
19;2021-02-06;193;5;0;8981;1524;0;4.2;0.7;0.0
19;2021-02-07;45;2;0;9026;1526;0;4.2;0.7;0.0
19;2021-02-08;182;154;0;9208;1680;0;4.3;0.8;0.0
19;2021-02-09;285;264;0;9493;1944;0;4.4;0.9;0.0
19;2021-02-10;488;277;0;9981;2221;0;4.7;1.0;0.0
19;2021-02-11;411;322;0;10392;2543;0;4.9;1.2;0.0
19;2021-02-12;749;1088;0;11141;3631;0;5.2;1.7;0.0
19;2021-02-13;333;178;0;11474;3809;0;5.4;1.8;0.0
19;2021-02-14;95;12;0;11569;3821;0;5.4;1.8;0.0
19;2021-02-15;194;234;0;11763;4055;0;5.5;1.9;0.0
19;2021-02-16;349;176;0;12112;4231;0;5.7;2.0;0.0
19;2021-02-17;291;487;0;12403;4718;0;5.8;2.2;0.0
19;2021-02-18;182;481;0;12585;5199;0;5.9;2.4;0.0
19;2021-02-19;451;281;0;13036;5480;0;6.1;2.6;0.0
19;2021-02-20;128;194;0;13164;5674;0;6.2;2.7;0.0
19;2021-02-21;20;42;0;13184;5716;0;6.2;2.7;0.0
19;2021-02-22;210;207;0;13394;5923;0;6.3;2.8;0.0
19;2021-02-23;249;324;0;13643;6247;0;6.4;2.9;0.0
19;2021-02-24;333;219;0;13976;6466;0;6.6;3.0;0.0
19;2021-02-25;507;364;0;14483;6830;0;6.8;3.2;0.0
19;2021-02-26;425;327;0;14908;7157;0;7.0;3.4;0.0
19;2021-02-27;352;149;0;15260;7306;0;7.2;3.4;0.0
19;2021-02-28;67;36;0;15327;7342;0;7.2;3.4;0.0
19;2021-03-01;262;217;0;15589;7559;0;7.3;3.5;0.0
19;2021-03-02;409;240;0;15998;7799;0;7.5;3.7;0.0
19;2021-03-03;668;347;0;16666;8146;0;7.8;3.8;0.0
19;2021-03-04;798;321;0;17464;8467;0;8.2;4.0;0.0
19;2021-03-05;901;697;0;18365;9164;0;8.6;4.3;0.0
19;2021-03-06;1041;192;0;19406;9356;0;9.1;4.4;0.0
19;2021-03-07;449;38;0;19855;9394;0;9.3;4.4;0.0
19;2021-03-08;582;179;0;20437;9573;0;9.6;4.5;0.0
19;2021-03-09;852;248;0;21289;9821;0;10.0;4.6;0.0
19;2021-03-10;1096;309;0;22385;10130;0;10.5;4.7;0.0
19;2021-03-11;1280;287;0;23665;10417;0;11.1;4.9;0.0
19;2021-03-12;1243;385;0;24908;10802;0;11.7;5.1;0.0
19;2021-03-13;1079;154;0;25987;10956;0;12.2;5.1;0.0
19;2021-03-14;145;78;0;26132;11034;0;12.2;5.2;0.0
19;2021-03-15;661;151;0;26793;11185;0;12.6;5.2;0.0
19;2021-03-16;653;266;0;27446;11451;0;12.9;5.4;0.0
19;2021-03-17;772;290;0;28218;11741;0;13.2;5.5;0.0
19;2021-03-18;734;259;0;28952;12000;0;13.6;5.6;0.0
19;2021-03-19;991;452;0;29943;12452;0;14.0;5.8;0.0
19;2021-03-20;752;122;0;30695;12574;0;14.4;5.9;0.0
19;2021-03-21;117;4;0;30812;12578;0;14.4;5.9;0.0
19;2021-03-22;554;172;0;31366;12750;0;14.7;6.0;0.0
19;2021-03-23;1003;227;0;32369;12977;0;15.2;6.1;0.0
19;2021-03-24;1113;356;0;33482;13333;0;15.7;6.2;0.0
19;2021-03-25;1209;391;0;34691;13724;0;16.3;6.4;0.0
19;2021-03-26;1331;295;0;36022;14019;0;16.9;6.6;0.0
19;2021-03-27;817;187;0;36839;14206;0;17.3;6.7;0.0
19;2021-03-28;72;59;0;36911;14265;0;17.3;6.7;0.0
19;2021-03-29;605;173;0;37516;14438;0;17.6;6.8;0.0
19;2021-03-30;933;349;0;38449;14787;0;18.0;6.9;0.0
19;2021-03-31;1084;498;0;39533;15285;0;18.5;7.2;0.0
19;2021-04-01;1454;375;0;40987;15660;0;19.2;7.3;0.0
19;2021-04-02;1021;529;0;42008;16189;0;19.7;7.6;0.0
19;2021-04-03;585;261;0;42593;16450;0;20.0;7.7;0.0
19;2021-04-04;135;4;0;42728;16454;0;20.0;7.7;0.0
19;2021-04-05;65;73;0;42793;16527;0;20.1;7.7;0.0
19;2021-04-06;732;577;0;43525;17104;0;20.4;8.0;0.0
19;2021-04-07;925;728;0;44450;17832;0;20.8;8.4;0.0
19;2021-04-08;1126;960;0;45576;18792;0;21.4;8.8;0.0
19;2021-04-09;1629;671;0;47205;19463;0;22.1;9.1;0.0
19;2021-04-10;939;522;0;48144;19985;0;22.6;9.4;0.0
19;2021-04-11;511;66;0;48655;20051;0;22.8;9.4;0.0
19;2021-04-12;715;500;0;49370;20551;0;23.1;9.6;0.0
19;2021-04-13;926;561;0;50296;21112;0;23.6;9.9;0.0
19;2021-04-14;1354;815;0;51650;21927;0;24.2;10.3;0.0
19;2021-04-15;1252;800;0;52902;22727;0;24.8;10.7;0.0
19;2021-04-16;1530;814;0;54432;23541;0;25.5;11.0;0.0
19;2021-04-17;777;460;0;55209;24001;0;25.9;11.2;0.0
19;2021-04-18;583;65;0;55792;24066;0;26.1;11.3;0.0
19;2021-04-19;733;430;0;56525;24496;0;26.5;11.5;0.0
19;2021-04-20;922;699;0;57447;25195;0;26.9;11.8;0.0
19;2021-04-21;1184;700;0;58631;25895;0;27.5;12.1;0.0
19;2021-04-22;1089;879;0;59720;26774;0;28.0;12.5;0.0
19;2021-04-23;1185;977;0;60905;27751;0;28.5;13.0;0.0
19;2021-04-24;660;652;0;61565;28403;0;28.9;13.3;0.0
19;2021-04-25;641;72;0;62206;28475;0;29.2;13.3;0.0
19;2021-04-26;1102;338;0;63308;28813;0;29.7;13.5;0.0
19;2021-04-27;1071;551;0;64379;29364;0;30.2;13.8;0.0
19;2021-04-28;1540;567;0;65919;29931;0;30.9;14.0;0.0
19;2021-04-29;1464;1086;0;67383;31017;0;31.6;14.5;0.0
19;2021-04-30;1918;1082;0;69301;32099;0;32.5;15.0;0.0
19;2021-05-01;673;183;0;69974;32282;0;32.8;15.1;0.0
19;2021-05-02;552;150;0;70526;32432;0;33.1;15.2;0.0
19;2021-05-03;958;546;0;71484;32978;0;33.5;15.5;0.0
19;2021-05-04;1144;713;0;72628;33691;0;34.0;15.8;0.0
19;2021-05-05;1387;759;0;74015;34450;0;34.7;16.1;0.0
19;2021-05-06;1346;1162;0;75361;35612;0;35.3;16.7;0.0
19;2021-05-07;1732;1197;0;77093;36809;0;36.1;17.3;0.0
19;2021-05-08;854;228;0;77947;37037;0;36.5;17.4;0.0
19;2021-05-09;470;510;0;78417;37547;0;36.8;17.6;0.0
19;2021-05-10;1211;742;0;79628;38289;0;37.3;17.9;0.0
19;2021-05-11;1652;878;0;81280;39167;0;38.1;18.4;0.0
19;2021-05-12;1935;1338;0;83215;40505;0;39.0;19.0;0.0
19;2021-05-13;636;294;0;83851;40799;0;39.3;19.1;0.0
19;2021-05-14;1593;972;0;85444;41771;0;40.0;19.6;0.0
19;2021-05-15;1341;585;0;86785;42356;0;40.7;19.9;0.0
19;2021-05-16;287;95;0;87072;42451;0;40.8;19.9;0.0
19;2021-05-17;1432;585;0;88504;43036;0;41.5;20.2;0.0
19;2021-05-18;1643;518;0;90147;43554;0;42.3;20.4;0.0
19;2021-05-19;1972;852;0;92119;44406;0;43.2;20.8;0.0
19;2021-05-20;1758;896;0;93877;45302;0;44.0;21.2;0.0
19;2021-05-21;1967;873;0;95844;46175;0;44.9;21.6;0.0
19;2021-05-22;1203;631;0;97047;46806;0;45.5;21.9;0.0
19;2021-05-23;292;126;0;97339;46932;0;45.6;22.0;0.0
19;2021-05-24;218;58;0;97557;46990;0;45.7;22.0;0.0
19;2021-05-25;1486;554;0;99043;47544;0;46.4;22.3;0.0
19;2021-05-26;1932;691;0;100975;48235;0;47.3;22.6;0.0
19;2021-05-27;1807;878;0;102782;49113;0;48.2;23.0;0.0
19;2021-05-28;1938;1065;0;104720;50178;0;49.1;23.5;0.0
19;2021-05-29;1345;699;0;106065;50877;0;49.7;23.8;0.0
19;2021-05-30;181;458;0;106246;51335;0;49.8;24.1;0.0
19;2021-05-31;1175;550;0;107421;51885;0;50.3;24.3;0.0
19;2021-06-01;1297;899;0;108718;52784;0;51.0;24.7;0.0
19;2021-06-02;1758;1016;0;110476;53800;0;51.8;25.2;0.0
19;2021-06-03;1498;1172;0;111974;54972;0;52.5;25.8;0.0
19;2021-06-04;1833;1396;0;113807;56368;0;53.3;26.4;0.0
19;2021-06-05;1135;794;0;114942;57162;0;53.9;26.8;0.0
19;2021-06-06;102;593;0;115044;57755;0;53.9;27.1;0.0
19;2021-06-07;918;1012;0;115962;58767;0;54.4;27.5;0.0
19;2021-06-08;1103;962;0;117065;59729;0;54.9;28.0;0.0
19;2021-06-09;1245;1461;0;118310;61190;0;55.5;28.7;0.0
19;2021-06-10;1258;1533;0;119568;62723;0;56.0;29.4;0.0
19;2021-06-11;1279;1954;0;120847;64677;0;56.6;30.3;0.0
19;2021-06-12;1255;1298;0;122102;65975;0;57.2;30.9;0.0
19;2021-06-13;472;418;0;122574;66393;0;57.5;31.1;0.0
19;2021-06-14;687;1149;0;123261;67542;0;57.8;31.7;0.0
19;2021-06-15;943;1289;0;124204;68831;0;58.2;32.3;0.0
19;2021-06-16;1162;1513;0;125366;70344;0;58.8;33.0;0.0
19;2021-06-17;871;1854;0;126237;72198;0;59.2;33.8;0.0
19;2021-06-18;1011;2159;0;127248;74357;0;59.6;34.9;0.0
19;2021-06-19;845;1390;0;128093;75747;0;60.0;35.5;0.0
19;2021-06-20;341;318;0;128434;76065;0;60.2;35.7;0.0
19;2021-06-21;501;1147;0;128935;77212;0;60.4;36.2;0.0
19;2021-06-22;648;1550;0;129583;78762;0;60.7;36.9;0.0
19;2021-06-23;681;1994;0;130264;80756;0;61.1;37.9;0.0
19;2021-06-24;653;1595;0;130917;82351;0;61.4;38.6;0.0
19;2021-06-25;557;2174;0;131474;84525;0;61.6;39.6;0.0
19;2021-06-26;454;1668;0;131928;86193;0;61.8;40.4;0.0
19;2021-06-27;252;374;0;132180;86567;0;62.0;40.6;0.0
19;2021-06-28;297;1525;0;132477;88092;0;62.1;41.3;0.0
19;2021-06-29;369;1907;0;132846;89999;0;62.3;42.2;0.0
19;2021-06-30;717;2080;0;133563;92079;0;62.6;43.2;0.0
19;2021-07-01;339;2267;0;133902;94346;0;62.8;44.2;0.0
19;2021-07-02;750;2291;0;134652;96637;0;63.1;45.3;0.0
19;2021-07-03;479;1693;0;135131;98330;0;63.3;46.1;0.0
19;2021-07-04;20;65;0;135151;98395;0;63.3;46.1;0.0
19;2021-07-05;585;1047;0;135736;99442;0;63.6;46.6;0.0
19;2021-07-06;470;1540;0;136206;100982;0;63.8;47.3;0.0
19;2021-07-07;611;2126;0;136817;103108;0;64.1;48.3;0.0
19;2021-07-08;722;2105;0;137539;105213;0;64.5;49.3;0.0
19;2021-07-09;682;2608;0;138221;107821;0;64.8;50.5;0.0
19;2021-07-10;528;1644;0;138749;109465;0;65.0;51.3;0.0
19;2021-07-11;60;215;0;138809;109680;0;65.1;51.4;0.0
19;2021-07-12;444;1502;0;139253;111182;0;65.3;52.1;0.0
19;2021-07-13;665;1833;0;139918;113015;0;65.6;53.0;0.0
19;2021-07-14;219;273;0;140137;113288;0;65.7;53.1;0.0
19;2021-07-15;848;1967;0;140985;115255;0;66.1;54.0;0.0
19;2021-07-16;1116;2352;0;142101;117607;0;66.6;55.1;0.0
19;2021-07-17;716;1582;0;142817;119189;0;66.9;55.9;0.0
19;2021-07-18;311;580;0;143128;119769;0;67.1;56.1;0.0
19;2021-07-19;918;1354;0;144046;121123;0;67.5;56.8;0.0
19;2021-07-20;968;1595;0;145014;122718;0;68.0;57.5;0.0
19;2021-07-21;1053;1623;0;146067;124341;0;68.5;58.3;0.0
19;2021-07-22;1334;1718;0;147401;126059;0;69.1;59.1;0.0
19;2021-07-23;1679;1928;0;149080;127987;0;69.9;60.0;0.0
19;2021-07-24;908;1607;0;149988;129594;0;70.3;60.7;0.0
19;2021-07-25;168;457;0;150156;130051;0;70.4;61.0;0.0
19;2021-07-26;905;921;0;151061;130972;0;70.8;61.4;0.0
19;2021-07-27;1369;1047;0;152430;132019;0;71.4;61.9;0.0
19;2021-07-28;1928;1174;0;154358;133193;0;72.3;62.4;0.0
19;2021-07-29;1561;1123;0;155919;134316;0;73.1;63.0;0.0
19;2021-07-30;1831;1034;0;157750;135350;0;73.9;63.4;0.0
19;2021-07-31;1098;964;0;158848;136314;0;74.5;63.9;0.0
19;2021-08-01;344;320;0;159192;136634;0;74.6;64.0;0.0
19;2021-08-02;1056;747;0;160248;137381;0;75.1;64.4;0.0
19;2021-08-03;1389;937;0;161637;138318;0;75.8;64.8;0.0
19;2021-08-04;1674;643;0;163311;138961;0;76.5;65.1;0.0
19;2021-08-05;1415;852;0;164726;139813;0;77.2;65.5;0.0
19;2021-08-06;1786;1138;0;166512;140951;0;78.0;66.1;0.0
19;2021-08-07;1186;895;0;167698;141846;0;78.6;66.5;0.0
19;2021-08-08;184;184;0;167882;142030;0;78.7;66.6;0.0
19;2021-08-09;929;738;0;168811;142768;0;79.1;66.9;0.0
19;2021-08-10;1116;942;0;169927;143710;0;79.6;67.4;0.0
19;2021-08-11;1166;903;0;171093;144613;0;80.2;67.8;0.0
19;2021-08-12;933;1099;0;172026;145712;0;80.6;68.3;0.0
19;2021-08-13;1070;1112;0;173096;146824;0;81.1;68.8;0.0
19;2021-08-14;842;1066;0;173938;147890;0;81.5;69.3;0.0
19;2021-08-15;40;63;0;173978;147953;0;81.5;69.3;0.0
19;2021-08-16;538;963;0;174516;148916;0;81.8;69.8;0.0
19;2021-08-17;554;1120;0;175070;150036;0;82.1;70.3;0.0
19;2021-08-18;567;908;0;175637;150944;0;82.3;70.7;0.0
19;2021-08-19;438;1191;0;176075;152135;0;82.5;71.3;0.0
19;2021-08-20;783;1757;0;176858;153892;0;82.9;72.1;0.0
19;2021-08-21;418;1256;0;177276;155148;0;83.1;72.7;0.0
19;2021-08-22;49;105;0;177325;155253;0;83.1;72.8;0.0
19;2021-08-23;220;1106;0;177545;156359;0;83.2;73.3;0.0
19;2021-08-24;438;1179;0;177983;157538;0;83.4;73.8;0.0
19;2021-08-25;561;1460;0;178544;158998;0;83.7;74.5;0.0
19;2021-08-26;443;1301;0;178987;160299;0;83.9;75.1;0.0
19;2021-08-27;446;1583;0;179433;161882;0;84.1;75.9;0.0
19;2021-08-28;336;1195;0;179769;163077;0;84.3;76.4;0.0
19;2021-08-29;51;170;0;179820;163247;0;84.3;76.5;0.0
19;2021-08-30;226;1067;5;180046;164314;5;84.4;77.0;0.0
19;2021-08-31;315;1257;97;180361;165571;102;84.5;77.6;0.0
19;2021-09-01;364;1333;43;180725;166904;145;84.7;78.2;0.1
19;2021-09-02;342;1087;119;181067;167991;264;84.9;78.7;0.1
19;2021-09-03;378;1372;93;181445;169363;357;85.0;79.4;0.2
19;2021-09-04;270;1249;26;181715;170612;383;85.2;80.0;0.2
19;2021-09-05;25;97;128;181740;170709;511;85.2;80.0;0.2
19;2021-09-06;189;589;69;181929;171298;580;85.3;80.3;0.3
19;2021-09-07;215;680;70;182144;171978;650;85.4;80.6;0.3
19;2021-09-08;266;711;188;182410;172689;838;85.5;80.9;0.4
19;2021-09-09;251;519;95;182661;173208;933;85.6;81.2;0.4
19;2021-09-10;252;697;147;182913;173905;1080;85.7;81.5;0.5
19;2021-09-11;267;947;95;183180;174852;1175;85.9;82.0;0.6
19;2021-09-12;26;48;74;183206;174900;1249;85.9;82.0;0.6
19;2021-09-13;98;249;243;183304;175149;1492;85.9;82.1;0.7
19;2021-09-14;171;339;253;183475;175488;1745;86.0;82.3;0.8
19;2021-09-15;226;558;312;183701;176046;2057;86.1;82.5;1.0
19;2021-09-16;210;355;257;183911;176401;2314;86.2;82.7;1.1
19;2021-09-17;250;521;171;184161;176922;2485;86.3;82.9;1.2
19;2021-09-18;163;625;87;184324;177547;2572;86.4;83.2;1.2
19;2021-09-19;12;23;4;184336;177570;2576;86.4;83.2;1.2
19;2021-09-20;116;211;284;184452;177781;2860;86.5;83.3;1.3
19;2021-09-21;126;266;418;184578;178047;3278;86.5;83.5;1.5
19;2021-09-22;134;363;272;184712;178410;3550;86.6;83.6;1.7
19;2021-09-23;77;275;241;184789;178685;3791;86.6;83.7;1.8
19;2021-09-24;129;331;375;184918;179016;4166;86.7;83.9;2.0
19;2021-09-25;128;507;127;185046;179523;4293;86.7;84.1;2.0
19;2021-09-26;15;24;4;185061;179547;4297;86.7;84.2;2.0
19;2021-09-27;42;201;288;185103;179748;4585;86.8;84.2;2.1
19;2021-09-28;65;197;280;185168;179945;4865;86.8;84.3;2.3
19;2021-09-29;83;334;263;185251;180279;5128;86.8;84.5;2.4
19;2021-09-30;107;277;225;185358;180556;5353;86.9;84.6;2.5
19;2021-10-01;123;233;217;185481;180789;5570;86.9;84.7;2.6
19;2021-10-02;134;301;185;185615;181090;5755;87.0;84.9;2.7
19;2021-10-03;9;12;10;185624;181102;5765;87.0;84.9;2.7
19;2021-10-04;56;118;208;185680;181220;5973;87.0;84.9;2.8
19;2021-10-05;79;159;325;185759;181379;6298;87.1;85.0;3.0
19;2021-10-06;108;235;311;185867;181614;6609;87.1;85.1;3.1
19;2021-10-07;62;229;289;185929;181843;6898;87.1;85.2;3.2
19;2021-10-08;79;235;268;186008;182078;7166;87.2;85.3;3.4
19;2021-10-09;133;244;263;186141;182322;7429;87.2;85.5;3.5
19;2021-10-10;3;8;22;186144;182330;7451;87.2;85.5;3.5
19;2021-10-11;59;148;257;186203;182478;7708;87.3;85.5;3.6
19;2021-10-12;77;159;443;186280;182637;8151;87.3;85.6;3.8
19;2021-10-13;104;184;325;186384;182821;8476;87.4;85.7;4.0
19;2021-10-14;71;98;349;186455;182919;8825;87.4;85.7;4.1
19;2021-10-15;96;152;278;186551;183071;9103;87.4;85.8;4.3
19;2021-10-16;121;220;272;186672;183291;9375;87.5;85.9;4.4
19;2021-10-17;0;21;1;186672;183312;9376;87.5;85.9;4.4
19;2021-10-18;45;73;309;186717;183385;9685;87.5;86.0;4.5
19;2021-10-19;62;79;418;186779;183464;10103;87.5;86.0;4.7
19;2021-10-20;60;141;463;186839;183605;10566;87.6;86.1;5.0
19;2021-10-21;60;105;435;186899;183710;11001;87.6;86.1;5.2
19;2021-10-22;91;111;366;186990;183821;11367;87.6;86.2;5.3
19;2021-10-23;98;186;443;187088;184007;11810;87.7;86.2;5.5
19;2021-10-24;2;13;9;187090;184020;11819;87.7;86.3;5.5
19;2021-10-25;46;70;381;187136;184090;12200;87.7;86.3;5.7
19;2021-10-26;53;66;479;187189;184156;12679;87.7;86.3;5.9
19;2021-10-27;49;84;520;187238;184240;13199;87.8;86.4;6.2
19;2021-10-28;61;90;523;187299;184330;13722;87.8;86.4;6.4
19;2021-10-29;59;95;360;187358;184425;14082;87.8;86.4;6.6
19;2021-10-30;76;125;425;187434;184550;14507;87.9;86.5;6.8
19;2021-10-31;5;5;32;187439;184555;14539;87.9;86.5;6.8
19;2021-11-01;3;2;8;187442;184557;14547;87.9;86.5;6.8
19;2021-11-02;58;76;589;187500;184633;15136;87.9;86.5;7.1
19;2021-11-03;54;98;531;187554;184731;15667;87.9;86.6;7.3
19;2021-11-04;54;63;522;187608;184794;16189;87.9;86.6;7.6
19;2021-11-05;62;101;519;187670;184895;16708;88.0;86.7;7.8
19;2021-11-06;94;123;470;187764;185018;17178;88.0;86.7;8.1
19;2021-11-07;2;3;11;187766;185021;17189;88.0;86.7;8.1
19;2021-11-08;38;70;481;187804;185091;17670;88.0;86.8;8.3
19;2021-11-09;48;92;885;187852;185183;18555;88.0;86.8;8.7
19;2021-11-10;63;83;741;187915;185266;19296;88.1;86.8;9.0
19;2021-11-11;3;1;13;187918;185267;19309;88.1;86.8;9.1
19;2021-11-12;63;76;579;187981;185343;19888;88.1;86.9;9.3
19;2021-11-13;51;70;488;188032;185413;20376;88.1;86.9;9.6
19;2021-11-14;13;3;39;188045;185416;20415;88.1;86.9;9.6
19;2021-11-15;33;56;544;188078;185472;20959;88.2;86.9;9.8
19;2021-11-16;43;51;1042;188121;185523;22001;88.2;87.0;10.3
19;2021-11-17;57;69;843;188178;185592;22844;88.2;87.0;10.7
19;2021-11-18;51;65;691;188229;185657;23535;88.2;87.0;11.0
19;2021-11-19;89;94;995;188318;185751;24530;88.3;87.1;11.5
19;2021-11-20;80;109;691;188398;185860;25221;88.3;87.1;11.8
19;2021-11-21;10;7;52;188408;185867;25273;88.3;87.1;11.8
19;2021-11-22;48;31;734;188456;185898;26007;88.3;87.1;12.2
19;2021-11-23;73;66;1235;188529;185964;27242;88.4;87.2;12.8
19;2021-11-24;72;70;953;188601;186034;28195;88.4;87.2;13.2
19;2021-11-25;69;58;1018;188670;186092;29213;88.4;87.2;13.7
19;2021-11-26;94;60;1257;188764;186152;30470;88.5;87.2;14.3
19;2021-11-27;90;106;1323;188854;186258;31793;88.5;87.3;14.9
19;2021-11-28;31;17;813;188885;186275;32606;88.5;87.3;15.3
19;2021-11-29;29;28;1105;188914;186303;33711;88.5;87.3;15.8
19;2021-11-30;62;68;1825;188976;186371;35536;88.6;87.4;16.7
19;2021-12-01;33;42;1350;189009;186413;36886;88.6;87.4;17.3
19;2021-12-02;37;30;2122;189046;186443;39008;88.6;87.4;18.3
19;2021-12-03;75;86;2169;189121;186529;41177;88.6;87.4;19.3
19;2021-12-04;44;73;1664;189165;186602;42841;88.7;87.5;20.1
19;2021-12-05;8;12;314;189173;186614;43155;88.7;87.5;20.2
19;2021-12-06;32;34;1502;189205;186648;44657;88.7;87.5;20.9
19;2021-12-07;47;46;2293;189252;186694;46950;88.7;87.5;22.0
19;2021-12-08;47;64;1954;189299;186758;48904;88.7;87.5;22.9
19;2021-12-09;44;59;2163;189343;186817;51067;88.7;87.6;23.9
19;2021-12-10;65;83;2849;189408;186900;53916;88.8;87.6;25.3
19;2021-12-11;35;80;2087;189443;186980;56003;88.8;87.6;26.2
19;2021-12-12;12;10;688;189455;186990;56691;88.8;87.6;26.6
19;2021-12-13;32;58;2037;189487;187048;58728;88.8;87.7;27.5
19;2021-12-14;70;75;3305;189557;187123;62033;88.8;87.7;29.1
19;2021-12-15;60;81;2901;189617;187204;64934;88.9;87.7;30.4
19;2021-12-16;68;81;3379;189685;187285;68313;88.9;87.8;32.0
19;2021-12-17;62;114;3064;189747;187399;71377;88.9;87.8;33.5
19;2021-12-18;73;96;2764;189820;187495;74141;89.0;87.9;34.7
19;2021-12-19;45;30;1334;189865;187525;75475;89.0;87.9;35.4
21;2020-12-27;4;0;0;4;0;0;0.0;0.0;0.0
21;2020-12-28;1;0;0;5;0;0;0.0;0.0;0.0
21;2020-12-29;18;0;0;23;0;0;0.0;0.0;0.0
21;2020-12-30;21;0;0;44;0;0;0.0;0.0;0.0
21;2020-12-31;0;0;0;44;0;0;0.0;0.0;0.0
21;2021-01-01;0;0;0;44;0;0;0.0;0.0;0.0
21;2021-01-02;1;0;0;45;0;0;0.0;0.0;0.0
21;2021-01-03;0;0;0;45;0;0;0.0;0.0;0.0
21;2021-01-04;19;0;0;64;0;0;0.0;0.0;0.0
21;2021-01-05;239;1;0;303;1;0;0.1;0.0;0.0
21;2021-01-06;299;0;0;602;1;0;0.1;0.0;0.0
21;2021-01-07;368;0;0;970;1;0;0.2;0.0;0.0
21;2021-01-08;460;2;0;1430;3;0;0.3;0.0;0.0
21;2021-01-09;248;0;0;1678;3;0;0.4;0.0;0.0
21;2021-01-10;2;0;0;1680;3;0;0.4;0.0;0.0
21;2021-01-11;627;1;0;2307;4;0;0.5;0.0;0.0
21;2021-01-12;637;0;0;2944;4;0;0.6;0.0;0.0
21;2021-01-13;692;1;0;3636;5;0;0.8;0.0;0.0
21;2021-01-14;1138;8;0;4774;13;0;1.0;0.0;0.0
21;2021-01-15;696;4;0;5470;17;0;1.2;0.0;0.0
21;2021-01-16;156;2;0;5626;19;0;1.2;0.0;0.0
21;2021-01-17;5;0;0;5631;19;0;1.2;0.0;0.0
21;2021-01-18;1261;6;0;6892;25;0;1.5;0.0;0.0
21;2021-01-19;1244;4;0;8136;29;0;1.7;0.0;0.0
21;2021-01-20;1202;48;0;9338;77;0;2.0;0.0;0.0
21;2021-01-21;1494;8;0;10832;85;0;2.3;0.0;0.0
21;2021-01-22;1241;5;0;12073;90;0;2.6;0.0;0.0
21;2021-01-23;482;0;0;12555;90;0;2.7;0.0;0.0
21;2021-01-24;125;0;0;12680;90;0;2.7;0.0;0.0
21;2021-01-25;907;17;0;13587;107;0;2.9;0.0;0.0
21;2021-01-26;1476;142;0;15063;249;0;3.2;0.1;0.0
21;2021-01-27;1971;159;0;17034;408;0;3.7;0.1;0.0
21;2021-01-28;1458;230;0;18492;638;0;4.0;0.1;0.0
21;2021-01-29;1047;225;0;19539;863;0;4.2;0.2;0.0
21;2021-01-30;480;38;0;20019;901;0;4.3;0.2;0.0
21;2021-01-31;93;4;0;20112;905;0;4.3;0.2;0.0
21;2021-02-01;470;297;0;20582;1202;0;4.4;0.3;0.0
21;2021-02-02;448;370;0;21030;1572;0;4.5;0.3;0.0
21;2021-02-03;497;291;0;21527;1863;0;4.6;0.4;0.0
21;2021-02-04;437;526;0;21964;2389;0;4.7;0.5;0.0
21;2021-02-05;544;514;0;22508;2903;0;4.8;0.6;0.0
21;2021-02-06;159;216;0;22667;3119;0;4.9;0.7;0.0
21;2021-02-07;1;4;0;22668;3123;0;4.9;0.7;0.0
21;2021-02-08;428;398;0;23096;3521;0;5.0;0.8;0.0
21;2021-02-09;514;542;0;23610;4063;0;5.1;0.9;0.0
21;2021-02-10;468;590;0;24078;4653;0;5.2;1.0;0.0
21;2021-02-11;484;732;0;24562;5385;0;5.3;1.2;0.0
21;2021-02-12;391;951;0;24953;6336;0;5.4;1.4;0.0
21;2021-02-13;337;299;0;25290;6635;0;5.4;1.4;0.0
21;2021-02-14;218;152;0;25508;6787;0;5.5;1.5;0.0
21;2021-02-15;129;1344;0;25637;8131;0;5.5;1.7;0.0
21;2021-02-16;219;1493;0;25856;9624;0;5.6;2.1;0.0
21;2021-02-17;381;1923;0;26237;11547;0;5.6;2.5;0.0
21;2021-02-18;576;1316;0;26813;12863;0;5.8;2.8;0.0
21;2021-02-19;216;1084;0;27029;13947;0;5.8;3.0;0.0
21;2021-02-20;120;382;0;27149;14329;0;5.8;3.1;0.0
21;2021-02-21;0;73;0;27149;14402;0;5.8;3.1;0.0
21;2021-02-22;92;782;0;27241;15184;0;5.9;3.3;0.0
21;2021-02-23;179;1006;0;27420;16190;0;5.9;3.5;0.0
21;2021-02-24;212;738;0;27632;16928;0;5.9;3.6;0.0
21;2021-02-25;637;828;0;28269;17756;0;6.1;3.8;0.0
21;2021-02-26;926;710;0;29195;18466;0;6.3;4.0;0.0
21;2021-02-27;520;305;0;29715;18771;0;6.4;4.0;0.0
21;2021-02-28;24;99;0;29739;18870;0;6.4;4.1;0.0
21;2021-03-01;693;613;0;30432;19483;0;6.5;4.2;0.0
21;2021-03-02;1076;540;0;31508;20023;0;6.8;4.3;0.0
21;2021-03-03;1124;457;0;32632;20480;0;7.0;4.4;0.0
21;2021-03-04;1638;516;0;34270;20996;0;7.4;4.5;0.0
21;2021-03-05;2172;660;0;36442;21656;0;7.8;4.7;0.0
21;2021-03-06;1577;208;0;38019;21864;0;8.2;4.7;0.0
21;2021-03-07;36;24;0;38055;21888;0;8.2;4.7;0.0
21;2021-03-08;746;449;0;38801;22337;0;8.3;4.8;0.0
21;2021-03-09;1571;571;0;40372;22908;0;8.7;4.9;0.0
21;2021-03-10;1629;562;0;42001;23470;0;9.0;5.0;0.0
21;2021-03-11;2155;697;0;44156;24167;0;9.5;5.2;0.0
21;2021-03-12;2861;457;0;47017;24624;0;10.1;5.3;0.0
21;2021-03-13;1908;193;0;48925;24817;0;10.5;5.3;0.0
21;2021-03-14;46;47;0;48971;24864;0;10.5;5.3;0.0
21;2021-03-15;1401;94;0;50372;24958;0;10.8;5.4;0.0
21;2021-03-16;1784;158;0;52156;25116;0;11.2;5.4;0.0
21;2021-03-17;1727;123;0;53883;25239;0;11.6;5.4;0.0
21;2021-03-18;2024;272;0;55907;25511;0;12.0;5.5;0.0
21;2021-03-19;1912;152;0;57819;25663;0;12.4;5.5;0.0
21;2021-03-20;1215;41;0;59034;25704;0;12.7;5.5;0.0
21;2021-03-21;6;0;0;59040;25704;0;12.7;5.5;0.0
21;2021-03-22;1517;95;0;60557;25799;0;13.0;5.5;0.0
21;2021-03-23;2624;119;0;63181;25918;0;13.6;5.6;0.0
21;2021-03-24;2797;156;0;65978;26074;0;14.2;5.6;0.0
21;2021-03-25;3641;254;0;69619;26328;0;15.0;5.7;0.0
21;2021-03-26;3614;207;0;73233;26535;0;15.7;5.7;0.0
21;2021-03-27;1637;65;0;74870;26600;0;16.1;5.7;0.0
21;2021-03-28;204;37;0;75074;26637;0;16.1;5.7;0.0
21;2021-03-29;1737;531;0;76811;27168;0;16.5;5.8;0.0
21;2021-03-30;2271;788;0;79082;27956;0;17.0;6.0;0.0
21;2021-03-31;2671;660;0;81753;28616;0;17.6;6.1;0.0
21;2021-04-01;2636;728;0;84389;29344;0;18.1;6.3;0.0
21;2021-04-02;2247;755;0;86636;30099;0;18.6;6.5;0.0
21;2021-04-03;988;280;0;87624;30379;0;18.8;6.5;0.0
21;2021-04-04;4;16;0;87628;30395;0;18.8;6.5;0.0
21;2021-04-05;20;1;0;87648;30396;0;18.8;6.5;0.0
21;2021-04-06;1324;1138;0;88972;31534;0;19.1;6.8;0.0
21;2021-04-07;1696;968;0;90668;32502;0;19.5;7.0;0.0
21;2021-04-08;3108;1112;0;93776;33614;0;20.1;7.2;0.0
21;2021-04-09;3357;1177;0;97133;34791;0;20.9;7.5;0.0
21;2021-04-10;1336;739;0;98469;35530;0;21.2;7.6;0.0
21;2021-04-11;141;9;0;98610;35539;0;21.2;7.6;0.0
21;2021-04-12;1144;1339;0;99754;36878;0;21.4;7.9;0.0
21;2021-04-13;1691;1717;0;101445;38595;0;21.8;8.3;0.0
21;2021-04-14;1489;1437;0;102934;40032;0;22.1;8.6;0.0
21;2021-04-15;1945;1545;0;104879;41577;0;22.5;8.9;0.0
21;2021-04-16;2337;1264;0;107216;42841;0;23.0;9.2;0.0
21;2021-04-17;1048;977;0;108264;43818;0;23.3;9.4;0.0
21;2021-04-18;27;11;0;108291;43829;0;23.3;9.4;0.0
21;2021-04-19;1140;1328;0;109431;45157;0;23.5;9.7;0.0
21;2021-04-20;1274;1781;0;110705;46938;0;23.8;10.1;0.0
21;2021-04-21;1157;1694;0;111862;48632;0;24.0;10.4;0.0
21;2021-04-22;1314;2148;0;113176;50780;0;24.3;10.9;0.0
21;2021-04-23;2037;1751;0;115213;52531;0;24.7;11.3;0.0
21;2021-04-24;1010;838;0;116223;53369;0;25.0;11.5;0.0
21;2021-04-25;21;164;0;116244;53533;0;25.0;11.5;0.0
21;2021-04-26;1120;1569;0;117364;55102;0;25.2;11.8;0.0
21;2021-04-27;1921;1899;0;119285;57001;0;25.6;12.2;0.0
21;2021-04-28;2383;2202;0;121668;59203;0;26.1;12.7;0.0
21;2021-04-29;3297;2264;0;124965;61467;0;26.8;13.2;0.0
21;2021-04-30;3663;1839;0;128628;63306;0;27.6;13.6;0.0
21;2021-05-01;1016;233;0;129644;63539;0;27.8;13.6;0.0
21;2021-05-02;21;10;0;129665;63549;0;27.9;13.7;0.0
21;2021-05-03;2182;1277;0;131847;64826;0;28.3;13.9;0.0
21;2021-05-04;2665;1605;0;134512;66431;0;28.9;14.3;0.0
21;2021-05-05;2499;1711;0;137011;68142;0;29.4;14.6;0.0
21;2021-05-06;3188;2253;0;140199;70395;0;30.1;15.1;0.0
21;2021-05-07;2915;2118;0;143114;72513;0;30.7;15.6;0.0
21;2021-05-08;1166;277;0;144280;72790;0;31.0;15.6;0.0
21;2021-05-09;58;171;0;144338;72961;0;31.0;15.7;0.0
21;2021-05-10;3178;1732;0;147516;74693;0;31.7;16.0;0.0
21;2021-05-11;4828;2037;0;152344;76730;0;32.7;16.5;0.0
21;2021-05-12;4830;1772;0;157174;78502;0;33.8;16.9;0.0
21;2021-05-13;3755;377;0;160929;78879;0;34.6;16.9;0.0
21;2021-05-14;5114;1511;0;166043;80390;0;35.7;17.3;0.0
21;2021-05-15;3453;673;0;169496;81063;0;36.4;17.4;0.0
21;2021-05-16;88;13;0;169584;81076;0;36.4;17.4;0.0
21;2021-05-17;3997;1249;0;173581;82325;0;37.3;17.7;0.0
21;2021-05-18;4251;1540;0;177832;83865;0;38.2;18.0;0.0
21;2021-05-19;3525;1121;0;181357;84986;0;39.0;18.3;0.0
21;2021-05-20;3944;1374;0;185301;86360;0;39.8;18.6;0.0
21;2021-05-21;3712;2131;0;189013;88491;0;40.6;19.0;0.0
21;2021-05-22;1635;749;0;190648;89240;0;41.0;19.2;0.0
21;2021-05-23;54;33;0;190702;89273;0;41.0;19.2;0.0
21;2021-05-24;1717;256;0;192419;89529;0;41.3;19.2;0.0
21;2021-05-25;2688;2013;0;195107;91542;0;41.9;19.7;0.0
21;2021-05-26;2640;2034;0;197747;93576;0;42.5;20.1;0.0
21;2021-05-27;3933;2137;0;201680;95713;0;43.3;20.6;0.0
21;2021-05-28;3535;2819;0;205215;98532;0;44.1;21.2;0.0
21;2021-05-29;1909;1429;0;207124;99961;0;44.5;21.5;0.0
21;2021-05-30;132;29;0;207256;99990;0;44.5;21.5;0.0
21;2021-05-31;2501;1780;0;209757;101770;0;45.1;21.9;0.0
21;2021-06-01;3381;2248;0;213138;104018;0;45.8;22.3;0.0
21;2021-06-02;2831;1830;0;215969;105848;0;46.4;22.7;0.0
21;2021-06-03;3289;2074;0;219258;107922;0;47.1;23.2;0.0
21;2021-06-04;3447;2673;0;222705;110595;0;47.8;23.8;0.0
21;2021-06-05;2837;1638;0;225542;112233;0;48.4;24.1;0.0
21;2021-06-06;101;98;0;225643;112331;0;48.5;24.1;0.0
21;2021-06-07;4213;1502;0;229856;113833;0;49.4;24.5;0.0
21;2021-06-08;4675;2252;0;234531;116085;0;50.4;24.9;0.0
21;2021-06-09;4467;1788;0;238998;117873;0;51.3;25.3;0.0
21;2021-06-10;3848;2603;0;242846;120476;0;52.2;25.9;0.0
21;2021-06-11;4149;3180;0;246995;123656;0;53.1;26.6;0.0
21;2021-06-12;2120;1653;0;249115;125309;0;53.5;26.9;0.0
21;2021-06-13;72;26;0;249187;125335;0;53.5;26.9;0.0
21;2021-06-14;2221;2678;0;251408;128013;0;54.0;27.5;0.0
21;2021-06-15;2919;3165;0;254327;131178;0;54.6;28.2;0.0
21;2021-06-16;2908;2815;0;257235;133993;0;55.3;28.8;0.0
21;2021-06-17;3315;3111;0;260550;137104;0;56.0;29.5;0.0
21;2021-06-18;2483;3868;0;263033;140972;0;56.5;30.3;0.0
21;2021-06-19;1978;1887;0;265011;142859;0;56.9;30.7;0.0
21;2021-06-20;42;37;0;265053;142896;0;56.9;30.7;0.0
21;2021-06-21;1802;3537;0;266855;146433;0;57.3;31.5;0.0
21;2021-06-22;1841;5811;0;268696;152244;0;57.7;32.7;0.0
21;2021-06-23;1998;5048;0;270694;157292;0;58.1;33.8;0.0
21;2021-06-24;2314;4631;0;273008;161923;0;58.6;34.8;0.0
21;2021-06-25;1511;5865;0;274519;167788;0;59.0;36.0;0.0
21;2021-06-26;1352;3836;0;275871;171624;0;59.3;36.9;0.0
21;2021-06-27;30;160;0;275901;171784;0;59.3;36.9;0.0
21;2021-06-28;1351;4078;0;277252;175862;0;59.6;37.8;0.0
21;2021-06-29;1571;4257;0;278823;180119;0;59.9;38.7;0.0
21;2021-06-30;1573;3507;0;280396;183626;0;60.2;39.4;0.0
21;2021-07-01;1718;4217;0;282114;187843;0;60.6;40.4;0.0
21;2021-07-02;2227;4206;0;284341;192049;0;61.1;41.3;0.0
21;2021-07-03;1095;2022;0;285436;194071;0;61.3;41.7;0.0
21;2021-07-04;57;97;0;285493;194168;0;61.3;41.7;0.0
21;2021-07-05;1582;3659;0;287075;197827;0;61.7;42.5;0.0
21;2021-07-06;1394;3649;0;288469;201476;0;62.0;43.3;0.0
21;2021-07-07;1531;3346;0;290000;204822;0;62.3;44.0;0.0
21;2021-07-08;1892;4097;0;291892;208919;0;62.7;44.9;0.0
21;2021-07-09;2047;4401;0;293939;213320;0;63.1;45.8;0.0
21;2021-07-10;1063;2547;0;295002;215867;0;63.4;46.4;0.0
21;2021-07-11;53;122;0;295055;215989;0;63.4;46.4;0.0
21;2021-07-12;1632;3789;0;296687;219778;0;63.7;47.2;0.0
21;2021-07-13;2307;4995;0;298994;224773;0;64.2;48.3;0.0
21;2021-07-14;2615;1946;0;301609;226719;0;64.8;48.7;0.0
21;2021-07-15;3733;4668;0;305342;231387;0;65.6;49.7;0.0
21;2021-07-16;3808;5197;0;309150;236584;0;66.4;50.8;0.0
21;2021-07-17;2560;3986;0;311710;240570;0;67.0;51.7;0.0
21;2021-07-18;213;140;0;311923;240710;0;67.0;51.7;0.0
21;2021-07-19;2294;4729;0;314217;245439;0;67.5;52.7;0.0
21;2021-07-20;2770;5434;0;316987;250873;0;68.1;53.9;0.0
21;2021-07-21;2900;4806;0;319887;255679;0;68.7;54.9;0.0
21;2021-07-22;3066;4729;0;322953;260408;0;69.4;55.9;0.0
21;2021-07-23;4110;4932;0;327063;265340;0;70.3;57.0;0.0
21;2021-07-24;2930;2892;0;329993;268232;0;70.9;57.6;0.0
21;2021-07-25;127;103;0;330120;268335;0;70.9;57.6;0.0
21;2021-07-26;2651;3630;0;332771;271965;0;71.5;58.4;0.0
21;2021-07-27;3439;3874;0;336210;275839;0;72.2;59.3;0.0
21;2021-07-28;3639;3396;0;339849;279235;0;73.0;60.0;0.0
21;2021-07-29;4074;3391;1;343923;282626;1;73.9;60.7;0.0
21;2021-07-30;4339;3387;0;348262;286013;1;74.8;61.4;0.0
21;2021-07-31;3217;2331;0;351479;288344;1;75.5;61.9;0.0
21;2021-08-01;351;100;0;351830;288444;1;75.6;62.0;0.0
21;2021-08-02;2590;3152;0;354420;291596;1;76.1;62.6;0.0
21;2021-08-03;2668;2761;0;357088;294357;1;76.7;63.2;0.0
21;2021-08-04;2362;2435;0;359450;296792;1;77.2;63.8;0.0
21;2021-08-05;2216;3079;0;361666;299871;1;77.7;64.4;0.0
21;2021-08-06;2583;3387;0;364249;303258;1;78.2;65.1;0.0
21;2021-08-07;1852;2564;0;366101;305822;1;78.6;65.7;0.0
21;2021-08-08;120;130;0;366221;305952;1;78.7;65.7;0.0
21;2021-08-09;1641;2910;0;367862;308862;1;79.0;66.3;0.0
21;2021-08-10;1451;2757;0;369313;311619;1;79.3;66.9;0.0
21;2021-08-11;1695;2476;0;371008;314095;1;79.7;67.5;0.0
21;2021-08-12;1274;2504;0;372282;316599;1;80.0;68.0;0.0
21;2021-08-13;1495;2825;0;373777;319424;1;80.3;68.6;0.0
21;2021-08-14;871;2420;0;374648;321844;1;80.5;69.1;0.0
21;2021-08-15;69;104;0;374717;321948;1;80.5;69.2;0.0
21;2021-08-16;1242;2769;0;375959;324717;1;80.8;69.8;0.0
21;2021-08-17;1203;2810;0;377162;327527;1;81.0;70.4;0.0
21;2021-08-18;1042;2898;0;378204;330425;1;81.2;71.0;0.0
21;2021-08-19;969;3042;0;379173;333467;1;81.5;71.6;0.0
21;2021-08-20;1036;4057;0;380209;337524;1;81.7;72.5;0.0
21;2021-08-21;786;3017;0;380995;340541;1;81.8;73.2;0.0
21;2021-08-22;37;147;0;381032;340688;1;81.9;73.2;0.0
21;2021-08-23;876;3267;0;381908;343955;1;82.0;73.9;0.0
21;2021-08-24;981;2986;0;382889;346941;1;82.3;74.5;0.0
21;2021-08-25;848;2634;0;383737;349575;1;82.4;75.1;0.0
21;2021-08-26;712;2504;0;384449;352079;1;82.6;75.6;0.0
21;2021-08-27;1022;3485;0;385471;355564;1;82.8;76.4;0.0
21;2021-08-28;685;2774;0;386156;358338;1;83.0;77.0;0.0
21;2021-08-29;52;233;0;386208;358571;1;83.0;77.0;0.0
21;2021-08-30;786;2229;57;386994;360800;58;83.1;77.5;0.0
21;2021-08-31;911;1989;117;387905;362789;175;83.3;77.9;0.0
21;2021-09-01;693;1642;185;388598;364431;360;83.5;78.3;0.1
21;2021-09-02;524;1316;267;389122;365747;627;83.6;78.6;0.1
21;2021-09-03;761;1851;325;389883;367598;952;83.8;79.0;0.2
21;2021-09-04;735;1452;234;390618;369050;1186;83.9;79.3;0.3
21;2021-09-05;71;73;27;390689;369123;1213;83.9;79.3;0.3
21;2021-09-06;397;1243;245;391086;370366;1458;84.0;79.6;0.3
21;2021-09-07;370;1006;282;391456;371372;1740;84.1;79.8;0.4
21;2021-09-08;556;1267;329;392012;372639;2069;84.2;80.0;0.4
21;2021-09-09;419;905;452;392431;373544;2521;84.3;80.2;0.5
21;2021-09-10;606;1351;414;393037;374895;2935;84.4;80.5;0.6
21;2021-09-11;437;1247;171;393474;376142;3106;84.5;80.8;0.7
21;2021-09-12;28;37;3;393502;376179;3109;84.5;80.8;0.7
21;2021-09-13;233;666;248;393735;376845;3357;84.6;81.0;0.7
21;2021-09-14;448;942;462;394183;377787;3819;84.7;81.2;0.8
21;2021-09-15;450;905;612;394633;378692;4431;84.8;81.3;1.0
21;2021-09-16;339;749;524;394972;379441;4955;84.8;81.5;1.1
21;2021-09-17;527;1025;484;395499;380466;5439;85.0;81.7;1.2
21;2021-09-18;304;947;189;395803;381413;5628;85.0;81.9;1.2
21;2021-09-19;9;35;2;395812;381448;5630;85.0;81.9;1.2
21;2021-09-20;215;578;270;396027;382026;5900;85.1;82.1;1.3
21;2021-09-21;363;654;568;396390;382680;6468;85.2;82.2;1.4
21;2021-09-22;319;906;430;396709;383586;6898;85.2;82.4;1.5
21;2021-09-23;271;468;458;396980;384054;7356;85.3;82.5;1.6
21;2021-09-24;331;780;660;397311;384834;8016;85.3;82.7;1.7
21;2021-09-25;186;839;215;397497;385673;8231;85.4;82.8;1.8
21;2021-09-26;9;33;7;397506;385706;8238;85.4;82.9;1.8
21;2021-09-27;207;426;487;397713;386132;8725;85.4;82.9;1.9
21;2021-09-28;205;451;600;397918;386583;9325;85.5;83.0;2.0
21;2021-09-29;233;507;428;398151;387090;9753;85.5;83.2;2.1
21;2021-09-30;255;404;653;398406;387494;10406;85.6;83.2;2.2
21;2021-10-01;438;782;804;398844;388276;11210;85.7;83.4;2.4
21;2021-10-02;230;554;195;399074;388830;11405;85.7;83.5;2.4
21;2021-10-03;7;26;7;399081;388856;11412;85.7;83.5;2.5
21;2021-10-04;205;292;386;399286;389148;11798;85.8;83.6;2.5
21;2021-10-05;157;414;593;399443;389562;12391;85.8;83.7;2.7
21;2021-10-06;228;487;591;399671;390049;12982;85.9;83.8;2.8
21;2021-10-07;141;323;530;399812;390372;13512;85.9;83.9;2.9
21;2021-10-08;372;687;995;400184;391059;14507;86.0;84.0;3.1
21;2021-10-09;242;422;491;400426;391481;14998;86.0;84.1;3.2
21;2021-10-10;12;22;6;400438;391503;15004;86.0;84.1;3.2
21;2021-10-11;129;280;437;400567;391783;15441;86.0;84.2;3.3
21;2021-10-12;166;395;707;400733;392178;16148;86.1;84.2;3.5
21;2021-10-13;222;383;722;400955;392561;16870;86.1;84.3;3.6
21;2021-10-14;169;333;608;401124;392894;17478;86.2;84.4;3.8
21;2021-10-15;276;449;1008;401400;393343;18486;86.2;84.5;4.0
21;2021-10-16;195;282;480;401595;393625;18966;86.3;84.6;4.1
21;2021-10-17;6;14;5;401601;393639;18971;86.3;84.6;4.1
21;2021-10-18;114;234;578;401715;393873;19549;86.3;84.6;4.2
21;2021-10-19;113;258;600;401828;394131;20149;86.3;84.7;4.3
21;2021-10-20;253;295;854;402081;394426;21003;86.4;84.7;4.5
21;2021-10-21;122;257;653;402203;394683;21656;86.4;84.8;4.7
21;2021-10-22;269;420;1100;402472;395103;22756;86.5;84.9;4.9
21;2021-10-23;163;244;393;402635;395347;23149;86.5;84.9;5.0
21;2021-10-24;17;14;33;402652;395361;23182;86.5;84.9;5.0
21;2021-10-25;169;228;627;402821;395589;23809;86.5;85.0;5.1
21;2021-10-26;124;145;690;402945;395734;24499;86.6;85.0;5.3
21;2021-10-27;207;269;1215;403152;396003;25714;86.6;85.1;5.5
21;2021-10-28;132;172;747;403284;396175;26461;86.6;85.1;5.7
21;2021-10-29;188;302;1349;403472;396477;27810;86.7;85.2;6.0
21;2021-10-30;112;184;383;403584;396661;28193;86.7;85.2;6.1
21;2021-10-31;2;10;13;403586;396671;28206;86.7;85.2;6.1
21;2021-11-01;13;20;1;403599;396691;28207;86.7;85.2;6.1
21;2021-11-02;143;206;776;403742;396897;28983;86.7;85.3;6.2
21;2021-11-03;174;265;1162;403916;397162;30145;86.8;85.3;6.5
21;2021-11-04;125;143;935;404041;397305;31080;86.8;85.3;6.7
21;2021-11-05;209;328;1608;404250;397633;32688;86.8;85.4;7.0
21;2021-11-06;135;241;808;404385;397874;33496;86.9;85.5;7.2
21;2021-11-07;4;4;1;404389;397878;33497;86.9;85.5;7.2
21;2021-11-08;130;170;1264;404519;398048;34761;86.9;85.5;7.5
21;2021-11-09;114;163;1524;404633;398211;36285;86.9;85.5;7.8
21;2021-11-10;193;275;1864;404826;398486;38149;87.0;85.6;8.2
21;2021-11-11;12;16;38;404838;398502;38187;87.0;85.6;8.2
21;2021-11-12;216;276;1878;405054;398778;40065;87.0;85.7;8.6
21;2021-11-13;134;172;564;405188;398950;40629;87.0;85.7;8.7
21;2021-11-14;2;13;14;405190;398963;40643;87.0;85.7;8.7
21;2021-11-15;115;130;1434;405305;399093;42077;87.1;85.7;9.0
21;2021-11-16;104;151;1546;405409;399244;43623;87.1;85.8;9.4
21;2021-11-17;210;252;1898;405619;399496;45521;87.1;85.8;9.8
21;2021-11-18;126;173;1468;405745;399669;46989;87.2;85.9;10.1
21;2021-11-19;225;305;2476;405970;399974;49465;87.2;85.9;10.6
21;2021-11-20;172;210;809;406142;400184;50274;87.2;86.0;10.8
21;2021-11-21;12;7;8;406154;400191;50282;87.2;86.0;10.8
21;2021-11-22;126;117;1621;406280;400308;51903;87.3;86.0;11.1
21;2021-11-23;108;113;1915;406388;400421;53818;87.3;86.0;11.6
21;2021-11-24;234;245;2321;406622;400666;56139;87.3;86.1;12.1
21;2021-11-25;120;133;2227;406742;400799;58366;87.4;86.1;12.5
21;2021-11-26;257;257;4713;406999;401056;63079;87.4;86.2;13.6
21;2021-11-27;169;170;2626;407168;401226;65705;87.5;86.2;14.1
21;2021-11-28;7;5;261;407175;401231;65966;87.5;86.2;14.2
21;2021-11-29;100;113;3976;407275;401344;69942;87.5;86.2;15.0
21;2021-11-30;135;137;4630;407410;401481;74572;87.5;86.2;16.0
21;2021-12-01;168;203;5055;407578;401684;79627;87.6;86.3;17.1
21;2021-12-02;93;135;4949;407671;401819;84576;87.6;86.3;18.2
21;2021-12-03;187;219;6166;407858;402038;90742;87.6;86.4;19.5
21;2021-12-04;150;188;3457;408008;402226;94199;87.6;86.4;20.2
21;2021-12-05;25;7;635;408033;402233;94834;87.7;86.4;20.4
21;2021-12-06;78;147;4579;408111;402380;99413;87.7;86.4;21.4
21;2021-12-07;145;164;6000;408256;402544;105413;87.7;86.5;22.6
21;2021-12-08;140;201;5515;408396;402745;110928;87.7;86.5;23.8
21;2021-12-09;139;137;5519;408535;402882;116447;87.8;86.5;25.0
21;2021-12-10;171;225;6775;408706;403107;123222;87.8;86.6;26.5
21;2021-12-11;111;169;4028;408817;403276;127250;87.8;86.6;27.3
21;2021-12-12;34;26;685;408851;403302;127935;87.8;86.6;27.5
21;2021-12-13;124;153;4908;408975;403455;132843;87.9;86.7;28.5
21;2021-12-14;135;164;6946;409110;403619;139789;87.9;86.7;30.0
21;2021-12-15;173;217;6619;409283;403836;146408;87.9;86.7;31.5
21;2021-12-16;143;142;6026;409426;403978;152434;88.0;86.8;32.7
21;2021-12-17;180;263;7221;409606;404241;159655;88.0;86.8;34.3
21;2021-12-18;137;182;3872;409743;404423;163527;88.0;86.9;35.1
21;2021-12-19;22;15;842;409765;404438;164369;88.0;86.9;35.3
22;2020-12-27;0;0;0;0;0;0;0.0;0.0;0.0
22;2020-12-28;0;0;0;0;0;0;0.0;0.0;0.0
22;2020-12-29;0;0;0;0;0;0;0.0;0.0;0.0
22;2020-12-30;0;0;0;0;0;0;0.0;0.0;0.0
22;2020-12-31;0;0;0;0;0;0;0.0;0.0;0.0
22;2021-01-01;1;0;0;1;0;0;0.0;0.0;0.0
22;2021-01-02;2;0;0;3;0;0;0.0;0.0;0.0
22;2021-01-03;1;0;0;4;0;0;0.0;0.0;0.0
22;2021-01-04;3;0;0;7;0;0;0.0;0.0;0.0
22;2021-01-05;52;0;0;59;0;0;0.0;0.0;0.0
22;2021-01-06;114;1;0;173;1;0;0.0;0.0;0.0
22;2021-01-07;72;0;0;245;1;0;0.0;0.0;0.0
22;2021-01-08;186;0;0;431;1;0;0.1;0.0;0.0
22;2021-01-09;1;0;0;432;1;0;0.1;0.0;0.0
22;2021-01-10;1;0;0;433;1;0;0.1;0.0;0.0
22;2021-01-11;239;3;0;672;4;0;0.1;0.0;0.0
22;2021-01-12;609;0;0;1281;4;0;0.2;0.0;0.0
22;2021-01-13;663;1;0;1944;5;0;0.4;0.0;0.0
22;2021-01-14;729;8;0;2673;13;0;0.5;0.0;0.0
22;2021-01-15;535;1;0;3208;14;0;0.6;0.0;0.0
22;2021-01-16;101;0;0;3309;14;0;0.6;0.0;0.0
22;2021-01-17;3;0;0;3312;14;0;0.6;0.0;0.0
22;2021-01-18;352;2;0;3664;16;0;0.7;0.0;0.0
22;2021-01-19;753;0;0;4417;16;0;0.8;0.0;0.0
22;2021-01-20;652;2;0;5069;18;0;1.0;0.0;0.0
22;2021-01-21;1003;2;0;6072;20;0;1.2;0.0;0.0
22;2021-01-22;846;2;0;6918;22;0;1.3;0.0;0.0
22;2021-01-23;230;0;0;7148;22;0;1.4;0.0;0.0
22;2021-01-24;12;0;0;7160;22;0;1.4;0.0;0.0
22;2021-01-25;795;11;0;7955;33;0;1.5;0.0;0.0
22;2021-01-26;977;57;0;8932;90;0;1.7;0.0;0.0
22;2021-01-27;3558;115;0;12490;205;0;2.4;0.0;0.0
22;2021-01-28;4257;84;0;16747;289;0;3.2;0.1;0.0
22;2021-01-29;1802;133;0;18549;422;0;3.6;0.1;0.0
22;2021-01-30;282;1;0;18831;423;0;3.6;0.1;0.0
22;2021-01-31;6;0;0;18837;423;0;3.6;0.1;0.0
22;2021-02-01;651;97;0;19488;520;0;3.7;0.1;0.0
22;2021-02-02;870;426;0;20358;946;0;3.9;0.2;0.0
22;2021-02-03;699;486;0;21057;1432;0;4.0;0.3;0.0
22;2021-02-04;938;641;0;21995;2073;0;4.2;0.4;0.0
22;2021-02-05;722;559;0;22717;2632;0;4.4;0.5;0.0
22;2021-02-06;248;2;0;22965;2634;0;4.4;0.5;0.0
22;2021-02-07;13;0;0;22978;2634;0;4.4;0.5;0.0
22;2021-02-08;553;149;0;23531;2783;0;4.5;0.5;0.0
22;2021-02-09;625;425;0;24156;3208;0;4.6;0.6;0.0
22;2021-02-10;451;285;0;24607;3493;0;4.7;0.7;0.0
22;2021-02-11;1058;388;0;25665;3881;0;4.9;0.7;0.0
22;2021-02-12;628;332;0;26293;4213;0;5.0;0.8;0.0
22;2021-02-13;318;92;0;26611;4305;0;5.1;0.8;0.0
22;2021-02-14;4;12;0;26615;4317;0;5.1;0.8;0.0
22;2021-02-15;688;486;0;27303;4803;0;5.2;0.9;0.0
22;2021-02-16;1021;717;0;28324;5520;0;5.4;1.1;0.0
22;2021-02-17;1174;2262;0;29498;7782;0;5.7;1.5;0.0
22;2021-02-18;2088;2847;0;31586;10629;0;6.1;2.0;0.0
22;2021-02-19;1577;1876;0;33163;12505;0;6.4;2.4;0.0
22;2021-02-20;479;210;0;33642;12715;0;6.4;2.4;0.0
22;2021-02-21;12;49;0;33654;12764;0;6.5;2.4;0.0
22;2021-02-22;417;729;0;34071;13493;0;6.5;2.6;0.0
22;2021-02-23;620;944;0;34691;14437;0;6.6;2.8;0.0
22;2021-02-24;711;894;0;35402;15331;0;6.8;2.9;0.0
22;2021-02-25;1203;1199;0;36605;16530;0;7.0;3.2;0.0
22;2021-02-26;1080;716;0;37685;17246;0;7.2;3.3;0.0
22;2021-02-27;575;280;0;38260;17526;0;7.3;3.4;0.0
22;2021-02-28;21;11;0;38281;17537;0;7.3;3.4;0.0
22;2021-03-01;963;555;0;39244;18092;0;7.5;3.5;0.0
22;2021-03-02;1196;879;0;40440;18971;0;7.8;3.6;0.0
22;2021-03-03;1295;863;0;41735;19834;0;8.0;3.8;0.0
22;2021-03-04;1606;913;0;43341;20747;0;8.3;4.0;0.0
22;2021-03-05;2143;810;0;45484;21557;0;8.7;4.1;0.0
22;2021-03-06;1097;285;0;46581;21842;0;8.9;4.2;0.0
22;2021-03-07;224;10;0;46805;21852;0;9.0;4.2;0.0
22;2021-03-08;1282;661;0;48087;22513;0;9.2;4.3;0.0
22;2021-03-09;1819;747;0;49906;23260;0;9.6;4.5;0.0
22;2021-03-10;1945;953;0;51851;24213;0;9.9;4.6;0.0
22;2021-03-11;2367;1596;0;54218;25809;0;10.4;4.9;0.0
22;2021-03-12;3171;967;0;57389;26776;0;11.0;5.1;0.0
22;2021-03-13;1717;285;0;59106;27061;0;11.3;5.2;0.0
22;2021-03-14;258;30;0;59364;27091;0;11.4;5.2;0.0
22;2021-03-15;1596;588;0;60960;27679;0;11.7;5.3;0.0
22;2021-03-16;1554;834;0;62514;28513;0;12.0;5.5;0.0
22;2021-03-17;2459;708;0;64973;29221;0;12.5;5.6;0.0
22;2021-03-18;2437;1104;0;67410;30325;0;12.9;5.8;0.0
22;2021-03-19;3193;811;0;70603;31136;0;13.5;6.0;0.0
22;2021-03-20;2085;282;0;72688;31418;0;13.9;6.0;0.0
22;2021-03-21;45;2;0;72733;31420;0;13.9;6.0;0.0
22;2021-03-22;2284;377;0;75017;31797;0;14.4;6.1;0.0
22;2021-03-23;3025;706;0;78042;32503;0;15.0;6.2;0.0
22;2021-03-24;3380;701;0;81422;33204;0;15.6;6.4;0.0
22;2021-03-25;3818;632;0;85240;33836;0;16.3;6.5;0.0
22;2021-03-26;3869;492;0;89109;34328;0;17.1;6.6;0.0
22;2021-03-27;1925;198;0;91034;34526;0;17.4;6.6;0.0
22;2021-03-28;132;6;0;91166;34532;0;17.5;6.6;0.0
22;2021-03-29;2573;899;0;93739;35431;0;18.0;6.8;0.0
22;2021-03-30;3363;1114;0;97102;36545;0;18.6;7.0;0.0
22;2021-03-31;3313;1059;0;100415;37604;0;19.2;7.2;0.0
22;2021-04-01;4435;1097;0;104850;38701;0;20.1;7.4;0.0
22;2021-04-02;3983;1019;0;108833;39720;0;20.9;7.6;0.0
22;2021-04-03;1664;391;0;110497;40111;0;21.2;7.7;0.0
22;2021-04-04;62;2;0;110559;40113;0;21.2;7.7;0.0
22;2021-04-05;80;19;0;110639;40132;0;21.2;7.7;0.0
22;2021-04-06;2998;1096;0;113637;41228;0;21.8;7.9;0.0
22;2021-04-07;3126;1306;0;116763;42534;0;22.4;8.2;0.0
22;2021-04-08;4107;1267;0;120870;43801;0;23.2;8.4;0.0
22;2021-04-09;4883;1358;0;125753;45159;0;24.1;8.7;0.0
22;2021-04-10;2125;384;0;127878;45543;0;24.5;8.7;0.0
22;2021-04-11;487;26;0;128365;45569;0;24.6;8.7;0.0
22;2021-04-12;2737;1023;0;131102;46592;0;25.1;8.9;0.0
22;2021-04-13;3229;1492;0;134331;48084;0;25.7;9.2;0.0
22;2021-04-14;3081;2323;0;137412;50407;0;26.3;9.7;0.0
22;2021-04-15;3507;2336;0;140919;52743;0;27.0;10.1;0.0
22;2021-04-16;3455;2402;0;144374;55145;0;27.7;10.6;0.0
22;2021-04-17;1671;1648;0;146045;56793;0;28.0;10.9;0.0
22;2021-04-18;53;14;0;146098;56807;0;28.0;10.9;0.0
22;2021-04-19;2817;2109;0;148915;58916;0;28.5;11.3;0.0
22;2021-04-20;3243;2668;0;152158;61584;0;29.2;11.8;0.0
22;2021-04-21;3110;2588;0;155268;64172;0;29.8;12.3;0.0
22;2021-04-22;3434;2998;0;158702;67170;0;30.4;12.9;0.0
22;2021-04-23;3643;2975;0;162345;70145;0;31.1;13.4;0.0
22;2021-04-24;1805;1687;0;164150;71832;0;31.5;13.8;0.0
22;2021-04-25;61;29;0;164211;71861;0;31.5;13.8;0.0
22;2021-04-26;3136;2629;0;167347;74490;0;32.1;14.3;0.0
22;2021-04-27;3397;2809;0;170744;77299;0;32.7;14.8;0.0
22;2021-04-28;3455;2724;0;174199;80023;0;33.4;15.3;0.0
22;2021-04-29;4060;2909;0;178259;82932;0;34.2;15.9;0.0
22;2021-04-30;3935;2829;0;182194;85761;0;34.9;16.4;0.0
22;2021-05-01;137;116;0;182331;85877;0;34.9;16.5;0.0
22;2021-05-02;1241;106;0;183572;85983;0;35.2;16.5;0.0
22;2021-05-03;2062;2433;0;185634;88416;0;35.6;16.9;0.0
22;2021-05-04;2221;2714;0;187855;91130;0;36.0;17.5;0.0
22;2021-05-05;2123;2688;0;189978;93818;0;36.4;18.0;0.0
22;2021-05-06;2608;3272;0;192586;97090;0;36.9;18.6;0.0
22;2021-05-07;2931;3207;0;195517;100297;0;37.5;19.2;0.0
22;2021-05-08;131;165;0;195648;100462;0;37.5;19.3;0.0
22;2021-05-09;643;446;0;196291;100908;0;37.6;19.3;0.0
22;2021-05-10;4305;2530;0;200596;103438;0;38.4;19.8;0.0
22;2021-05-11;4816;2773;0;205412;106211;0;39.4;20.4;0.0
22;2021-05-12;6048;1119;0;211460;107330;0;40.5;20.6;0.0
22;2021-05-13;714;126;0;212174;107456;0;40.7;20.6;0.0
22;2021-05-14;5679;1207;0;217853;108663;0;41.8;20.8;0.0
22;2021-05-15;3576;459;0;221429;109122;0;42.4;20.9;0.0
22;2021-05-16;377;61;0;221806;109183;0;42.5;20.9;0.0
22;2021-05-17;5206;610;0;227012;109793;0;43.5;21.0;0.0
22;2021-05-18;5558;1073;0;232570;110866;0;44.6;21.2;0.0
22;2021-05-19;5711;833;0;238281;111699;0;45.7;21.4;0.0
22;2021-05-20;6135;1449;0;244416;113148;0;46.8;21.7;0.0
22;2021-05-21;5440;1552;0;249856;114700;0;47.9;22.0;0.0
22;2021-05-22;3590;757;0;253446;115457;0;48.6;22.1;0.0
22;2021-05-23;449;28;0;253895;115485;0;48.7;22.1;0.0
22;2021-05-24;4547;245;0;258442;115730;0;49.5;22.2;0.0
22;2021-05-25;4987;1242;0;263429;116972;0;50.5;22.4;0.0
22;2021-05-26;3843;2574;0;267272;119546;0;51.2;22.9;0.0
22;2021-05-27;4150;3568;0;271422;123114;0;52.0;23.6;0.0
22;2021-05-28;4010;4190;0;275432;127304;0;52.8;24.4;0.0
22;2021-05-29;2763;1623;0;278195;128927;0;53.3;24.7;0.0
22;2021-05-30;146;23;0;278341;128950;0;53.4;24.7;0.0
22;2021-05-31;3413;3033;0;281754;131983;0;54.0;25.3;0.0
22;2021-06-01;3451;3566;0;285205;135549;0;54.7;26.0;0.0
22;2021-06-02;2995;3173;0;288200;138722;0;55.2;26.6;0.0
22;2021-06-03;3286;3901;0;291486;142623;0;55.9;27.3;0.0
22;2021-06-04;3365;4422;0;294851;147045;0;56.5;28.2;0.0
22;2021-06-05;3122;1894;0;297973;148939;0;57.1;28.5;0.0
22;2021-06-06;344;55;0;298317;148994;0;57.2;28.6;0.0
22;2021-06-07;2913;3210;0;301230;152204;0;57.7;29.2;0.0
22;2021-06-08;2818;3470;0;304048;155674;0;58.3;29.8;0.0
22;2021-06-09;2641;3503;0;306689;159177;0;58.8;30.5;0.0
22;2021-06-10;2713;4107;0;309402;163284;0;59.3;31.3;0.0
22;2021-06-11;2753;4304;0;312155;167588;0;59.8;32.1;0.0
22;2021-06-12;2213;1397;0;314368;168985;0;60.3;32.4;0.0
22;2021-06-13;303;1125;0;314671;170110;0;60.3;32.6;0.0
22;2021-06-14;2596;2536;0;317267;172646;0;60.8;33.1;0.0
22;2021-06-15;3105;3135;0;320372;175781;0;61.4;33.7;0.0
22;2021-06-16;3038;2917;0;323410;178698;0;62.0;34.3;0.0
22;2021-06-17;2725;3256;0;326135;181954;0;62.5;34.9;0.0
22;2021-06-18;3204;4220;0;329339;186174;0;63.1;35.7;0.0
22;2021-06-19;2753;1419;0;332092;187593;0;63.7;36.0;0.0
22;2021-06-20;239;89;0;332331;187682;0;63.7;36.0;0.0
22;2021-06-21;1885;4883;0;334216;192565;0;64.1;36.9;0.0
22;2021-06-22;2500;5487;0;336716;198052;0;64.5;38.0;0.0
22;2021-06-23;1497;5983;0;338213;204035;0;64.8;39.1;0.0
22;2021-06-24;2697;3906;0;340910;207941;0;65.3;39.9;0.0
22;2021-06-25;1682;6500;0;342592;214441;0;65.7;41.1;0.0
22;2021-06-26;796;3543;0;343388;217984;0;65.8;41.8;0.0
22;2021-06-27;67;475;0;343455;218459;0;65.8;41.9;0.0
22;2021-06-28;1082;5329;0;344537;223788;0;66.0;42.9;0.0
22;2021-06-29;1470;5824;0;346007;229612;0;66.3;44.0;0.0
22;2021-06-30;1242;5654;0;347249;235266;0;66.6;45.1;0.0
22;2021-07-01;1509;5879;0;348758;241145;0;66.8;46.2;0.0
22;2021-07-02;1766;5940;0;350524;247085;0;67.2;47.4;0.0
22;2021-07-03;959;3417;0;351483;250502;0;67.4;48.0;0.0
22;2021-07-04;186;440;0;351669;250942;0;67.4;48.1;0.0
22;2021-07-05;1643;5534;0;353312;256476;0;67.7;49.2;0.0
22;2021-07-06;2300;5772;0;355612;262248;0;68.2;50.3;0.0
22;2021-07-07;2191;4762;0;357803;267010;0;68.6;51.2;0.0
22;2021-07-08;2328;4924;0;360131;271934;0;69.0;52.1;0.0
22;2021-07-09;2318;5247;0;362449;277181;0;69.5;53.1;0.0
22;2021-07-10;1604;3107;0;364053;280288;0;69.8;53.7;0.0
22;2021-07-11;459;145;0;364512;280433;0;69.9;53.8;0.0
22;2021-07-12;2124;4541;0;366636;284974;0;70.3;54.6;0.0
22;2021-07-13;3465;5033;0;370101;290007;0;70.9;55.6;0.0
22;2021-07-14;769;2547;0;370870;292554;0;71.1;56.1;0.0
22;2021-07-15;3393;4676;0;374263;297230;0;71.7;57.0;0.0
22;2021-07-16;3499;5236;0;377762;302466;0;72.4;58.0;0.0
22;2021-07-17;2269;3069;0;380031;305535;0;72.8;58.6;0.0
22;2021-07-18;579;209;0;380610;305744;0;73.0;58.6;0.0
22;2021-07-19;2527;3951;1;383137;309695;1;73.4;59.4;0.0
22;2021-07-20;3538;4053;0;386675;313748;1;74.1;60.1;0.0
22;2021-07-21;3581;3372;0;390256;317120;1;74.8;60.8;0.0
22;2021-07-22;4323;3691;0;394579;320811;1;75.6;61.5;0.0
22;2021-07-23;4030;4242;0;398609;325053;1;76.4;62.3;0.0
22;2021-07-24;1981;2409;0;400590;327462;1;76.8;62.8;0.0
22;2021-07-25;221;278;0;400811;327740;1;76.8;62.8;0.0
22;2021-07-26;2749;3857;0;403560;331597;1;77.4;63.6;0.0
22;2021-07-27;3340;4713;0;406900;336310;1;78.0;64.5;0.0
22;2021-07-28;3352;3579;0;410252;339889;1;78.6;65.1;0.0
22;2021-07-29;3782;3728;0;414034;343617;1;79.4;65.9;0.0
22;2021-07-30;3560;3958;0;417594;347575;1;80.0;66.6;0.0
22;2021-07-31;2032;2653;0;419626;350228;1;80.4;67.1;0.0
22;2021-08-01;247;258;0;419873;350486;1;80.5;67.2;0.0
22;2021-08-02;4189;2433;0;424062;352919;1;81.3;67.6;0.0
22;2021-08-03;4347;3325;0;428409;356244;1;82.1;68.3;0.0
22;2021-08-04;5032;2403;0;433441;358647;1;83.1;68.7;0.0
22;2021-08-05;3721;3543;0;437162;362190;1;83.8;69.4;0.0
22;2021-08-06;3291;3576;0;440453;365766;1;84.4;70.1;0.0
22;2021-08-07;2092;2075;0;442545;367841;1;84.8;70.5;0.0
22;2021-08-08;369;153;0;442914;367994;1;84.9;70.5;0.0
22;2021-08-09;2499;2596;0;445413;370590;1;85.4;71.0;0.0
22;2021-08-10;2597;3317;0;448010;373907;1;85.9;71.7;0.0
22;2021-08-11;2338;2931;0;450348;376838;1;86.3;72.2;0.0
22;2021-08-12;2140;3300;0;452488;380138;1;86.7;72.9;0.0
22;2021-08-13;1973;2895;0;454461;383033;1;87.1;73.4;0.0
22;2021-08-14;1264;1730;0;455725;384763;1;87.3;73.7;0.0
22;2021-08-15;147;270;0;455872;385033;1;87.4;73.8;0.0
22;2021-08-16;1502;3004;0;457374;388037;1;87.7;74.4;0.0
22;2021-08-17;1764;3334;0;459138;391371;1;88.0;75.0;0.0
22;2021-08-18;1490;3134;0;460628;394505;1;88.3;75.6;0.0
22;2021-08-19;1436;3434;0;462064;397939;1;88.6;76.3;0.0
22;2021-08-20;1496;3547;0;463560;401486;1;88.9;77.0;0.0
22;2021-08-21;746;2100;0;464306;403586;1;89.0;77.4;0.0
22;2021-08-22;203;386;0;464509;403972;1;89.0;77.4;0.0
22;2021-08-23;1862;3528;0;466371;407500;1;89.4;78.1;0.0
22;2021-08-24;1410;3232;0;467781;410732;1;89.7;78.7;0.0
22;2021-08-25;866;2595;0;468647;413327;1;89.8;79.2;0.0
22;2021-08-26;1104;4210;0;469751;417537;1;90.0;80.0;0.0
22;2021-08-27;1283;4536;0;471034;422073;1;90.3;80.9;0.0
22;2021-08-28;700;2353;0;471734;424426;1;90.4;81.4;0.0
22;2021-08-29;69;136;0;471803;424562;1;90.4;81.4;0.0
22;2021-08-30;916;3017;54;472719;427579;55;90.6;82.0;0.0
22;2021-08-31;994;3732;71;473713;431311;126;90.8;82.7;0.0
22;2021-09-01;1022;3235;171;474735;434546;297;91.0;83.3;0.1
22;2021-09-02;847;2840;234;475582;437386;531;91.2;83.8;0.1
22;2021-09-03;934;2864;313;476516;440250;844;91.3;84.4;0.2
22;2021-09-04;761;2436;129;477277;442686;973;91.5;84.9;0.2
22;2021-09-05;119;109;29;477396;442795;1002;91.5;84.9;0.2
22;2021-09-06;501;1940;321;477897;444735;1323;91.6;85.2;0.3
22;2021-09-07;537;1980;310;478434;446715;1633;91.7;85.6;0.3
22;2021-09-08;624;1958;324;479058;448673;1957;91.8;86.0;0.4
22;2021-09-09;649;1924;407;479707;450597;2364;91.9;86.4;0.5
22;2021-09-10;714;2136;369;480421;452733;2733;92.1;86.8;0.5
22;2021-09-11;534;1556;131;480955;454289;2864;92.2;87.1;0.5
22;2021-09-12;41;123;8;480996;454412;2872;92.2;87.1;0.6
22;2021-09-13;504;2056;593;481500;456468;3465;92.3;87.5;0.7
22;2021-09-14;598;1564;850;482098;458032;4315;92.4;87.8;0.8
22;2021-09-15;456;1713;619;482554;459745;4934;92.5;88.1;0.9
22;2021-09-16;558;1088;991;483112;460833;5925;92.6;88.3;1.1
22;2021-09-17;631;1627;947;483743;462460;6872;92.7;88.6;1.3
22;2021-09-18;279;2014;104;484022;464474;6976;92.8;89.0;1.3
22;2021-09-19;10;57;7;484032;464531;6983;92.8;89.0;1.3
22;2021-09-20;373;735;678;484405;465266;7661;92.8;89.2;1.5
22;2021-09-21;360;913;1011;484765;466179;8672;92.9;89.4;1.7
22;2021-09-22;302;1201;533;485067;467380;9205;93.0;89.6;1.8
22;2021-09-23;389;730;941;485456;468110;10146;93.0;89.7;1.9
22;2021-09-24;375;1148;932;485831;469258;11078;93.1;89.9;2.1
22;2021-09-25;215;1304;176;486046;470562;11254;93.2;90.2;2.2
22;2021-09-26;17;90;15;486063;470652;11269;93.2;90.2;2.2
22;2021-09-27;336;780;697;486399;471432;11966;93.2;90.4;2.3
22;2021-09-28;229;604;702;486628;472036;12668;93.3;90.5;2.4
22;2021-09-29;234;873;936;486862;472909;13604;93.3;90.6;2.6
22;2021-09-30;275;706;1020;487137;473615;14624;93.4;90.8;2.8
22;2021-10-01;327;800;862;487464;474415;15486;93.4;90.9;3.0
22;2021-10-02;305;844;239;487769;475259;15725;93.5;91.1;3.0
22;2021-10-03;5;3;5;487774;475262;15730;93.5;91.1;3.0
22;2021-10-04;149;452;602;487923;475714;16332;93.5;91.2;3.1
22;2021-10-05;217;634;905;488140;476348;17237;93.6;91.3;3.3
22;2021-10-06;235;396;757;488375;476744;17994;93.6;91.4;3.4
22;2021-10-07;233;650;937;488608;477394;18931;93.7;91.5;3.6
22;2021-10-08;313;784;961;488921;478178;19892;93.7;91.7;3.8
22;2021-10-09;225;434;387;489146;478612;20279;93.8;91.7;3.9
22;2021-10-10;6;11;4;489152;478623;20283;93.8;91.7;3.9
22;2021-10-11;158;304;675;489310;478927;20958;93.8;91.8;4.0
22;2021-10-12;106;183;536;489416;479110;21494;93.8;91.8;4.1
22;2021-10-13;184;263;660;489600;479373;22154;93.8;91.9;4.2
22;2021-10-14;209;713;1218;489809;480086;23372;93.9;92.0;4.5
22;2021-10-15;269;481;1362;490078;480567;24734;93.9;92.1;4.7
22;2021-10-16;307;448;669;490385;481015;25403;94.0;92.2;4.9
22;2021-10-17;2;6;3;490387;481021;25406;94.0;92.2;4.9
22;2021-10-18;139;329;1010;490526;481350;26416;94.0;92.3;5.1
22;2021-10-19;70;131;392;490596;481481;26808;94.0;92.3;5.1
22;2021-10-20;167;271;1349;490763;481752;28157;94.1;92.3;5.4
22;2021-10-21;214;419;1736;490977;482171;29893;94.1;92.4;5.7
22;2021-10-22;195;427;1197;491172;482598;31090;94.1;92.5;6.0
22;2021-10-23;233;413;1033;491405;483011;32123;94.2;92.6;6.2
22;2021-10-24;2;10;1;491407;483021;32124;94.2;92.6;6.2
22;2021-10-25;178;160;1505;491585;483181;33629;94.2;92.6;6.4
22;2021-10-26;68;80;420;491653;483261;34049;94.2;92.6;6.5
22;2021-10-27;125;142;1110;491778;483403;35159;94.3;92.7;6.7
22;2021-10-28;205;257;1675;491983;483660;36834;94.3;92.7;7.1
22;2021-10-29;175;337;1414;492158;483997;38248;94.3;92.8;7.3
22;2021-10-30;154;251;889;492312;484248;39137;94.4;92.8;7.5
22;2021-10-31;1;9;7;492313;484257;39144;94.4;92.8;7.5
22;2021-11-01;5;4;9;492318;484261;39153;94.4;92.8;7.5
22;2021-11-02;71;80;539;492389;484341;39692;94.4;92.8;7.6
22;2021-11-03;158;182;1592;492547;484523;41284;94.4;92.9;7.9
22;2021-11-04;213;278;1955;492760;484801;43239;94.4;92.9;8.3
22;2021-11-05;190;316;1784;492950;485117;45023;94.5;93.0;8.6
22;2021-11-06;206;312;1350;493156;485429;46373;94.5;93.0;8.9
22;2021-11-07;3;4;6;493159;485433;46379;94.5;93.0;8.9
22;2021-11-08;110;192;2480;493269;485625;48859;94.5;93.1;9.4
22;2021-11-09;151;160;2114;493420;485785;50973;94.6;93.1;9.8
22;2021-11-10;124;174;1600;493544;485959;52573;94.6;93.1;10.1
22;2021-11-11;1;13;57;493545;485972;52630;94.6;93.1;10.1
22;2021-11-12;194;410;2803;493739;486382;55433;94.6;93.2;10.6
22;2021-11-13;207;301;1670;493946;486683;57103;94.7;93.3;10.9
22;2021-11-14;1;8;2;493947;486691;57105;94.7;93.3;10.9
22;2021-11-15;134;139;2026;494081;486830;59131;94.7;93.3;11.3
22;2021-11-16;139;129;2348;494220;486959;61479;94.7;93.3;11.8
22;2021-11-17;158;167;1956;494378;487126;63435;94.8;93.4;12.2
22;2021-11-18;211;207;2740;494589;487333;66175;94.8;93.4;12.7
22;2021-11-19;235;274;2940;494824;487607;69115;94.8;93.5;13.2
22;2021-11-20;264;269;1253;495088;487876;70368;94.9;93.5;13.5
22;2021-11-21;1;3;1;495089;487879;70369;94.9;93.5;13.5
22;2021-11-22;163;116;2108;495252;487995;72477;94.9;93.5;13.9
22;2021-11-23;183;138;2659;495435;488133;75136;95.0;93.6;14.4
22;2021-11-24;230;197;1976;495665;488330;77112;95.0;93.6;14.8
22;2021-11-25;169;155;3168;495834;488485;80280;95.0;93.6;15.4
22;2021-11-26;229;232;4687;496063;488717;84967;95.1;93.7;16.3
22;2021-11-27;207;255;2060;496270;488972;87027;95.1;93.7;16.7
22;2021-11-28;4;2;53;496274;488974;87080;95.1;93.7;16.7
22;2021-11-29;125;113;4766;496399;489087;91846;95.1;93.7;17.6
22;2021-11-30;158;139;6130;496557;489226;97976;95.2;93.8;18.8
22;2021-12-01;167;146;5438;496724;489372;103414;95.2;93.8;19.8
22;2021-12-02;124;118;5882;496848;489490;109296;95.2;93.8;20.9
22;2021-12-03;146;203;6878;496994;489693;116174;95.3;93.9;22.3
22;2021-12-04;99;253;2432;497093;489946;118606;95.3;93.9;22.7
22;2021-12-05;5;4;120;497098;489950;118726;95.3;93.9;22.8
22;2021-12-06;110;162;5864;497208;490112;124590;95.3;93.9;23.9
22;2021-12-07;126;142;7117;497334;490254;131707;95.3;94.0;25.2
22;2021-12-08;154;189;6821;497488;490443;138528;95.4;94.0;26.6
22;2021-12-09;170;170;7955;497658;490613;146483;95.4;94.0;28.1
22;2021-12-10;204;268;8641;497862;490881;155124;95.4;94.1;29.7
22;2021-12-11;109;262;3822;497971;491143;158946;95.4;94.1;30.5
22;2021-12-12;27;17;1143;497998;491160;160089;95.5;94.1;30.7
22;2021-12-13;132;167;7348;498130;491327;167437;95.5;94.2;32.1
22;2021-12-14;180;183;9136;498310;491510;176573;95.5;94.2;33.8
22;2021-12-15;207;208;7868;498517;491718;184441;95.6;94.2;35.4
22;2021-12-16;176;256;8322;498693;491974;192763;95.6;94.3;36.9
22;2021-12-17;196;294;8939;498889;492268;201702;95.6;94.4;38.7
22;2021-12-18;160;241;3859;499049;492509;205561;95.7;94.4;39.4
22;2021-12-19;35;23;1302;499084;492532;206863;95.7;94.4;39.6
23;2020-12-27;0;0;0;0;0;0;0.0;0.0;0.0
23;2020-12-28;1;0;0;1;0;0;0.0;0.0;0.0
23;2020-12-29;0;0;0;1;0;0;0.0;0.0;0.0
23;2020-12-30;0;0;0;1;0;0;0.0;0.0;0.0
23;2020-12-31;0;0;0;1;0;0;0.0;0.0;0.0
23;2021-01-01;0;0;0;1;0;0;0.0;0.0;0.0
23;2021-01-02;1;0;0;2;0;0;0.0;0.0;0.0
23;2021-01-03;0;0;0;2;0;0;0.0;0.0;0.0
23;2021-01-04;2;0;0;4;0;0;0.0;0.0;0.0
23;2021-01-05;4;0;0;8;0;0;0.0;0.0;0.0
23;2021-01-06;8;0;0;16;0;0;0.0;0.0;0.0
23;2021-01-07;98;1;0;114;1;0;0.1;0.0;0.0
23;2021-01-08;111;0;0;225;1;0;0.2;0.0;0.0
23;2021-01-09;26;0;0;251;1;0;0.2;0.0;0.0
23;2021-01-10;3;0;0;254;1;0;0.2;0.0;0.0
23;2021-01-11;150;1;0;404;2;0;0.4;0.0;0.0
23;2021-01-12;209;5;0;613;7;0;0.6;0.0;0.0
23;2021-01-13;239;0;0;852;7;0;0.8;0.0;0.0
23;2021-01-14;238;3;0;1090;10;0;1.0;0.0;0.0
23;2021-01-15;295;5;0;1385;15;0;1.3;0.0;0.0
23;2021-01-16;154;1;0;1539;16;0;1.5;0.0;0.0
23;2021-01-17;0;0;0;1539;16;0;1.5;0.0;0.0
23;2021-01-18;307;3;0;1846;19;0;1.8;0.0;0.0
23;2021-01-19;451;1;0;2297;20;0;2.2;0.0;0.0
23;2021-01-20;327;1;0;2624;21;0;2.5;0.0;0.0
23;2021-01-21;631;1;0;3255;22;0;3.1;0.0;0.0
23;2021-01-22;444;0;0;3699;22;0;3.5;0.0;0.0
23;2021-01-23;347;1;0;4046;23;0;3.9;0.0;0.0
23;2021-01-24;8;0;0;4054;23;0;3.9;0.0;0.0
23;2021-01-25;360;16;0;4414;39;0;4.2;0.0;0.0
23;2021-01-26;280;6;0;4694;45;0;4.5;0.0;0.0
23;2021-01-27;232;2;0;4926;47;0;4.7;0.0;0.0
23;2021-01-28;229;34;0;5155;81;0;4.9;0.1;0.0
23;2021-01-29;288;99;0;5443;180;0;5.2;0.2;0.0
23;2021-01-30;98;26;0;5541;206;0;5.3;0.2;0.0
23;2021-01-31;2;24;0;5543;230;0;5.3;0.2;0.0
23;2021-02-01;144;93;0;5687;323;0;5.4;0.3;0.0
23;2021-02-02;157;104;0;5844;427;0;5.6;0.4;0.0
23;2021-02-03;99;146;0;5943;573;0;5.7;0.5;0.0
23;2021-02-04;87;209;0;6030;782;0;5.8;0.7;0.0
23;2021-02-05;125;287;0;6155;1069;0;5.9;1.0;0.0
23;2021-02-06;17;163;0;6172;1232;0;5.9;1.2;0.0
23;2021-02-07;1;0;0;6173;1232;0;5.9;1.2;0.0
23;2021-02-08;110;199;0;6283;1431;0;6.0;1.4;0.0
23;2021-02-09;75;276;0;6358;1707;0;6.1;1.6;0.0
23;2021-02-10;88;257;0;6446;1964;0;6.2;1.9;0.0
23;2021-02-11;228;515;0;6674;2479;0;6.4;2.4;0.0
23;2021-02-12;210;252;0;6884;2731;0;6.6;2.6;0.0
23;2021-02-13;8;175;0;6892;2906;0;6.6;2.8;0.0
23;2021-02-14;11;1;0;6903;2907;0;6.6;2.8;0.0
23;2021-02-15;152;330;0;7055;3237;0;6.7;3.1;0.0
23;2021-02-16;95;412;0;7150;3649;0;6.8;3.5;0.0
23;2021-02-17;74;471;0;7224;4120;0;6.9;3.9;0.0
23;2021-02-18;126;372;0;7350;4492;0;7.0;4.3;0.0
23;2021-02-19;107;240;0;7457;4732;0;7.1;4.5;0.0
23;2021-02-20;9;97;0;7466;4829;0;7.1;4.6;0.0
23;2021-02-21;0;0;0;7466;4829;0;7.1;4.6;0.0
23;2021-02-22;99;196;0;7565;5025;0;7.2;4.8;0.0
23;2021-02-23;91;204;0;7656;5229;0;7.3;5.0;0.0
23;2021-02-24;148;152;0;7804;5381;0;7.5;5.1;0.0
23;2021-02-25;164;111;0;7968;5492;0;7.6;5.2;0.0
23;2021-02-26;269;142;0;8237;5634;0;7.9;5.4;0.0
23;2021-02-27;92;15;0;8329;5649;0;8.0;5.4;0.0
23;2021-02-28;3;30;0;8332;5679;0;8.0;5.4;0.0
23;2021-03-01;89;176;0;8421;5855;0;8.0;5.6;0.0
23;2021-03-02;225;128;0;8646;5983;0;8.3;5.7;0.0
23;2021-03-03;139;99;0;8785;6082;0;8.4;5.8;0.0
23;2021-03-04;279;119;0;9064;6201;0;8.7;5.9;0.0
23;2021-03-05;512;129;0;9576;6330;0;9.2;6.1;0.0
23;2021-03-06;493;14;0;10069;6344;0;9.6;6.1;0.0
23;2021-03-07;288;4;0;10357;6348;0;9.9;6.1;0.0
23;2021-03-08;210;78;0;10567;6426;0;10.1;6.1;0.0
23;2021-03-09;360;95;0;10927;6521;0;10.4;6.2;0.0
23;2021-03-10;306;43;0;11233;6564;0;10.7;6.3;0.0
23;2021-03-11;295;53;0;11528;6617;0;11.0;6.3;0.0
23;2021-03-12;528;50;0;12056;6667;0;11.5;6.4;0.0
23;2021-03-13;293;15;0;12349;6682;0;11.8;6.4;0.0
23;2021-03-14;46;34;0;12395;6716;0;11.8;6.4;0.0
23;2021-03-15;219;115;0;12614;6831;0;12.1;6.5;0.0
23;2021-03-16;207;92;0;12821;6923;0;12.3;6.6;0.0
23;2021-03-17;127;100;0;12948;7023;0;12.4;6.7;0.0
23;2021-03-18;189;90;0;13137;7113;0;12.6;6.8;0.0
23;2021-03-19;240;122;0;13377;7235;0;12.8;6.9;0.0
23;2021-03-20;604;34;0;13981;7269;0;13.4;6.9;0.0
23;2021-03-21;107;0;0;14088;7269;0;13.5;6.9;0.0
23;2021-03-22;254;126;0;14342;7395;0;13.7;7.1;0.0
23;2021-03-23;465;86;0;14807;7481;0;14.2;7.2;0.0
23;2021-03-24;427;108;0;15234;7589;0;14.6;7.3;0.0
23;2021-03-25;814;173;0;16048;7762;0;15.3;7.4;0.0
23;2021-03-26;714;172;0;16762;7934;0;16.0;7.6;0.0
23;2021-03-27;506;37;0;17268;7971;0;16.5;7.6;0.0
23;2021-03-28;4;12;0;17272;7983;0;16.5;7.6;0.0
23;2021-03-29;360;106;0;17632;8089;0;16.9;7.7;0.0
23;2021-03-30;538;169;0;18170;8258;0;17.4;7.9;0.0
23;2021-03-31;431;178;0;18601;8436;0;17.8;8.1;0.0
23;2021-04-01;602;169;0;19203;8605;0;18.4;8.2;0.0
23;2021-04-02;509;286;0;19712;8891;0;18.8;8.5;0.0
23;2021-04-03;637;49;0;20349;8940;0;19.5;8.5;0.0
23;2021-04-04;4;1;0;20353;8941;0;19.5;8.5;0.0
23;2021-04-05;7;4;0;20360;8945;0;19.5;8.6;0.0
23;2021-04-06;391;264;0;20751;9209;0;19.8;8.8;0.0
23;2021-04-07;689;261;0;21440;9470;0;20.5;9.1;0.0
23;2021-04-08;784;223;0;22224;9693;0;21.2;9.3;0.0
23;2021-04-09;900;293;0;23124;9986;0;22.1;9.5;0.0
23;2021-04-10;1018;125;0;24142;10111;0;23.1;9.7;0.0
23;2021-04-11;31;5;0;24173;10116;0;23.1;9.7;0.0
23;2021-04-12;638;209;0;24811;10325;0;23.7;9.9;0.0
23;2021-04-13;646;275;0;25457;10600;0;24.3;10.1;0.0
23;2021-04-14;570;181;0;26027;10781;0;24.9;10.3;0.0
23;2021-04-15;878;186;0;26905;10967;0;25.7;10.5;0.0
23;2021-04-16;837;226;0;27742;11193;0;26.5;10.7;0.0
23;2021-04-17;882;531;0;28624;11724;0;27.4;11.2;0.0
23;2021-04-18;20;118;0;28644;11842;0;27.4;11.3;0.0
23;2021-04-19;544;282;0;29188;12124;0;27.9;11.6;0.0
23;2021-04-20;658;299;0;29846;12423;0;28.5;11.9;0.0
23;2021-04-21;673;384;0;30519;12807;0;29.2;12.2;0.0
23;2021-04-22;579;484;0;31098;13291;0;29.7;12.7;0.0
23;2021-04-23;526;342;0;31624;13633;0;30.2;13.0;0.0
23;2021-04-24;767;425;0;32391;14058;0;31.0;13.4;0.0
23;2021-04-25;14;2;0;32405;14060;0;31.0;13.4;0.0
23;2021-04-26;563;267;0;32968;14327;0;31.5;13.7;0.0
23;2021-04-27;634;431;0;33602;14758;0;32.1;14.1;0.0
23;2021-04-28;622;276;0;34224;15034;0;32.7;14.4;0.0
23;2021-04-29;860;378;0;35084;15412;0;33.5;14.7;0.0
23;2021-04-30;665;701;0;35749;16113;0;34.2;15.4;0.0
23;2021-05-01;1149;50;0;36898;16163;0;35.3;15.4;0.0
23;2021-05-02;24;5;0;36922;16168;0;35.3;15.5;0.0
23;2021-05-03;415;502;0;37337;16670;0;35.7;15.9;0.0
23;2021-05-04;616;491;0;37953;17161;0;36.3;16.4;0.0
23;2021-05-05;539;688;0;38492;17849;0;36.8;17.1;0.0
23;2021-05-06;593;676;0;39085;18525;0;37.4;17.7;0.0
23;2021-05-07;662;615;0;39747;19140;0;38.0;18.3;0.0
23;2021-05-08;1063;502;0;40810;19642;0;39.0;18.8;0.0
23;2021-05-09;12;13;0;40822;19655;0;39.0;18.8;0.0
23;2021-05-10;504;639;0;41326;20294;0;39.5;19.4;0.0
23;2021-05-11;562;707;0;41888;21001;0;40.0;20.1;0.0
23;2021-05-12;558;670;0;42446;21671;0;40.6;20.7;0.0
23;2021-05-13;490;60;0;42936;21731;0;41.0;20.8;0.0
23;2021-05-14;627;440;0;43563;22171;0;41.6;21.2;0.0
23;2021-05-15;863;193;0;44426;22364;0;42.5;21.4;0.0
23;2021-05-16;14;4;0;44440;22368;0;42.5;21.4;0.0
23;2021-05-17;500;437;0;44940;22805;0;43.0;21.8;0.0
23;2021-05-18;658;287;0;45598;23092;0;43.6;22.1;0.0
23;2021-05-19;769;258;0;46367;23350;0;44.3;22.3;0.0
23;2021-05-20;714;298;0;47081;23648;0;45.0;22.6;0.0
23;2021-05-21;834;301;0;47915;23949;0;45.8;22.9;0.0
23;2021-05-22;568;119;0;48483;24068;0;46.3;23.0;0.0
23;2021-05-23;10;21;0;48493;24089;0;46.4;23.0;0.0
23;2021-05-24;278;141;0;48771;24230;0;46.6;23.2;0.0
23;2021-05-25;733;335;0;49504;24565;0;47.3;23.5;0.0
23;2021-05-26;871;244;0;50375;24809;0;48.2;23.7;0.0
23;2021-05-27;799;430;0;51174;25239;0;48.9;24.1;0.0
23;2021-05-28;683;663;0;51857;25902;0;49.6;24.8;0.0
23;2021-05-29;530;1003;0;52387;26905;0;50.1;25.7;0.0
23;2021-05-30;23;46;0;52410;26951;0;50.1;25.8;0.0
23;2021-05-31;373;479;0;52783;27430;0;50.5;26.2;0.0
23;2021-06-01;543;757;0;53326;28187;0;51.0;26.9;0.0
23;2021-06-02;534;494;0;53860;28681;0;51.5;27.4;0.0
23;2021-06-03;663;529;0;54523;29210;0;52.1;27.9;0.0
23;2021-06-04;710;550;0;55233;29760;0;52.8;28.4;0.0
23;2021-06-05;477;717;0;55710;30477;0;53.3;29.1;0.0
23;2021-06-06;8;15;0;55718;30492;0;53.3;29.1;0.0
23;2021-06-07;365;631;0;56083;31123;0;53.6;29.7;0.0
23;2021-06-08;338;771;0;56421;31894;0;53.9;30.5;0.0
23;2021-06-09;274;650;0;56695;32544;0;54.2;31.1;0.0
23;2021-06-10;391;684;0;57086;33228;0;54.6;31.8;0.0
23;2021-06-11;377;797;0;57463;34025;0;54.9;32.5;0.0
23;2021-06-12;334;1211;0;57797;35236;0;55.2;33.7;0.0
23;2021-06-13;21;8;0;57818;35244;0;55.3;33.7;0.0
23;2021-06-14;213;555;0;58031;35799;0;55.5;34.2;0.0
23;2021-06-15;247;835;0;58278;36634;0;55.7;35.0;0.0
23;2021-06-16;354;554;0;58632;37188;0;56.0;35.5;0.0
23;2021-06-17;327;717;0;58959;37905;0;56.4;36.2;0.0
23;2021-06-18;370;726;0;59329;38631;0;56.7;36.9;0.0
23;2021-06-19;434;1196;0;59763;39827;0;57.1;38.1;0.0
23;2021-06-20;10;20;0;59773;39847;0;57.1;38.1;0.0
23;2021-06-21;204;583;0;59977;40430;0;57.3;38.6;0.0
23;2021-06-22;227;643;0;60204;41073;0;57.5;39.3;0.0
23;2021-06-23;232;639;0;60436;41712;0;57.8;39.9;0.0
23;2021-06-24;195;582;0;60631;42294;0;58.0;40.4;0.0
23;2021-06-25;291;753;0;60922;43047;0;58.2;41.1;0.0
23;2021-06-26;210;903;0;61132;43950;0;58.4;42.0;0.0
23;2021-06-27;4;15;0;61136;43965;0;58.4;42.0;0.0
23;2021-06-28;110;604;0;61246;44569;0;58.5;42.6;0.0
23;2021-06-29;216;793;0;61462;45362;0;58.8;43.4;0.0
23;2021-06-30;173;777;0;61635;46139;0;58.9;44.1;0.0
23;2021-07-01;183;800;0;61818;46939;0;59.1;44.9;0.0
23;2021-07-02;199;939;0;62017;47878;0;59.3;45.8;0.0
23;2021-07-03;237;828;0;62254;48706;0;59.5;46.6;0.0
23;2021-07-04;0;7;0;62254;48713;0;59.5;46.6;0.0
23;2021-07-05;157;706;0;62411;49419;0;59.7;47.2;0.0
23;2021-07-06;215;886;0;62626;50305;0;59.9;48.1;0.0
23;2021-07-07;220;784;0;62846;51089;0;60.1;48.8;0.0
23;2021-07-08;270;720;0;63116;51809;0;60.3;49.5;0.0
23;2021-07-09;284;993;0;63400;52802;0;60.6;50.5;0.0
23;2021-07-10;230;574;0;63630;53376;0;60.8;51.0;0.0
23;2021-07-11;10;11;0;63640;53387;0;60.8;51.0;0.0
23;2021-07-12;253;659;0;63893;54046;0;61.1;51.7;0.0
23;2021-07-13;486;846;0;64379;54892;0;61.5;52.5;0.0
23;2021-07-14;208;293;0;64587;55185;0;61.7;52.8;0.0
23;2021-07-15;469;752;0;65056;55937;0;62.2;53.5;0.0
23;2021-07-16;765;525;0;65821;56462;0;62.9;54.0;0.0
23;2021-07-17;222;443;0;66043;56905;0;63.1;54.4;0.0
23;2021-07-18;16;15;0;66059;56920;0;63.1;54.4;0.0
23;2021-07-19;668;618;0;66727;57538;0;63.8;55.0;0.0
23;2021-07-20;571;571;0;67298;58109;0;64.3;55.5;0.0
23;2021-07-21;676;616;0;67974;58725;0;65.0;56.1;0.0
23;2021-07-22;823;467;0;68797;59192;0;65.8;56.6;0.0
23;2021-07-23;813;545;0;69610;59737;0;66.5;57.1;0.0
23;2021-07-24;843;419;0;70453;60156;0;67.3;57.5;0.0
23;2021-07-25;20;27;0;70473;60183;0;67.4;57.5;0.0
23;2021-07-26;705;545;0;71178;60728;0;68.0;58.0;0.0
23;2021-07-27;872;443;0;72050;61171;0;68.9;58.5;0.0
23;2021-07-28;838;415;0;72888;61586;0;69.7;58.9;0.0
23;2021-07-29;957;379;0;73845;61965;0;70.6;59.2;0.0
23;2021-07-30;812;488;0;74657;62453;0;71.4;59.7;0.0
23;2021-07-31;909;284;0;75566;62737;0;72.2;60.0;0.0
23;2021-08-01;21;21;0;75587;62758;0;72.3;60.0;0.0
23;2021-08-02;594;495;0;76181;63253;0;72.8;60.5;0.0
23;2021-08-03;726;500;0;76907;63753;0;73.5;60.9;0.0
23;2021-08-04;611;290;0;77518;64043;0;74.1;61.2;0.0
23;2021-08-05;639;335;0;78157;64378;0;74.7;61.5;0.0
23;2021-08-06;435;474;0;78592;64852;0;75.1;62.0;0.0
23;2021-08-07;278;208;0;78870;65060;0;75.4;62.2;0.0
23;2021-08-08;130;36;0;79000;65096;0;75.5;62.2;0.0
23;2021-08-09;436;434;0;79436;65530;0;75.9;62.6;0.0
23;2021-08-10;447;655;0;79883;66185;0;76.4;63.3;0.0
23;2021-08-11;372;468;0;80255;66653;0;76.7;63.7;0.0
23;2021-08-12;484;594;0;80739;67247;0;77.2;64.3;0.0
23;2021-08-13;407;547;0;81146;67794;0;77.6;64.8;0.0
23;2021-08-14;259;366;0;81405;68160;0;77.8;65.2;0.0
23;2021-08-15;27;19;0;81432;68179;0;77.8;65.2;0.0
23;2021-08-16;279;655;0;81711;68834;0;78.1;65.8;0.0
23;2021-08-17;263;732;0;81974;69566;0;78.4;66.5;0.0
23;2021-08-18;196;624;0;82170;70190;0;78.5;67.1;0.0
23;2021-08-19;271;753;0;82441;70943;0;78.8;67.8;0.0
23;2021-08-20;222;666;0;82663;71609;0;79.0;68.4;0.0
23;2021-08-21;135;452;0;82798;72061;0;79.1;68.9;0.0
23;2021-08-22;50;39;0;82848;72100;0;79.2;68.9;0.0
23;2021-08-23;152;779;0;83000;72879;0;79.3;69.7;0.0
23;2021-08-24;265;843;0;83265;73722;0;79.6;70.5;0.0
23;2021-08-25;198;764;0;83463;74486;0;79.8;71.2;0.0
23;2021-08-26;210;698;0;83673;75184;0;80.0;71.9;0.0
23;2021-08-27;204;664;1;83877;75848;1;80.2;72.5;0.0
23;2021-08-28;206;429;0;84083;76277;1;80.4;72.9;0.0
23;2021-08-29;16;73;0;84099;76350;1;80.4;73.0;0.0
23;2021-08-30;187;617;11;84286;76967;12;80.6;73.6;0.0
23;2021-08-31;237;630;12;84523;77597;24;80.8;74.2;0.0
23;2021-09-01;164;391;37;84687;77988;61;81.0;74.5;0.1
23;2021-09-02;128;316;42;84815;78304;103;81.1;74.8;0.1
23;2021-09-03;210;518;69;85025;78822;172;81.3;75.3;0.2
23;2021-09-04;153;685;51;85178;79507;223;81.4;76.0;0.2
23;2021-09-05;5;9;2;85183;79516;225;81.4;76.0;0.2
23;2021-09-06;132;379;99;85315;79895;324;81.6;76.4;0.3
23;2021-09-07;91;368;169;85406;80263;493;81.6;76.7;0.5
23;2021-09-08;107;361;112;85513;80624;605;81.7;77.1;0.6
23;2021-09-09;110;319;74;85623;80943;679;81.8;77.4;0.6
23;2021-09-10;156;329;136;85779;81272;815;82.0;77.7;0.8
23;2021-09-11;98;211;22;85877;81483;837;82.1;77.9;0.8
23;2021-09-12;4;10;8;85881;81493;845;82.1;77.9;0.8
23;2021-09-13;111;319;80;85992;81812;925;82.2;78.2;0.9
23;2021-09-14;101;294;174;86093;82106;1099;82.3;78.5;1.1
23;2021-09-15;87;269;85;86180;82375;1184;82.4;78.7;1.1
23;2021-09-16;116;150;144;86296;82525;1328;82.5;78.9;1.3
23;2021-09-17;152;245;127;86448;82770;1455;82.6;79.1;1.4
23;2021-09-18;40;212;26;86488;82982;1481;82.7;79.3;1.4
23;2021-09-19;6;6;1;86494;82988;1482;82.7;79.3;1.4
23;2021-09-20;61;212;138;86555;83200;1620;82.7;79.5;1.5
23;2021-09-21;74;180;222;86629;83380;1842;82.8;79.7;1.8
23;2021-09-22;67;252;187;86696;83632;2029;82.9;79.9;1.9
23;2021-09-23;64;139;216;86760;83771;2245;82.9;80.1;2.1
23;2021-09-24;79;231;174;86839;84002;2419;83.0;80.3;2.3
23;2021-09-25;37;134;57;86876;84136;2476;83.0;80.4;2.4
23;2021-09-26;1;2;3;86877;84138;2479;83.0;80.4;2.4
23;2021-09-27;36;153;158;86913;84291;2637;83.1;80.6;2.5
23;2021-09-28;44;121;180;86957;84412;2817;83.1;80.7;2.7
23;2021-09-29;66;154;234;87023;84566;3051;83.2;80.8;2.9
23;2021-09-30;47;63;139;87070;84629;3190;83.2;80.9;3.0
23;2021-10-01;93;179;204;87163;84808;3394;83.3;81.1;3.2
23;2021-10-02;27;94;50;87190;84902;3444;83.3;81.2;3.3
23;2021-10-03;2;6;17;87192;84908;3461;83.3;81.2;3.3
23;2021-10-04;46;82;177;87238;84990;3638;83.4;81.2;3.5
23;2021-10-05;36;83;214;87274;85073;3852;83.4;81.3;3.7
23;2021-10-06;50;95;128;87324;85168;3980;83.5;81.4;3.8
23;2021-10-07;60;116;203;87384;85284;4183;83.5;81.5;4.0
23;2021-10-08;58;191;223;87442;85475;4406;83.6;81.7;4.2
23;2021-10-09;22;50;43;87464;85525;4449;83.6;81.8;4.3
23;2021-10-10;0;0;0;87464;85525;4449;83.6;81.8;4.3
23;2021-10-11;20;93;214;87484;85618;4663;83.6;81.8;4.5
23;2021-10-12;50;86;171;87534;85704;4834;83.7;81.9;4.6
23;2021-10-13;46;75;176;87580;85779;5010;83.7;82.0;4.8
23;2021-10-14;38;68;106;87618;85847;5116;83.8;82.1;4.9
23;2021-10-15;76;101;211;87694;85948;5327;83.8;82.2;5.1
23;2021-10-16;34;43;53;87728;85991;5380;83.9;82.2;5.1
23;2021-10-17;1;3;1;87729;85994;5381;83.9;82.2;5.1
23;2021-10-18;49;70;216;87778;86064;5597;83.9;82.3;5.4
23;2021-10-19;35;41;171;87813;86105;5768;83.9;82.3;5.5
23;2021-10-20;46;52;187;87859;86157;5955;84.0;82.4;5.7
23;2021-10-21;24;62;155;87883;86219;6110;84.0;82.4;5.8
23;2021-10-22;36;123;296;87919;86342;6406;84.0;82.5;6.1
23;2021-10-23;27;45;86;87946;86387;6492;84.1;82.6;6.2
23;2021-10-24;6;3;9;87952;86390;6501;84.1;82.6;6.2
23;2021-10-25;43;58;292;87995;86448;6793;84.1;82.6;6.5
23;2021-10-26;34;39;280;88029;86487;7073;84.1;82.7;6.8
23;2021-10-27;20;33;211;88049;86520;7284;84.2;82.7;7.0
23;2021-10-28;31;41;253;88080;86561;7537;84.2;82.7;7.2
23;2021-10-29;45;76;277;88125;86637;7814;84.2;82.8;7.5
23;2021-10-30;33;17;32;88158;86654;7846;84.3;82.8;7.5
23;2021-10-31;1;0;0;88159;86654;7846;84.3;82.8;7.5
23;2021-11-01;0;0;0;88159;86654;7846;84.3;82.8;7.5
23;2021-11-02;37;45;350;88196;86699;8196;84.3;82.9;7.8
23;2021-11-03;26;40;293;88222;86739;8489;84.3;82.9;8.1
23;2021-11-04;25;33;240;88247;86772;8729;84.4;82.9;8.3
23;2021-11-05;44;86;456;88291;86858;9185;84.4;83.0;8.8
23;2021-11-06;22;23;114;88313;86881;9299;84.4;83.0;8.9
23;2021-11-07;3;8;28;88316;86889;9327;84.4;83.1;8.9
23;2021-11-08;21;42;341;88337;86931;9668;84.4;83.1;9.2
23;2021-11-09;40;47;495;88377;86978;10163;84.5;83.1;9.7
23;2021-11-10;33;62;284;88410;87040;10447;84.5;83.2;10.0
23;2021-11-11;0;1;21;88410;87041;10468;84.5;83.2;10.0
23;2021-11-12;31;56;447;88441;87097;10915;84.5;83.3;10.4
23;2021-11-13;14;30;131;88455;87127;11046;84.6;83.3;10.6
23;2021-11-14;0;1;2;88455;87128;11048;84.6;83.3;10.6
23;2021-11-15;26;41;342;88481;87169;11390;84.6;83.3;10.9
23;2021-11-16;25;48;594;88506;87217;11984;84.6;83.4;11.5
23;2021-11-17;30;39;385;88536;87256;12369;84.6;83.4;11.8
23;2021-11-18;39;35;484;88575;87291;12853;84.7;83.4;12.3
23;2021-11-19;49;69;573;88624;87360;13426;84.7;83.5;12.8
23;2021-11-20;19;29;190;88643;87389;13616;84.7;83.5;13.0
23;2021-11-21;0;2;12;88643;87391;13628;84.7;83.5;13.0
23;2021-11-22;32;17;392;88675;87408;14020;84.8;83.6;13.4
23;2021-11-23;40;34;673;88715;87442;14693;84.8;83.6;14.0
23;2021-11-24;49;36;598;88764;87478;15291;84.8;83.6;14.6
23;2021-11-25;35;20;486;88799;87498;15777;84.9;83.6;15.1
23;2021-11-26;60;56;806;88859;87554;16583;84.9;83.7;15.9
23;2021-11-27;38;36;545;88897;87590;17128;85.0;83.7;16.4
23;2021-11-28;5;1;19;88902;87591;17147;85.0;83.7;16.4
23;2021-11-29;14;21;535;88916;87612;17682;85.0;83.7;16.9
23;2021-11-30;46;47;987;88962;87659;18669;85.0;83.8;17.8
23;2021-12-01;49;34;1175;89011;87693;19844;85.1;83.8;19.0
23;2021-12-02;30;18;1221;89041;87711;21065;85.1;83.8;20.1
23;2021-12-03;42;27;1169;89083;87738;22234;85.2;83.9;21.3
23;2021-12-04;31;27;947;89114;87765;23181;85.2;83.9;22.2
23;2021-12-05;8;0;256;89122;87765;23437;85.2;83.9;22.4
23;2021-12-06;18;24;677;89140;87789;24114;85.2;83.9;23.1
23;2021-12-07;32;20;1274;89172;87809;25388;85.2;83.9;24.3
23;2021-12-08;44;39;1392;89216;87848;26780;85.3;84.0;25.6
23;2021-12-09;27;34;1255;89243;87882;28035;85.3;84.0;26.8
23;2021-12-10;38;45;1392;89281;87927;29427;85.3;84.0;28.1
23;2021-12-11;41;29;1314;89322;87956;30741;85.4;84.1;29.4
23;2021-12-12;4;4;67;89326;87960;30808;85.4;84.1;29.4
23;2021-12-13;21;25;1095;89347;87985;31903;85.4;84.1;30.5
23;2021-12-14;57;39;1792;89404;88024;33695;85.5;84.1;32.2
23;2021-12-15;30;41;1330;89434;88065;35025;85.5;84.2;33.5
23;2021-12-16;56;56;1286;89490;88121;36311;85.5;84.2;34.7
23;2021-12-17;48;63;1480;89538;88184;37791;85.6;84.3;36.1
23;2021-12-18;49;46;1228;89587;88230;39019;85.6;84.3;37.3
23;2021-12-19;5;1;259;89592;88231;39278;85.6;84.3;37.5
24;2020-12-27;0;0;0;0;0;0;0.0;0.0;0.0
24;2020-12-28;0;0;0;0;0;0;0.0;0.0;0.0
24;2020-12-29;2;0;0;2;0;0;0.0;0.0;0.0
24;2020-12-30;1;0;0;3;0;0;0.0;0.0;0.0
24;2020-12-31;0;0;0;3;0;0;0.0;0.0;0.0
24;2021-01-01;1;0;0;4;0;0;0.0;0.0;0.0
24;2021-01-02;0;0;0;4;0;0;0.0;0.0;0.0
24;2021-01-03;1;0;0;5;0;0;0.0;0.0;0.0
24;2021-01-04;1;0;0;6;0;0;0.0;0.0;0.0
24;2021-01-05;0;0;0;6;0;0;0.0;0.0;0.0
24;2021-01-06;4;0;0;10;0;0;0.0;0.0;0.0
24;2021-01-07;201;0;0;211;0;0;0.1;0.0;0.0
24;2021-01-08;284;0;0;495;0;0;0.1;0.0;0.0
24;2021-01-09;184;13;0;679;13;0;0.2;0.0;0.0
24;2021-01-10;36;0;0;715;13;0;0.2;0.0;0.0
24;2021-01-11;258;0;0;973;13;0;0.3;0.0;0.0
24;2021-01-12;309;0;0;1282;13;0;0.4;0.0;0.0
24;2021-01-13;263;1;0;1545;14;0;0.4;0.0;0.0
24;2021-01-14;982;24;0;2527;38;0;0.7;0.0;0.0
24;2021-01-15;601;6;0;3128;44;0;0.9;0.0;0.0
24;2021-01-16;92;0;0;3220;44;0;0.9;0.0;0.0
24;2021-01-17;4;1;0;3224;45;0;0.9;0.0;0.0
24;2021-01-18;348;2;0;3572;47;0;1.0;0.0;0.0
24;2021-01-19;512;2;0;4084;49;0;1.1;0.0;0.0
24;2021-01-20;585;0;0;4669;49;0;1.3;0.0;0.0
24;2021-01-21;690;5;0;5359;54;0;1.5;0.0;0.0
24;2021-01-22;585;1;0;5944;55;0;1.6;0.0;0.0
24;2021-01-23;163;1;0;6107;56;0;1.7;0.0;0.0
24;2021-01-24;13;0;0;6120;56;0;1.7;0.0;0.0
24;2021-01-25;488;0;0;6608;56;0;1.8;0.0;0.0
24;2021-01-26;680;64;0;7288;120;0;2.0;0.0;0.0
24;2021-01-27;1162;14;0;8450;134;0;2.3;0.0;0.0
24;2021-01-28;1000;115;0;9450;249;0;2.6;0.1;0.0
24;2021-01-29;912;140;0;10362;389;0;2.8;0.1;0.0
24;2021-01-30;268;1;0;10630;390;0;2.9;0.1;0.0
24;2021-01-31;10;4;0;10640;394;0;2.9;0.1;0.0
24;2021-02-01;397;175;0;11037;569;0;3.0;0.2;0.0
24;2021-02-02;624;323;0;11661;892;0;3.2;0.2;0.0
24;2021-02-03;648;488;0;12309;1380;0;3.4;0.4;0.0
24;2021-02-04;985;427;0;13294;1807;0;3.6;0.5;0.0
24;2021-02-05;667;418;0;13961;2225;0;3.8;0.6;0.0
24;2021-02-06;143;35;0;14104;2260;0;3.9;0.6;0.0
24;2021-02-07;31;3;0;14135;2263;0;3.9;0.6;0.0
24;2021-02-08;330;246;0;14465;2509;0;4.0;0.7;0.0
24;2021-02-09;480;252;0;14945;2761;0;4.1;0.8;0.0
24;2021-02-10;429;189;0;15374;2950;0;4.2;0.8;0.0
24;2021-02-11;589;564;0;15963;3514;0;4.4;1.0;0.0
24;2021-02-12;515;396;0;16478;3910;0;4.5;1.1;0.0
24;2021-02-13;199;51;0;16677;3961;0;4.6;1.1;0.0
24;2021-02-14;90;8;0;16767;3969;0;4.6;1.1;0.0
24;2021-02-15;201;275;0;16968;4244;0;4.6;1.2;0.0
24;2021-02-16;338;541;0;17306;4785;0;4.7;1.3;0.0
24;2021-02-17;547;827;0;17853;5612;0;4.9;1.5;0.0
24;2021-02-18;435;771;0;18288;6383;0;5.0;1.7;0.0
24;2021-02-19;472;677;0;18760;7060;0;5.1;1.9;0.0
24;2021-02-20;164;151;0;18924;7211;0;5.2;2.0;0.0
24;2021-02-21;107;3;0;19031;7214;0;5.2;2.0;0.0
24;2021-02-22;447;517;0;19478;7731;0;5.3;2.1;0.0
24;2021-02-23;546;677;0;20024;8408;0;5.5;2.3;0.0
24;2021-02-24;534;795;0;20558;9203;0;5.6;2.5;0.0
24;2021-02-25;753;881;0;21311;10084;0;5.8;2.8;0.0
24;2021-02-26;1010;929;0;22321;11013;0;6.1;3.0;0.0
24;2021-02-27;384;265;0;22705;11278;0;6.2;3.1;0.0
24;2021-02-28;19;14;0;22724;11292;0;6.2;3.1;0.0
24;2021-03-01;347;412;0;23071;11704;0;6.3;3.2;0.0
24;2021-03-02;559;477;0;23630;12181;0;6.5;3.3;0.0
24;2021-03-03;678;368;0;24308;12549;0;6.7;3.4;0.0
24;2021-03-04;944;547;0;25252;13096;0;6.9;3.6;0.0
24;2021-03-05;1059;577;0;26311;13673;0;7.2;3.7;0.0
24;2021-03-06;1166;146;0;27477;13819;0;7.5;3.8;0.0
24;2021-03-07;201;62;0;27678;13881;0;7.6;3.8;0.0
24;2021-03-08;613;284;0;28291;14165;0;7.7;3.9;0.0
24;2021-03-09;1172;462;0;29463;14627;0;8.1;4.0;0.0
24;2021-03-10;1194;479;0;30657;15106;0;8.4;4.1;0.0
24;2021-03-11;1701;497;0;32358;15603;0;8.9;4.3;0.0
24;2021-03-12;2185;459;0;34543;16062;0;9.5;4.4;0.0
24;2021-03-13;1424;188;0;35967;16250;0;9.8;4.4;0.0
24;2021-03-14;132;95;0;36099;16345;0;9.9;4.5;0.0
24;2021-03-15;1031;196;0;37130;16541;0;10.2;4.5;0.0
24;2021-03-16;1221;237;0;38351;16778;0;10.5;4.6;0.0
24;2021-03-17;1237;284;0;39588;17062;0;10.8;4.7;0.0
24;2021-03-18;1138;540;0;40726;17602;0;11.1;4.8;0.0
24;2021-03-19;1328;528;0;42054;18130;0;11.5;5.0;0.0
24;2021-03-20;1002;155;0;43056;18285;0;11.8;5.0;0.0
24;2021-03-21;29;12;0;43085;18297;0;11.8;5.0;0.0
24;2021-03-22;1367;429;0;44452;18726;0;12.2;5.1;0.0
24;2021-03-23;1986;396;0;46438;19122;0;12.7;5.2;0.0
24;2021-03-24;1916;384;0;48354;19506;0;13.2;5.3;0.0
24;2021-03-25;2095;510;0;50449;20016;0;13.8;5.5;0.0
24;2021-03-26;2409;297;0;52858;20313;0;14.5;5.6;0.0
24;2021-03-27;1383;44;0;54241;20357;0;14.9;5.6;0.0
24;2021-03-28;74;8;0;54315;20365;0;14.9;5.6;0.0
24;2021-03-29;1720;354;0;56035;20719;0;15.3;5.7;0.0
24;2021-03-30;2488;422;0;58523;21141;0;16.0;5.8;0.0
24;2021-03-31;2183;327;0;60706;21468;0;16.6;5.9;0.0
24;2021-04-01;2281;347;0;62987;21815;0;17.2;6.0;0.0
24;2021-04-02;2131;454;0;65118;22269;0;17.8;6.1;0.0
24;2021-04-03;1331;154;0;66449;22423;0;18.2;6.1;0.0
24;2021-04-04;73;7;0;66522;22430;0;18.2;6.1;0.0
24;2021-04-05;890;68;0;67412;22498;0;18.5;6.2;0.0
24;2021-04-06;2278;786;0;69690;23284;0;19.1;6.4;0.0
24;2021-04-07;2665;712;0;72355;23996;0;19.8;6.6;0.0
24;2021-04-08;2971;1032;0;75326;25028;0;20.6;6.9;0.0
24;2021-04-09;3338;1065;0;78664;26093;0;21.5;7.1;0.0
24;2021-04-10;2481;357;0;81145;26450;0;22.2;7.2;0.0
24;2021-04-11;1016;24;0;82161;26474;0;22.5;7.2;0.0
24;2021-04-12;2377;900;0;84538;27374;0;23.1;7.5;0.0
24;2021-04-13;2805;1241;0;87343;28615;0;23.9;7.8;0.0
24;2021-04-14;2908;1206;0;90251;29821;0;24.7;8.2;0.0
24;2021-04-15;2813;1175;0;93064;30996;0;25.5;8.5;0.0
24;2021-04-16;3229;1051;0;96293;32047;0;26.4;8.8;0.0
24;2021-04-17;2245;452;0;98538;32499;0;27.0;8.9;0.0
24;2021-04-18;437;3;0;98975;32502;0;27.1;8.9;0.0
24;2021-04-19;1636;1120;0;100611;33622;0;27.5;9.2;0.0
24;2021-04-20;2329;1541;0;102940;35163;0;28.2;9.6;0.0
24;2021-04-21;2348;1486;0;105288;36649;0;28.8;10.0;0.0
24;2021-04-22;2236;1399;0;107524;38048;0;29.4;10.4;0.0
24;2021-04-23;1986;1443;0;109510;39491;0;30.0;10.8;0.0
24;2021-04-24;738;736;0;110248;40227;0;30.2;11.0;0.0
24;2021-04-25;66;10;0;110314;40237;0;30.2;11.0;0.0
24;2021-04-26;1417;1500;0;111731;41737;0;30.6;11.4;0.0
24;2021-04-27;1917;1923;0;113648;43660;0;31.1;12.0;0.0
24;2021-04-28;1673;1949;0;115321;45609;0;31.6;12.5;0.0
24;2021-04-29;1824;1944;0;117145;47553;0;32.1;13.0;0.0
24;2021-04-30;2331;1775;0;119476;49328;0;32.7;13.5;0.0
24;2021-05-01;1916;1012;0;121392;50340;0;33.2;13.8;0.0
24;2021-05-02;1835;207;0;123227;50547;0;33.7;13.8;0.0
24;2021-05-03;1675;1784;0;124902;52331;0;34.2;14.3;0.0
24;2021-05-04;2396;2271;0;127298;54602;0;34.9;14.9;0.0
24;2021-05-05;2051;2671;0;129349;57273;0;35.4;15.7;0.0
24;2021-05-06;2146;2713;0;131495;59986;0;36.0;16.4;0.0
24;2021-05-07;2450;2743;0;133945;62729;0;36.7;17.2;0.0
24;2021-05-08;1338;1100;0;135283;63829;0;37.0;17.5;0.0
24;2021-05-09;1113;821;0;136396;64650;0;37.3;17.7;0.0
24;2021-05-10;1368;2541;0;137764;67191;0;37.7;18.4;0.0
24;2021-05-11;2232;2681;0;139996;69872;0;38.3;19.1;0.0
24;2021-05-12;2059;2299;0;142055;72171;0;38.9;19.8;0.0
24;2021-05-13;1592;1169;0;143647;73340;0;39.3;20.1;0.0
24;2021-05-14;2574;1397;0;146221;74737;0;40.0;20.5;0.0
24;2021-05-15;2074;867;0;148295;75604;0;40.6;20.7;0.0
24;2021-05-16;1094;351;0;149389;75955;0;40.9;20.8;0.0
24;2021-05-17;2295;1291;0;151684;77246;0;41.5;21.1;0.0
24;2021-05-18;2606;1799;0;154290;79045;0;42.2;21.6;0.0
24;2021-05-19;2398;1366;0;156688;80411;0;42.9;22.0;0.0
24;2021-05-20;2599;1538;0;159287;81949;0;43.6;22.4;0.0
24;2021-05-21;2557;1378;0;161844;83327;0;44.3;22.8;0.0
24;2021-05-22;1696;455;0;163540;83782;0;44.8;22.9;0.0
24;2021-05-23;817;64;0;164357;83846;0;45.0;23.0;0.0
24;2021-05-24;1367;304;0;165724;84150;0;45.4;23.0;0.0
24;2021-05-25;2252;1411;0;167976;85561;0;46.0;23.4;0.0
24;2021-05-26;2172;1343;0;170148;86904;0;46.6;23.8;0.0
24;2021-05-27;1899;2135;0;172047;89039;0;47.1;24.4;0.0
24;2021-05-28;2182;2028;0;174229;91067;0;47.7;24.9;0.0
24;2021-05-29;1119;2062;0;175348;93129;0;48.0;25.5;0.0
24;2021-05-30;1149;163;0;176497;93292;0;48.3;25.5;0.0
24;2021-05-31;1732;1414;0;178229;94706;0;48.8;25.9;0.0
24;2021-06-01;2634;2005;0;180863;96711;0;49.5;26.5;0.0
24;2021-06-02;2597;1883;0;183460;98594;0;50.2;27.0;0.0
24;2021-06-03;2281;1549;0;185741;100143;0;50.9;27.4;0.0
24;2021-06-04;2373;2021;0;188114;102164;0;51.5;28.0;0.0
24;2021-06-05;1822;1399;0;189936;103563;0;52.0;28.4;0.0
24;2021-06-06;690;221;0;190626;103784;0;52.2;28.4;0.0
24;2021-06-07;1464;1650;0;192090;105434;0;52.6;28.9;0.0
24;2021-06-08;1677;2110;0;193767;107544;0;53.0;29.4;0.0
24;2021-06-09;1422;1729;0;195189;109273;0;53.4;29.9;0.0
24;2021-06-10;1700;1946;0;196889;111219;0;53.9;30.4;0.0
24;2021-06-11;1375;2317;0;198264;113536;0;54.3;31.1;0.0
24;2021-06-12;1098;2508;0;199362;116044;0;54.6;31.8;0.0
24;2021-06-13;1053;882;0;200415;116926;0;54.9;32.0;0.0
24;2021-06-14;1165;2105;0;201580;119031;0;55.2;32.6;0.0
24;2021-06-15;1543;3244;0;203123;122275;0;55.6;33.5;0.0
24;2021-06-16;1717;2865;0;204840;125140;0;56.1;34.3;0.0
24;2021-06-17;1593;2296;0;206433;127436;0;56.5;34.9;0.0
24;2021-06-18;1496;3034;0;207929;130470;0;56.9;35.7;0.0
24;2021-06-19;1202;1609;0;209131;132079;0;57.3;36.2;0.0
24;2021-06-20;470;466;0;209601;132545;0;57.4;36.3;0.0
24;2021-06-21;919;2058;0;210520;134603;0;57.6;36.9;0.0
24;2021-06-22;1348;2644;0;211868;137247;0;58.0;37.6;0.0
24;2021-06-23;1353;2518;0;213221;139765;0;58.4;38.3;0.0
24;2021-06-24;1173;2041;0;214394;141806;0;58.7;38.8;0.0
24;2021-06-25;1023;3009;0;215417;144815;0;59.0;39.6;0.0
24;2021-06-26;802;2158;0;216219;146973;0;59.2;40.2;0.0
24;2021-06-27;385;924;0;216604;147897;0;59.3;40.5;0.0
24;2021-06-28;799;2660;0;217403;150557;0;59.5;41.2;0.0
24;2021-06-29;936;3027;0;218339;153584;0;59.8;42.0;0.0
24;2021-06-30;1078;2651;0;219417;156235;0;60.1;42.8;0.0
24;2021-07-01;1148;2455;0;220565;158690;0;60.4;43.4;0.0
24;2021-07-02;1088;2840;0;221653;161530;0;60.7;44.2;0.0
24;2021-07-03;752;1863;0;222405;163393;0;60.9;44.7;0.0
24;2021-07-04;357;908;0;222762;164301;0;61.0;45.0;0.0
24;2021-07-05;758;2359;0;223520;166660;0;61.2;45.6;0.0
24;2021-07-06;892;3412;0;224412;170072;0;61.4;46.6;0.0
24;2021-07-07;1026;3065;0;225438;173137;0;61.7;47.4;0.0
24;2021-07-08;1345;2154;0;226783;175291;0;62.1;48.0;0.0
24;2021-07-09;1114;3183;0;227897;178474;0;62.4;48.9;0.0
24;2021-07-10;486;1886;0;228383;180360;0;62.5;49.4;0.0
24;2021-07-11;538;983;0;228921;181343;0;62.7;49.6;0.0
24;2021-07-12;864;2573;0;229785;183916;0;62.9;50.4;0.0
24;2021-07-13;1322;3233;0;231107;187149;0;63.3;51.2;0.0
24;2021-07-14;628;1066;0;231735;188215;0;63.4;51.5;0.0
24;2021-07-15;1619;2726;0;233354;190941;0;63.9;52.3;0.0
24;2021-07-16;2102;2536;0;235456;193477;0;64.5;53.0;0.0
24;2021-07-17;1375;2092;0;236831;195569;0;64.8;53.5;0.0
24;2021-07-18;645;806;0;237476;196375;0;65.0;53.8;0.0
24;2021-07-19;1555;2212;0;239031;198587;0;65.4;54.4;0.0
24;2021-07-20;2003;2499;0;241034;201086;0;66.0;55.1;0.0
24;2021-07-21;1925;2310;0;242959;203396;0;66.5;55.7;0.0
24;2021-07-22;2491;2436;0;245450;205832;0;67.2;56.4;0.0
24;2021-07-23;2306;2537;0;247756;208369;0;67.8;57.0;0.0
24;2021-07-24;1731;1527;0;249487;209896;0;68.3;57.5;0.0
24;2021-07-25;796;760;0;250283;210656;0;68.5;57.7;0.0
24;2021-07-26;1553;2005;0;251836;212661;0;68.9;58.2;0.0
24;2021-07-27;2810;2215;0;254646;214876;0;69.7;58.8;0.0
24;2021-07-28;2642;1860;0;257288;216736;0;70.4;59.3;0.0
24;2021-07-29;2981;2164;0;260269;218900;0;71.3;59.9;0.0
24;2021-07-30;2539;1915;0;262808;220815;0;72.0;60.5;0.0
24;2021-07-31;1580;1462;0;264388;222277;0;72.4;60.9;0.0
24;2021-08-01;1018;587;0;265406;222864;0;72.7;61.0;0.0
24;2021-08-02;1947;1581;0;267353;224445;0;73.2;61.4;0.0
24;2021-08-03;2735;1826;0;270088;226271;0;73.9;61.9;0.0
24;2021-08-04;2879;1468;0;272967;227739;0;74.7;62.4;0.0
24;2021-08-05;2849;1348;0;275816;229087;0;75.5;62.7;0.0
24;2021-08-06;2390;1463;0;278206;230550;0;76.2;63.1;0.0
24;2021-08-07;1723;1040;0;279929;231590;0;76.6;63.4;0.0
24;2021-08-08;1005;562;0;280934;232152;0;76.9;63.6;0.0
24;2021-08-09;1583;1339;0;282517;233491;0;77.3;63.9;0.0
24;2021-08-10;2202;1747;0;284719;235238;0;78.0;64.4;0.0
24;2021-08-11;2127;1610;0;286846;236848;0;78.5;64.8;0.0
24;2021-08-12;1872;1866;0;288718;238714;0;79.0;65.4;0.0
24;2021-08-13;1535;1583;0;290253;240297;0;79.5;65.8;0.0
24;2021-08-14;1094;1166;0;291347;241463;0;79.8;66.1;0.0
24;2021-08-15;622;488;0;291969;241951;0;79.9;66.2;0.0
24;2021-08-16;1138;1608;0;293107;243559;0;80.2;66.7;0.0
24;2021-08-17;1541;2030;0;294648;245589;0;80.7;67.2;0.0
24;2021-08-18;1412;1784;0;296060;247373;0;81.1;67.7;0.0
24;2021-08-19;1110;2459;0;297170;249832;0;81.4;68.4;0.0
24;2021-08-20;1092;2412;0;298262;252244;0;81.7;69.1;0.0
24;2021-08-21;781;1562;0;299043;253806;0;81.9;69.5;0.0
24;2021-08-22;290;974;0;299333;254780;0;82.0;69.8;0.0
24;2021-08-23;700;2057;0;300033;256837;0;82.1;70.3;0.0
24;2021-08-24;833;2354;0;300866;259191;0;82.4;71.0;0.0
24;2021-08-25;818;2308;0;301684;261499;0;82.6;71.6;0.0
24;2021-08-26;749;2711;0;302433;264210;0;82.8;72.3;0.0
24;2021-08-27;824;2811;0;303257;267021;0;83.0;73.1;0.0
24;2021-08-28;504;1804;0;303761;268825;0;83.2;73.6;0.0
24;2021-08-29;157;897;0;303918;269722;0;83.2;73.8;0.0
24;2021-08-30;431;2062;17;304349;271784;17;83.3;74.4;0.0
24;2021-08-31;633;2493;55;304982;274277;72;83.5;75.1;0.0
24;2021-09-01;662;2280;101;305644;276557;173;83.7;75.7;0.0
24;2021-09-02;484;1856;122;306128;278413;295;83.8;76.2;0.1
24;2021-09-03;575;2148;180;306703;280561;475;84.0;76.8;0.1
24;2021-09-04;365;1847;64;307068;282408;539;84.1;77.3;0.1
24;2021-09-05;228;848;45;307296;283256;584;84.1;77.5;0.2
24;2021-09-06;324;1462;165;307620;284718;749;84.2;77.9;0.2
24;2021-09-07;485;1676;260;308105;286394;1009;84.4;78.4;0.3
24;2021-09-08;428;1773;172;308533;288167;1181;84.5;78.9;0.3
24;2021-09-09;367;1116;232;308900;289283;1413;84.6;79.2;0.4
24;2021-09-10;408;1643;207;309308;290926;1620;84.7;79.6;0.4
24;2021-09-11;318;1568;70;309626;292494;1690;84.8;80.1;0.5
24;2021-09-12;93;315;59;309719;292809;1749;84.8;80.2;0.5
24;2021-09-13;315;981;221;310034;293790;1970;84.9;80.4;0.5
24;2021-09-14;441;916;306;310475;294706;2276;85.0;80.7;0.6
24;2021-09-15;450;1290;398;310925;295996;2674;85.1;81.0;0.7
24;2021-09-16;290;888;269;311215;296884;2943;85.2;81.3;0.8
24;2021-09-17;413;1047;331;311628;297931;3274;85.3;81.6;0.9
24;2021-09-18;300;1068;152;311928;298999;3426;85.4;81.9;0.9
24;2021-09-19;52;343;34;311980;299342;3460;85.4;82.0;0.9
24;2021-09-20;158;560;254;312138;299902;3714;85.5;82.1;1.0
24;2021-09-21;366;441;436;312504;300343;4150;85.6;82.2;1.1
24;2021-09-22;223;737;440;312727;301080;4590;85.6;82.4;1.3
24;2021-09-23;160;410;414;312887;301490;5004;85.7;82.5;1.4
24;2021-09-24;251;823;369;313138;302313;5373;85.7;82.8;1.5
24;2021-09-25;207;583;120;313345;302896;5493;85.8;82.9;1.5
24;2021-09-26;23;92;14;313368;302988;5507;85.8;83.0;1.5
24;2021-09-27;175;444;312;313543;303432;5819;85.8;83.1;1.6
24;2021-09-28;212;340;586;313755;303772;6405;85.9;83.2;1.8
24;2021-09-29;207;576;392;313962;304348;6797;86.0;83.3;1.9
24;2021-09-30;233;448;480;314195;304796;7277;86.0;83.4;2.0
24;2021-10-01;254;512;406;314449;305308;7683;86.1;83.6;2.1
24;2021-10-02;191;483;177;314640;305791;7860;86.1;83.7;2.2
24;2021-10-03;16;42;4;314656;305833;7864;86.1;83.7;2.2
24;2021-10-04;158;302;316;314814;306135;8180;86.2;83.8;2.2
24;2021-10-05;117;362;339;314931;306497;8519;86.2;83.9;2.3
24;2021-10-06;219;470;589;315150;306967;9108;86.3;84.0;2.5
24;2021-10-07;117;229;417;315267;307196;9525;86.3;84.1;2.6
24;2021-10-08;197;442;553;315464;307638;10078;86.4;84.2;2.8
24;2021-10-09;166;427;413;315630;308065;10491;86.4;84.3;2.9
24;2021-10-10;20;26;18;315650;308091;10509;86.4;84.3;2.9
24;2021-10-11;98;216;398;315748;308307;10907;86.4;84.4;3.0
24;2021-10-12;144;392;708;315892;308699;11615;86.5;84.5;3.2
24;2021-10-13;143;296;557;316035;308995;12172;86.5;84.6;3.3
24;2021-10-14;129;213;527;316164;309208;12699;86.6;84.7;3.5
24;2021-10-15;272;417;1021;316436;309625;13720;86.6;84.8;3.8
24;2021-10-16;173;326;304;316609;309951;14024;86.7;84.9;3.8
24;2021-10-17;14;30;11;316623;309981;14035;86.7;84.9;3.8
24;2021-10-18;105;154;420;316728;310135;14455;86.7;84.9;4.0
24;2021-10-19;130;250;667;316858;310385;15122;86.7;85.0;4.1
24;2021-10-20;132;240;678;316990;310625;15800;86.8;85.0;4.3
24;2021-10-21;93;240;539;317083;310865;16339;86.8;85.1;4.5
24;2021-10-22;145;221;857;317228;311086;17196;86.9;85.2;4.7
24;2021-10-23;98;207;371;317326;311293;17567;86.9;85.2;4.8
24;2021-10-24;10;12;9;317336;311305;17576;86.9;85.2;4.8
24;2021-10-25;95;133;684;317431;311438;18260;86.9;85.3;5.0
24;2021-10-26;86;132;642;317517;311570;18902;86.9;85.3;5.2
24;2021-10-27;131;184;836;317648;311754;19738;87.0;85.4;5.4
24;2021-10-28;82;143;685;317730;311897;20423;87.0;85.4;5.6
24;2021-10-29;142;190;1043;317872;312087;21466;87.0;85.4;5.9
24;2021-10-30;81;169;385;317953;312256;21851;87.0;85.5;6.0
24;2021-10-31;10;14;28;317963;312270;21879;87.1;85.5;6.0
24;2021-11-01;18;14;90;317981;312284;21969;87.1;85.5;6.0
24;2021-11-02;97;109;771;318078;312393;22740;87.1;85.5;6.2
24;2021-11-03;115;174;962;318193;312567;23702;87.1;85.6;6.5
24;2021-11-04;90;121;868;318283;312688;24570;87.1;85.6;6.7
24;2021-11-05;175;219;1217;318458;312907;25787;87.2;85.7;7.1
24;2021-11-06;100;193;633;318558;313100;26420;87.2;85.7;7.2
24;2021-11-07;11;12;55;318569;313112;26475;87.2;85.7;7.2
24;2021-11-08;77;129;877;318646;313241;27352;87.2;85.8;7.5
24;2021-11-09;116;187;1505;318762;313428;28857;87.3;85.8;7.9
24;2021-11-10;125;171;1504;318887;313599;30361;87.3;85.9;8.3
24;2021-11-11;33;37;256;318920;313636;30617;87.3;85.9;8.4
24;2021-11-12;94;168;1300;319014;313804;31917;87.3;85.9;8.7
24;2021-11-13;85;154;769;319099;313958;32686;87.4;86.0;8.9
24;2021-11-14;8;23;60;319107;313981;32746;87.4;86.0;9.0
24;2021-11-15;69;116;1068;319176;314097;33814;87.4;86.0;9.3
24;2021-11-16;100;137;1924;319276;314234;35738;87.4;86.0;9.8
24;2021-11-17;113;139;1654;319389;314373;37392;87.4;86.1;10.2
24;2021-11-18;84;93;1576;319473;314466;38968;87.5;86.1;10.7
24;2021-11-19;170;180;2207;319643;314646;41175;87.5;86.1;11.3
24;2021-11-20;128;129;1150;319771;314775;42325;87.5;86.2;11.6
24;2021-11-21;19;21;198;319790;314796;42523;87.6;86.2;11.6
24;2021-11-22;108;78;1355;319898;314874;43878;87.6;86.2;12.0
24;2021-11-23;126;130;2108;320024;315004;45986;87.6;86.2;12.6
24;2021-11-24;150;140;2083;320174;315144;48069;87.7;86.3;13.2
24;2021-11-25;125;109;2116;320299;315253;50185;87.7;86.3;13.7
24;2021-11-26;151;170;2972;320450;315423;53157;87.7;86.4;14.6
24;2021-11-27;140;147;1763;320590;315570;54920;87.8;86.4;15.0
24;2021-11-28;27;18;711;320617;315588;55631;87.8;86.4;15.2
24;2021-11-29;103;118;2508;320720;315706;58139;87.8;86.4;15.9
24;2021-11-30;139;130;3636;320859;315836;61775;87.8;86.5;16.9
24;2021-12-01;148;118;3506;321007;315954;65281;87.9;86.5;17.9
24;2021-12-02;110;91;3799;321117;316045;69080;87.9;86.5;18.9
24;2021-12-03;147;163;3971;321264;316208;73051;88.0;86.6;20.0
24;2021-12-04;94;108;2540;321358;316316;75591;88.0;86.6;20.7
24;2021-12-05;32;22;1001;321390;316338;76592;88.0;86.6;21.0
24;2021-12-06;99;89;3139;321489;316427;79731;88.0;86.6;21.8
24;2021-12-07;134;114;4713;321623;316541;84444;88.1;86.7;23.1
24;2021-12-08;144;116;4227;321767;316657;88671;88.1;86.7;24.3
24;2021-12-09;124;128;4145;321891;316785;92816;88.1;86.7;25.4
24;2021-12-10;147;148;4623;322038;316933;97439;88.2;86.8;26.7
24;2021-12-11;110;102;2870;322148;317035;100309;88.2;86.8;27.5
24;2021-12-12;34;31;1045;322182;317066;101354;88.2;86.8;27.7
24;2021-12-13;124;111;4151;322306;317177;105505;88.2;86.8;28.9
24;2021-12-14;150;145;5888;322456;317322;111393;88.3;86.9;30.5
24;2021-12-15;130;165;5281;322586;317487;116674;88.3;86.9;31.9
24;2021-12-16;143;154;5611;322729;317641;122285;88.4;87.0;33.5
24;2021-12-17;154;163;5408;322883;317804;127693;88.4;87.0;35.0
24;2021-12-18;137;151;3117;323020;317955;130810;88.4;87.0;35.8
24;2021-12-19;42;47;1616;323062;318002;132426;88.4;87.1;36.3
25;2020-12-27;0;0;0;0;0;0;0.0;0.0;0.0
25;2020-12-28;0;0;0;0;0;0;0.0;0.0;0.0
25;2020-12-29;0;0;0;0;0;0;0.0;0.0;0.0
25;2020-12-30;0;0;0;0;0;0;0.0;0.0;0.0
25;2020-12-31;2;0;0;2;0;0;0.0;0.0;0.0
25;2021-01-01;0;0;0;2;0;0;0.0;0.0;0.0
25;2021-01-02;2;0;0;4;0;0;0.0;0.0;0.0
25;2021-01-03;0;0;0;4;0;0;0.0;0.0;0.0
25;2021-01-04;3;0;0;7;0;0;0.0;0.0;0.0
25;2021-01-05;1;0;0;8;0;0;0.0;0.0;0.0
25;2021-01-06;86;1;0;94;1;0;0.0;0.0;0.0
25;2021-01-07;222;1;0;316;2;0;0.1;0.0;0.0
25;2021-01-08;393;1;0;709;3;0;0.2;0.0;0.0
25;2021-01-09;110;0;0;819;3;0;0.2;0.0;0.0
25;2021-01-10;1;0;0;820;3;0;0.2;0.0;0.0
25;2021-01-11;532;6;0;1352;9;0;0.3;0.0;0.0
25;2021-01-12;730;2;0;2082;11;0;0.5;0.0;0.0
25;2021-01-13;669;12;0;2751;23;0;0.6;0.0;0.0
25;2021-01-14;923;19;0;3674;42;0;0.8;0.0;0.0
25;2021-01-15;824;8;0;4498;50;0;1.0;0.0;0.0
25;2021-01-16;222;1;0;4720;51;0;1.0;0.0;0.0
25;2021-01-17;102;0;0;4822;51;0;1.0;0.0;0.0
25;2021-01-18;1277;6;0;6099;57;0;1.3;0.0;0.0
25;2021-01-19;1400;3;0;7499;60;0;1.6;0.0;0.0
25;2021-01-20;1480;7;0;8979;67;0;1.9;0.0;0.0
25;2021-01-21;1845;5;0;10824;72;0;2.3;0.0;0.0
25;2021-01-22;1476;8;0;12300;80;0;2.7;0.0;0.0
25;2021-01-23;488;1;0;12788;81;0;2.8;0.0;0.0
25;2021-01-24;113;0;0;12901;81;0;2.8;0.0;0.0
25;2021-01-25;1005;2;0;13906;83;0;3.0;0.0;0.0
25;2021-01-26;1429;41;0;15335;124;0;3.3;0.0;0.0
25;2021-01-27;1271;67;0;16606;191;0;3.6;0.0;0.0
25;2021-01-28;1122;85;0;17728;276;0;3.8;0.1;0.0
25;2021-01-29;978;272;0;18706;548;0;4.0;0.1;0.0
25;2021-01-30;317;103;0;19023;651;0;4.1;0.1;0.0
25;2021-01-31;7;0;0;19030;651;0;4.1;0.1;0.0
25;2021-02-01;619;261;0;19649;912;0;4.2;0.2;0.0
25;2021-02-02;678;450;0;20327;1362;0;4.4;0.3;0.0
25;2021-02-03;801;320;0;21128;1682;0;4.6;0.4;0.0
25;2021-02-04;737;495;0;21865;2177;0;4.7;0.5;0.0
25;2021-02-05;551;475;0;22416;2652;0;4.8;0.6;0.0
25;2021-02-06;217;173;0;22633;2825;0;4.9;0.6;0.0
25;2021-02-07;2;34;0;22635;2859;0;4.9;0.6;0.0
25;2021-02-08;616;546;0;23251;3405;0;5.0;0.7;0.0
25;2021-02-09;639;516;0;23890;3921;0;5.2;0.8;0.0
25;2021-02-10;769;522;0;24659;4443;0;5.3;1.0;0.0
25;2021-02-11;636;829;0;25295;5272;0;5.5;1.1;0.0
25;2021-02-12;448;560;0;25743;5832;0;5.6;1.3;0.0
25;2021-02-13;97;141;0;25840;5973;0;5.6;1.3;0.0
25;2021-02-14;1;3;0;25841;5976;0;5.6;1.3;0.0
25;2021-02-15;182;1053;0;26023;7029;0;5.6;1.5;0.0
25;2021-02-16;221;1429;0;26244;8458;0;5.7;1.8;0.0
25;2021-02-17;165;1349;0;26409;9807;0;5.7;2.1;0.0
25;2021-02-18;156;1336;0;26565;11143;0;5.7;2.4;0.0
25;2021-02-19;121;1272;0;26686;12415;0;5.8;2.7;0.0
25;2021-02-20;25;472;0;26711;12887;0;5.8;2.8;0.0
25;2021-02-21;0;136;0;26711;13023;0;5.8;2.8;0.0
25;2021-02-22;117;1092;0;26828;14115;0;5.8;3.1;0.0
25;2021-02-23;201;1147;0;27029;15262;0;5.8;3.3;0.0
25;2021-02-24;153;1034;0;27182;16296;0;5.9;3.5;0.0
25;2021-02-25;505;1061;0;27687;17357;0;6.0;3.8;0.0
25;2021-02-26;605;1079;0;28292;18436;0;6.1;4.0;0.0
25;2021-02-27;227;375;0;28519;18811;0;6.2;4.1;0.0
25;2021-02-28;6;5;0;28525;18816;0;6.2;4.1;0.0
25;2021-03-01;480;628;0;29005;19444;0;6.3;4.2;0.0
25;2021-03-02;632;837;0;29637;20281;0;6.4;4.4;0.0
25;2021-03-03;589;780;0;30226;21061;0;6.5;4.6;0.0
25;2021-03-04;1196;684;0;31422;21745;0;6.8;4.7;0.0
25;2021-03-05;1866;406;0;33288;22151;0;7.2;4.8;0.0
25;2021-03-06;1225;251;0;34513;22402;0;7.5;4.8;0.0
25;2021-03-07;30;15;0;34543;22417;0;7.5;4.8;0.0
25;2021-03-08;597;700;0;35140;23117;0;7.6;5.0;0.0
25;2021-03-09;1115;780;0;36255;23897;0;7.8;5.2;0.0
25;2021-03-10;1211;654;0;37466;24551;0;8.1;5.3;0.0
25;2021-03-11;1648;586;0;39114;25137;0;8.5;5.4;0.0
25;2021-03-12;2004;477;0;41118;25614;0;8.9;5.5;0.0
25;2021-03-13;1145;101;0;42263;25715;0;9.1;5.6;0.0
25;2021-03-14;50;2;0;42313;25717;0;9.1;5.6;0.0
25;2021-03-15;1153;157;0;43466;25874;0;9.4;5.6;0.0
25;2021-03-16;1276;131;0;44742;26005;0;9.7;5.6;0.0
25;2021-03-17;1471;153;0;46213;26158;0;10.0;5.7;0.0
25;2021-03-18;1551;91;0;47764;26249;0;10.3;5.7;0.0
25;2021-03-19;1689;135;0;49453;26384;0;10.7;5.7;0.0
25;2021-03-20;841;42;0;50294;26426;0;10.9;5.7;0.0
25;2021-03-21;26;0;0;50320;26426;0;10.9;5.7;0.0
25;2021-03-22;1488;105;0;51808;26531;0;11.2;5.7;0.0
25;2021-03-23;2215;172;0;54023;26703;0;11.7;5.8;0.0
25;2021-03-24;2483;111;0;56506;26814;0;12.2;5.8;0.0
25;2021-03-25;2926;216;0;59432;27030;0;12.8;5.8;0.0
25;2021-03-26;3219;208;0;62651;27238;0;13.5;5.9;0.0
25;2021-03-27;1193;110;0;63844;27348;0;13.8;5.9;0.0
25;2021-03-28;119;61;0;63963;27409;0;13.8;5.9;0.0
25;2021-03-29;1844;301;0;65807;27710;0;14.2;6.0;0.0
25;2021-03-30;2286;462;0;68093;28172;0;14.7;6.1;0.0
25;2021-03-31;2218;416;0;70311;28588;0;15.2;6.2;0.0
25;2021-04-01;2515;567;0;72826;29155;0;15.7;6.3;0.0
25;2021-04-02;2116;624;0;74942;29779;0;16.2;6.4;0.0
25;2021-04-03;519;134;0;75461;29913;0;16.3;6.5;0.0
25;2021-04-04;42;20;0;75503;29933;0;16.3;6.5;0.0
25;2021-04-05;146;5;0;75649;29938;0;16.4;6.5;0.0
25;2021-04-06;1926;727;0;77575;30665;0;16.8;6.6;0.0
25;2021-04-07;1971;930;0;79546;31595;0;17.2;6.8;0.0
25;2021-04-08;2470;937;0;82016;32532;0;17.7;7.0;0.0
25;2021-04-09;2641;1047;0;84657;33579;0;18.3;7.3;0.0
25;2021-04-10;1002;322;0;85659;33901;0;18.5;7.3;0.0
25;2021-04-11;98;31;0;85757;33932;0;18.5;7.3;0.0
25;2021-04-12;1659;1028;0;87416;34960;0;18.9;7.6;0.0
25;2021-04-13;2056;1415;0;89472;36375;0;19.3;7.9;0.0
25;2021-04-14;1885;1278;0;91357;37653;0;19.8;8.1;0.0
25;2021-04-15;2061;1390;0;93418;39043;0;20.2;8.4;0.0
25;2021-04-16;2135;1060;0;95553;40103;0;20.7;8.7;0.0
25;2021-04-17;1131;472;0;96684;40575;0;20.9;8.8;0.0
25;2021-04-18;126;20;0;96810;40595;0;20.9;8.8;0.0
25;2021-04-19;1370;1291;0;98180;41886;0;21.2;9.1;0.0
25;2021-04-20;1658;1534;0;99838;43420;0;21.6;9.4;0.0
25;2021-04-21;1752;1719;0;101590;45139;0;22.0;9.8;0.0
25;2021-04-22;1931;1683;0;103521;46822;0;22.4;10.1;0.0
25;2021-04-23;1955;1809;0;105476;48631;0;22.8;10.5;0.0
25;2021-04-24;1324;768;0;106800;49399;0;23.1;10.7;0.0
25;2021-04-25;131;110;0;106931;49509;0;23.1;10.7;0.0
25;2021-04-26;1791;1774;0;108722;51283;0;23.5;11.1;0.0
25;2021-04-27;2823;1618;0;111545;52901;0;24.1;11.4;0.0
25;2021-04-28;2544;1556;0;114089;54457;0;24.7;11.8;0.0
25;2021-04-29;2774;1974;0;116863;56431;0;25.3;12.2;0.0
25;2021-04-30;3264;1634;0;120127;58065;0;26.0;12.6;0.0
25;2021-05-01;1723;315;0;121850;58380;0;26.3;12.6;0.0
25;2021-05-02;409;25;0;122259;58405;0;26.4;12.6;0.0
25;2021-05-03;2878;886;0;125137;59291;0;27.1;12.8;0.0
25;2021-05-04;2610;1910;0;127747;61201;0;27.6;13.2;0.0
25;2021-05-05;2630;1719;0;130377;62920;0;28.2;13.6;0.0
25;2021-05-06;2917;2288;0;133294;65208;0;28.8;14.1;0.0
25;2021-05-07;3017;2172;0;136311;67380;0;29.5;14.6;0.0
25;2021-05-08;1333;246;0;137644;67626;0;29.8;14.6;0.0
25;2021-05-09;227;81;0;137871;67707;0;29.8;14.6;0.0
25;2021-05-10;2953;1698;0;140824;69405;0;30.4;15.0;0.0
25;2021-05-11;3544;2028;0;144368;71433;0;31.2;15.4;0.0
25;2021-05-12;3421;1894;0;147789;73327;0;32.0;15.9;0.0
25;2021-05-13;3149;590;0;150938;73917;0;32.6;16.0;0.0
25;2021-05-14;4071;1340;0;155009;75257;0;33.5;16.3;0.0
25;2021-05-15;2946;723;0;157955;75980;0;34.1;16.4;0.0
25;2021-05-16;721;94;0;158676;76074;0;34.3;16.4;0.0
25;2021-05-17;3706;1104;0;162382;77178;0;35.1;16.7;0.0
25;2021-05-18;4455;1252;0;166837;78430;0;36.1;17.0;0.0
25;2021-05-19;4731;1158;0;171568;79588;0;37.1;17.2;0.0
25;2021-05-20;4624;1425;0;176192;81013;0;38.1;17.5;0.0
25;2021-05-21;5206;1932;0;181398;82945;0;39.2;17.9;0.0
25;2021-05-22;2727;715;0;184125;83660;0;39.8;18.1;0.0
25;2021-05-23;702;116;0;184827;83776;0;40.0;18.1;0.0
25;2021-05-24;1456;187;0;186283;83963;0;40.3;18.2;0.0
25;2021-05-25;3111;1729;0;189394;85692;0;40.9;18.5;0.0
25;2021-05-26;3445;1628;0;192839;87320;0;41.7;18.9;0.0
25;2021-05-27;4010;1896;0;196849;89216;0;42.6;19.3;0.0
25;2021-05-28;3608;2676;0;200457;91892;0;43.3;19.9;0.0
25;2021-05-29;1888;1009;0;202345;92901;0;43.7;20.1;0.0
25;2021-05-30;184;92;0;202529;92993;0;43.8;20.1;0.0
25;2021-05-31;2386;1797;0;204915;94790;0;44.3;20.5;0.0
25;2021-06-01;2578;2202;0;207493;96992;0;44.9;21.0;0.0
25;2021-06-02;2596;2367;0;210089;99359;0;45.4;21.5;0.0
25;2021-06-03;3235;2146;0;213324;101505;0;46.1;21.9;0.0
25;2021-06-04;2970;2500;0;216294;104005;0;46.8;22.5;0.0
25;2021-06-05;1427;1430;0;217721;105435;0;47.1;22.8;0.0
25;2021-06-06;944;254;0;218665;105689;0;47.3;22.8;0.0
25;2021-06-07;2671;2620;0;221336;108309;0;47.9;23.4;0.0
25;2021-06-08;2594;2836;0;223930;111145;0;48.4;24.0;0.0
25;2021-06-09;2440;2786;0;226370;113931;0;48.9;24.6;0.0
25;2021-06-10;2396;2601;0;228766;116532;0;49.5;25.2;0.0
25;2021-06-11;2645;3356;0;231411;119888;0;50.0;25.9;0.0
25;2021-06-12;1546;1798;0;232957;121686;0;50.4;26.3;0.0
25;2021-06-13;446;246;0;233403;121932;0;50.5;26.4;0.0
25;2021-06-14;1405;3664;0;234808;125596;0;50.8;27.2;0.0
25;2021-06-15;1568;3459;0;236376;129055;0;51.1;27.9;0.0
25;2021-06-16;2032;3186;0;238408;132241;0;51.5;28.6;0.0
25;2021-06-17;1610;3242;0;240018;135483;0;51.9;29.3;0.0
25;2021-06-18;2262;4182;0;242280;139665;0;52.4;30.2;0.0
25;2021-06-19;1304;1936;0;243584;141601;0;52.7;30.6;0.0
25;2021-06-20;73;235;0;243657;141836;0;52.7;30.7;0.0
25;2021-06-21;1117;3906;0;244774;145742;0;52.9;31.5;0.0
25;2021-06-22;1167;4330;0;245941;150072;0;53.2;32.4;0.0
25;2021-06-23;1447;3835;0;247388;153907;0;53.5;33.3;0.0
25;2021-06-24;1276;3866;0;248664;157773;0;53.8;34.1;0.0
25;2021-06-25;1608;5287;0;250272;163060;0;54.1;35.3;0.0
25;2021-06-26;664;3033;0;250936;166093;0;54.2;35.9;0.0
25;2021-06-27;389;858;0;251325;166951;0;54.3;36.1;0.0
25;2021-06-28;882;4066;0;252207;171017;0;54.5;37.0;0.0
25;2021-06-29;1118;4894;0;253325;175911;0;54.8;38.0;0.0
25;2021-06-30;1305;5087;0;254630;180998;0;55.0;39.1;0.0
25;2021-07-01;1725;4922;0;256355;185920;0;55.4;40.2;0.0
25;2021-07-02;1724;4698;0;258079;190618;0;55.8;41.2;0.0
25;2021-07-03;1005;2481;0;259084;193099;0;56.0;41.7;0.0
25;2021-07-04;383;691;0;259467;193790;0;56.1;41.9;0.0
25;2021-07-05;1281;2502;0;260748;196292;0;56.4;42.4;0.0
25;2021-07-06;1560;4344;0;262308;200636;0;56.7;43.4;0.0
25;2021-07-07;1507;4116;0;263815;204752;0;57.0;44.3;0.0
25;2021-07-08;1547;3715;0;265362;208467;0;57.4;45.1;0.0
25;2021-07-09;1692;4194;0;267054;212661;0;57.7;46.0;0.0
25;2021-07-10;809;2177;0;267863;214838;0;57.9;46.4;0.0
25;2021-07-11;131;307;0;267994;215145;0;57.9;46.5;0.0
25;2021-07-12;1365;3654;0;269359;218799;0;58.2;47.3;0.0
25;2021-07-13;2405;4578;0;271764;223377;0;58.8;48.3;0.0
25;2021-07-14;476;577;0;272240;223954;0;58.9;48.4;0.0
25;2021-07-15;2583;3834;0;274823;227788;0;59.4;49.2;0.0
25;2021-07-16;3460;3801;0;278283;231589;0;60.2;50.1;0.0
25;2021-07-17;2301;2054;0;280584;233643;0;60.7;50.5;0.0
25;2021-07-18;856;1221;0;281440;234864;0;60.8;50.8;0.0
25;2021-07-19;2633;4142;0;284073;239006;0;61.4;51.7;0.0
25;2021-07-20;3433;3711;0;287506;242717;0;62.2;52.5;0.0
25;2021-07-21;3549;3572;0;291055;246289;0;62.9;53.2;0.0
25;2021-07-22;3510;3141;0;294565;249430;0;63.7;53.9;0.0
25;2021-07-23;3719;3385;0;298284;252815;0;64.5;54.7;0.0
25;2021-07-24;1640;2180;0;299924;254995;0;64.8;55.1;0.0
25;2021-07-25;605;608;0;300529;255603;0;65.0;55.3;0.0
25;2021-07-26;3053;2945;0;303582;258548;0;65.6;55.9;0.0
25;2021-07-27;3807;2162;0;307389;260710;0;66.5;56.4;0.0
25;2021-07-28;3792;2347;0;311181;263057;0;67.3;56.9;0.0
25;2021-07-29;4331;2240;0;315512;265297;0;68.2;57.4;0.0
25;2021-07-30;4179;2488;0;319691;267785;0;69.1;57.9;0.0
25;2021-07-31;1935;1465;0;321626;269250;0;69.5;58.2;0.0
25;2021-08-01;1173;210;0;322799;269460;0;69.8;58.3;0.0
25;2021-08-02;2759;2122;0;325558;271582;0;70.4;58.7;0.0
25;2021-08-03;2900;2193;0;328458;273775;0;71.0;59.2;0.0
25;2021-08-04;2993;1584;0;331451;275359;0;71.7;59.5;0.0
25;2021-08-05;2297;1807;0;333748;277166;0;72.2;59.9;0.0
25;2021-08-06;2350;2380;0;336098;279546;0;72.7;60.4;0.0
25;2021-08-07;1283;1166;0;337381;280712;0;72.9;60.7;0.0
25;2021-08-08;303;446;0;337684;281158;0;73.0;60.8;0.0
25;2021-08-09;2015;2268;0;339699;283426;0;73.4;61.3;0.0
25;2021-08-10;1959;2558;0;341658;285984;0;73.9;61.8;0.0
25;2021-08-11;1841;2143;0;343499;288127;0;74.3;62.3;0.0
25;2021-08-12;2193;2563;0;345692;290690;0;74.7;62.8;0.0
25;2021-08-13;1686;2189;0;347378;292879;0;75.1;63.3;0.0
25;2021-08-14;927;1825;0;348305;294704;0;75.3;63.7;0.0
25;2021-08-15;25;64;0;348330;294768;0;75.3;63.7;0.0
25;2021-08-16;1256;3239;0;349586;298007;0;75.6;64.4;0.0
25;2021-08-17;1437;3309;0;351023;301316;0;75.9;65.1;0.0
25;2021-08-18;1235;2902;0;352258;304218;0;76.2;65.8;0.0
25;2021-08-19;1011;2816;0;353269;307034;0;76.4;66.4;0.0
25;2021-08-20;1401;3674;0;354670;310708;0;76.7;67.2;0.0
25;2021-08-21;559;1780;0;355229;312488;0;76.8;67.6;0.0
25;2021-08-22;180;1082;0;355409;313570;0;76.8;67.8;0.0
25;2021-08-23;1072;3208;0;356481;316778;0;77.1;68.5;0.0
25;2021-08-24;1057;3171;0;357538;319949;0;77.3;69.2;0.0
25;2021-08-25;1019;3045;0;358557;322994;0;77.5;69.8;0.0
25;2021-08-26;1132;3139;0;359689;326133;0;77.8;70.5;0.0
25;2021-08-27;1162;3105;0;360851;329238;0;78.0;71.2;0.0
25;2021-08-28;546;1799;0;361397;331037;0;78.1;71.6;0.0
25;2021-08-29;129;460;0;361526;331497;0;78.2;71.7;0.0
25;2021-08-30;896;2726;37;362422;334223;37;78.4;72.3;0.0
25;2021-08-31;940;2306;110;363362;336529;147;78.6;72.8;0.0
25;2021-09-01;917;2282;334;364279;338811;481;78.8;73.2;0.1
25;2021-09-02;779;1709;272;365058;340520;753;78.9;73.6;0.2
25;2021-09-03;772;1852;309;365830;342372;1062;79.1;74.0;0.2
25;2021-09-04;622;1272;185;366452;343644;1247;79.2;74.3;0.3
25;2021-09-05;113;151;51;366565;343795;1298;79.2;74.3;0.3
25;2021-09-06;636;1361;489;367201;345156;1787;79.4;74.6;0.4
25;2021-09-07;519;1114;323;367720;346270;2110;79.5;74.9;0.5
25;2021-09-08;616;1580;397;368336;347850;2507;79.6;75.2;0.5
25;2021-09-09;444;1038;382;368780;348888;2889;79.7;75.4;0.6
25;2021-09-10;818;1607;436;369598;350495;3325;79.9;75.8;0.7
25;2021-09-11;374;1005;114;369972;351500;3439;80.0;76.0;0.7
25;2021-09-12;93;180;26;370065;351680;3465;80.0;76.0;0.7
25;2021-09-13;700;943;385;370765;352623;3850;80.2;76.2;0.8
25;2021-09-14;612;863;496;371377;353486;4346;80.3;76.4;0.9
25;2021-09-15;750;1475;438;372127;354961;4784;80.4;76.7;1.0
25;2021-09-16;511;806;411;372638;355767;5195;80.6;76.9;1.1
25;2021-09-17;726;1315;431;373364;357082;5626;80.7;77.2;1.2
25;2021-09-18;317;831;89;373681;357913;5715;80.8;77.4;1.2
25;2021-09-19;63;143;9;373744;358056;5724;80.8;77.4;1.2
25;2021-09-20;433;729;448;374177;358785;6172;80.9;77.6;1.3
25;2021-09-21;203;583;371;374380;359368;6543;80.9;77.7;1.4
25;2021-09-22;439;1143;484;374819;360511;7027;81.0;77.9;1.5
25;2021-09-23;244;480;334;375063;360991;7361;81.1;78.0;1.6
25;2021-09-24;487;1003;536;375550;361994;7897;81.2;78.3;1.7
25;2021-09-25;246;803;97;375796;362797;7994;81.2;78.4;1.7
25;2021-09-26;13;12;15;375809;362809;8009;81.2;78.4;1.7
25;2021-09-27;302;563;342;376111;363372;8351;81.3;78.6;1.8
25;2021-09-28;220;425;414;376331;363797;8765;81.4;78.6;1.9
25;2021-09-29;429;798;505;376760;364595;9270;81.5;78.8;2.0
25;2021-09-30;265;349;341;377025;364944;9611;81.5;78.9;2.1
25;2021-10-01;601;825;503;377626;365769;10114;81.6;79.1;2.2
25;2021-10-02;265;533;133;377891;366302;10247;81.7;79.2;2.2
25;2021-10-03;10;12;0;377901;366314;10247;81.7;79.2;2.2
25;2021-10-04;348;714;473;378249;367028;10720;81.8;79.3;2.3
25;2021-10-05;156;366;312;378405;367394;11032;81.8;79.4;2.4
25;2021-10-06;410;716;560;378815;368110;11592;81.9;79.6;2.5
25;2021-10-07;155;301;442;378970;368411;12034;81.9;79.6;2.6
25;2021-10-08;478;869;687;379448;369280;12721;82.0;79.8;2.8
25;2021-10-09;286;488;198;379734;369768;12919;82.1;79.9;2.8
25;2021-10-10;5;13;12;379739;369781;12931;82.1;79.9;2.8
25;2021-10-11;247;544;606;379986;370325;13537;82.1;80.1;2.9
25;2021-10-12;162;240;363;380148;370565;13900;82.2;80.1;3.0
25;2021-10-13;469;756;686;380617;371321;14586;82.3;80.3;3.2
25;2021-10-14;146;209;387;380763;371530;14973;82.3;80.3;3.2
25;2021-10-15;514;622;859;381277;372152;15832;82.4;80.5;3.4
25;2021-10-16;281;391;276;381558;372543;16108;82.5;80.5;3.5
25;2021-10-17;8;9;2;381566;372552;16110;82.5;80.5;3.5
25;2021-10-18;225;330;465;381791;372882;16575;82.5;80.6;3.6
25;2021-10-19;106;165;370;381897;373047;16945;82.6;80.6;3.7
25;2021-10-20;321;519;894;382218;373566;17839;82.6;80.8;3.9
25;2021-10-21;141;192;382;382359;373758;18221;82.7;80.8;3.9
25;2021-10-22;440;512;986;382799;374270;19207;82.8;80.9;4.2
25;2021-10-23;242;303;389;383041;374573;19596;82.8;81.0;4.2
25;2021-10-24;3;17;7;383044;374590;19603;82.8;81.0;4.2
25;2021-10-25;257;333;710;383301;374923;20313;82.9;81.1;4.4
25;2021-10-26;149;185;666;383450;375108;20979;82.9;81.1;4.5
25;2021-10-27;296;416;1058;383746;375524;22037;83.0;81.2;4.8
25;2021-10-28;94;131;387;383840;375655;22424;83.0;81.2;4.8
25;2021-10-29;341;453;1150;384181;376108;23574;83.1;81.3;5.1
25;2021-10-30;150;282;299;384331;376390;23873;83.1;81.4;5.2
25;2021-10-31;4;4;13;384335;376394;23886;83.1;81.4;5.2
25;2021-11-01;48;14;10;384383;376408;23896;83.1;81.4;5.2
25;2021-11-02;177;259;700;384560;376667;24596;83.1;81.4;5.3
25;2021-11-03;244;422;1259;384804;377089;25855;83.2;81.5;5.6
25;2021-11-04;133;169;676;384937;377258;26531;83.2;81.6;5.7
25;2021-11-05;281;451;1354;385218;377709;27885;83.3;81.7;6.0
25;2021-11-06;186;285;588;385404;377994;28473;83.3;81.7;6.2
25;2021-11-07;13;20;5;385417;378014;28478;83.3;81.7;6.2
25;2021-11-08;138;205;1018;385555;378219;29496;83.4;81.8;6.4
25;2021-11-09;106;157;1143;385661;378376;30639;83.4;81.8;6.6
25;2021-11-10;247;402;1760;385908;378778;32399;83.4;81.9;7.0
25;2021-11-11;2;23;10;385910;378801;32409;83.4;81.9;7.0
25;2021-11-12;278;455;1794;386188;379256;34203;83.5;82.0;7.4
25;2021-11-13;137;242;689;386325;379498;34892;83.5;82.0;7.5
25;2021-11-14;8;23;17;386333;379521;34909;83.5;82.0;7.5
25;2021-11-15;145;261;1694;386478;379782;36603;83.6;82.1;7.9
25;2021-11-16;144;180;1268;386622;379962;37871;83.6;82.1;8.2
25;2021-11-17;286;353;2211;386908;380315;40082;83.6;82.2;8.7
25;2021-11-18;100;128;1056;387008;380443;41138;83.7;82.2;8.9
25;2021-11-19;351;450;2313;387359;380893;43451;83.7;82.3;9.4
25;2021-11-20;220;262;855;387579;381155;44306;83.8;82.4;9.6
25;2021-11-21;3;13;9;387582;381168;44315;83.8;82.4;9.6
25;2021-11-22;227;168;1784;387809;381336;46099;83.8;82.4;10.0
25;2021-11-23;124;119;1420;387933;381455;47519;83.9;82.5;10.3
25;2021-11-24;288;338;2150;388221;381793;49669;83.9;82.5;10.7
25;2021-11-25;95;102;1177;388316;381895;50846;83.9;82.6;11.0
25;2021-11-26;317;345;3709;388633;382240;54555;84.0;82.6;11.8
25;2021-11-27;169;222;1315;388802;382462;55870;84.1;82.7;12.1
25;2021-11-28;5;20;37;388807;382482;55907;84.1;82.7;12.1
25;2021-11-29;177;185;3411;388984;382667;59318;84.1;82.7;12.8
25;2021-11-30;180;186;3729;389164;382853;63047;84.1;82.8;13.6
25;2021-12-01;184;271;4358;389348;383124;67405;84.2;82.8;14.6
25;2021-12-02;147;132;4605;389495;383256;72010;84.2;82.9;15.6
25;2021-12-03;198;339;5059;389693;383595;77069;84.2;82.9;16.7
25;2021-12-04;117;187;2052;389810;383782;79121;84.3;83.0;17.1
25;2021-12-05;6;12;78;389816;383794;79199;84.3;83.0;17.1
25;2021-12-06;143;175;4391;389959;383969;83590;84.3;83.0;18.1
25;2021-12-07;164;201;5522;390123;384170;89112;84.3;83.1;19.3
25;2021-12-08;198;317;5015;390321;384487;94127;84.4;83.1;20.3
25;2021-12-09;173;159;5221;390494;384646;99348;84.4;83.2;21.5
25;2021-12-10;169;298;6145;390663;384944;105493;84.5;83.2;22.8
25;2021-12-11;97;211;2903;390760;385155;108396;84.5;83.3;23.4
25;2021-12-12;13;26;234;390773;385181;108630;84.5;83.3;23.5
25;2021-12-13;130;224;4944;390903;385405;113574;84.5;83.3;24.6
25;2021-12-14;172;209;6042;391075;385614;119616;84.5;83.4;25.9
25;2021-12-15;168;352;5560;391243;385966;125176;84.6;83.4;27.1
25;2021-12-16;151;179;5916;391394;386145;131092;84.6;83.5;28.3
25;2021-12-17;228;347;6183;391622;386492;137275;84.7;83.6;29.7
25;2021-12-18;188;222;3362;391810;386714;140637;84.7;83.6;30.4
25;2021-12-19;10;18;438;391820;386732;141075;84.7;83.6;30.5
26;2020-12-27;0;0;0;0;0;0;0.0;0.0;0.0
26;2020-12-28;0;0;0;0;0;0;0.0;0.0;0.0
26;2020-12-29;0;0;0;0;0;0;0.0;0.0;0.0
26;2020-12-30;0;0;0;0;0;0;0.0;0.0;0.0
26;2020-12-31;0;0;0;0;0;0;0.0;0.0;0.0
26;2021-01-01;2;0;0;2;0;0;0.0;0.0;0.0
26;2021-01-02;0;0;0;2;0;0;0.0;0.0;0.0
26;2021-01-03;1;0;0;3;0;0;0.0;0.0;0.0
26;2021-01-04;0;0;0;3;0;0;0.0;0.0;0.0
26;2021-01-05;0;0;0;3;0;0;0.0;0.0;0.0
26;2021-01-06;4;0;0;7;0;0;0.0;0.0;0.0
26;2021-01-07;176;0;0;183;0;0;0.0;0.0;0.0
26;2021-01-08;133;0;0;316;0;0;0.1;0.0;0.0
26;2021-01-09;5;0;0;321;0;0;0.1;0.0;0.0
26;2021-01-10;0;0;0;321;0;0;0.1;0.0;0.0
26;2021-01-11;256;2;0;577;2;0;0.1;0.0;0.0
26;2021-01-12;206;1;0;783;3;0;0.2;0.0;0.0
26;2021-01-13;409;1;0;1192;4;0;0.3;0.0;0.0
26;2021-01-14;501;1;0;1693;5;0;0.4;0.0;0.0
26;2021-01-15;537;2;0;2230;7;0;0.5;0.0;0.0
26;2021-01-16;237;1;0;2467;8;0;0.6;0.0;0.0
26;2021-01-17;0;0;0;2467;8;0;0.6;0.0;0.0
26;2021-01-18;636;2;0;3103;10;0;0.7;0.0;0.0
26;2021-01-19;788;3;0;3891;13;0;0.9;0.0;0.0
26;2021-01-20;794;2;0;4685;15;0;1.0;0.0;0.0
26;2021-01-21;794;2;0;5479;17;0;1.2;0.0;0.0
26;2021-01-22;732;2;0;6211;19;0;1.4;0.0;0.0
26;2021-01-23;473;1;0;6684;20;0;1.5;0.0;0.0
26;2021-01-24;15;0;0;6699;20;0;1.5;0.0;0.0
26;2021-01-25;624;1;0;7323;21;0;1.6;0.0;0.0
26;2021-01-26;769;6;0;8092;27;0;1.8;0.0;0.0
26;2021-01-27;815;9;0;8907;36;0;2.0;0.0;0.0
26;2021-01-28;1259;169;0;10166;205;0;2.3;0.0;0.0
26;2021-01-29;928;68;0;11094;273;0;2.5;0.1;0.0
26;2021-01-30;552;8;0;11646;281;0;2.6;0.1;0.0
26;2021-01-31;11;0;0;11657;281;0;2.6;0.1;0.0
26;2021-02-01;643;172;0;12300;453;0;2.8;0.1;0.0
26;2021-02-02;1214;211;0;13514;664;0;3.0;0.1;0.0
26;2021-02-03;1214;291;0;14728;955;0;3.3;0.2;0.0
26;2021-02-04;944;437;0;15672;1392;0;3.5;0.3;0.0
26;2021-02-05;633;325;0;16305;1717;0;3.7;0.4;0.0
26;2021-02-06;324;219;0;16629;1936;0;3.7;0.4;0.0
26;2021-02-07;36;3;0;16665;1939;0;3.7;0.4;0.0
26;2021-02-08;516;402;0;17181;2341;0;3.8;0.5;0.0
26;2021-02-09;581;439;0;17762;2780;0;4.0;0.6;0.0
26;2021-02-10;652;373;0;18414;3153;0;4.1;0.7;0.0
26;2021-02-11;730;344;0;19144;3497;0;4.3;0.8;0.0
26;2021-02-12;561;444;0;19705;3941;0;4.4;0.9;0.0
26;2021-02-13;317;303;0;20022;4244;0;4.5;1.0;0.0
26;2021-02-14;31;2;0;20053;4246;0;4.5;1.0;0.0
26;2021-02-15;381;508;0;20434;4754;0;4.6;1.1;0.0
26;2021-02-16;294;526;0;20728;5280;0;4.6;1.2;0.0
26;2021-02-17;238;732;0;20966;6012;0;4.7;1.3;0.0
26;2021-02-18;401;897;0;21367;6909;0;4.8;1.5;0.0
26;2021-02-19;342;811;0;21709;7720;0;4.9;1.7;0.0
26;2021-02-20;86;441;0;21795;8161;0;4.9;1.8;0.0
26;2021-02-21;3;12;0;21798;8173;0;4.9;1.8;0.0
26;2021-02-22;160;647;0;21958;8820;0;4.9;2.0;0.0
26;2021-02-23;393;964;0;22351;9784;0;5.0;2.2;0.0
26;2021-02-24;376;1153;0;22727;10937;0;5.1;2.4;0.0
26;2021-02-25;678;1001;0;23405;11938;0;5.2;2.7;0.0
26;2021-02-26;859;608;0;24264;12546;0;5.4;2.8;0.0
26;2021-02-27;304;434;0;24568;12980;0;5.5;2.9;0.0
26;2021-02-28;11;17;0;24579;12997;0;5.5;2.9;0.0
26;2021-03-01;462;628;0;25041;13625;0;5.6;3.1;0.0
26;2021-03-02;678;630;0;25719;14255;0;5.8;3.2;0.0
26;2021-03-03;712;670;0;26431;14925;0;5.9;3.3;0.0
26;2021-03-04;994;559;0;27425;15484;0;6.1;3.5;0.0
26;2021-03-05;1696;512;0;29121;15996;0;6.5;3.6;0.0
26;2021-03-06;2576;437;0;31697;16433;0;7.1;3.7;0.0
26;2021-03-07;2584;196;0;34281;16629;0;7.7;3.7;0.0
26;2021-03-08;899;614;0;35180;17243;0;7.9;3.9;0.0
26;2021-03-09;1299;552;0;36479;17795;0;8.2;4.0;0.0
26;2021-03-10;1193;498;0;37672;18293;0;8.4;4.1;0.0
26;2021-03-11;1533;624;0;39205;18917;0;8.8;4.2;0.0
26;2021-03-12;2171;499;0;41376;19416;0;9.3;4.3;0.0
26;2021-03-13;1769;288;0;43145;19704;0;9.7;4.4;0.0
26;2021-03-14;66;27;0;43211;19731;0;9.7;4.4;0.0
26;2021-03-15;1565;257;0;44776;19988;0;10.0;4.5;0.0
26;2021-03-16;1162;491;0;45938;20479;0;10.3;4.6;0.0
26;2021-03-17;1318;330;0;47256;20809;0;10.6;4.7;0.0
26;2021-03-18;1527;306;0;48783;21115;0;10.9;4.7;0.0
26;2021-03-19;2351;357;0;51134;21472;0;11.4;4.8;0.0
26;2021-03-20;1200;138;0;52334;21610;0;11.7;4.8;0.0
26;2021-03-21;63;21;0;52397;21631;0;11.7;4.8;0.0
26;2021-03-22;1729;215;0;54126;21846;0;12.1;4.9;0.0
26;2021-03-23;2468;324;0;56594;22170;0;12.7;5.0;0.0
26;2021-03-24;2494;278;0;59088;22448;0;13.2;5.0;0.0
26;2021-03-25;2972;345;0;62060;22793;0;13.9;5.1;0.0
26;2021-03-26;2940;358;0;65000;23151;0;14.6;5.2;0.0
26;2021-03-27;1131;152;0;66131;23303;0;14.8;5.2;0.0
26;2021-03-28;78;5;0;66209;23308;0;14.8;5.2;0.0
26;2021-03-29;1786;424;0;67995;23732;0;15.2;5.3;0.0
26;2021-03-30;2226;498;0;70221;24230;0;15.7;5.4;0.0
26;2021-03-31;2344;567;0;72565;24797;0;16.2;5.6;0.0
26;2021-04-01;2185;760;0;74750;25557;0;16.7;5.7;0.0
26;2021-04-02;2172;934;0;76922;26491;0;17.2;5.9;0.0
26;2021-04-03;511;980;0;77433;27471;0;17.3;6.1;0.0
26;2021-04-04;205;736;0;77638;28207;0;17.4;6.3;0.0
26;2021-04-05;472;47;0;78110;28254;0;17.5;6.3;0.0
26;2021-04-06;1446;781;0;79556;29035;0;17.8;6.5;0.0
26;2021-04-07;1752;872;0;81308;29907;0;18.2;6.7;0.0
26;2021-04-08;2949;949;0;84257;30856;0;18.9;6.9;0.0
26;2021-04-09;3413;996;0;87670;31852;0;19.6;7.1;0.0
26;2021-04-10;1258;822;0;88928;32674;0;19.9;7.3;0.0
26;2021-04-11;95;31;0;89023;32705;0;19.9;7.3;0.0
26;2021-04-12;1715;1078;0;90738;33783;0;20.3;7.6;0.0
26;2021-04-13;2677;1462;0;93415;35245;0;20.9;7.9;0.0
26;2021-04-14;2247;1412;0;95662;36657;0;21.4;8.2;0.0
26;2021-04-15;2291;1521;0;97953;38178;0;21.9;8.5;0.0
26;2021-04-16;2221;1562;0;100174;39740;0;22.4;8.9;0.0
26;2021-04-17;995;750;0;101169;40490;0;22.6;9.1;0.0
26;2021-04-18;65;46;0;101234;40536;0;22.7;9.1;0.0
26;2021-04-19;1453;1473;0;102687;42009;0;23.0;9.4;0.0
26;2021-04-20;1684;1738;0;104371;43747;0;23.4;9.8;0.0
26;2021-04-21;1865;1440;0;106236;45187;0;23.8;10.1;0.0
26;2021-04-22;2292;1585;0;108528;46772;0;24.3;10.5;0.0
26;2021-04-23;1958;1554;0;110486;48326;0;24.7;10.8;0.0
26;2021-04-24;1388;759;0;111874;49085;0;25.0;11.0;0.0
26;2021-04-25;510;80;0;112384;49165;0;25.2;11.0;0.0
26;2021-04-26;1307;1443;0;113691;50608;0;25.5;11.3;0.0
26;2021-04-27;1832;1653;0;115523;52261;0;25.9;11.7;0.0
26;2021-04-28;1782;1748;0;117305;54009;0;26.3;12.1;0.0
26;2021-04-29;2735;1887;0;120040;55896;0;26.9;12.5;0.0
26;2021-04-30;2598;1814;0;122638;57710;0;27.5;12.9;0.0
26;2021-05-01;1292;336;0;123930;58046;0;27.7;13.0;0.0
26;2021-05-02;910;116;0;124840;58162;0;27.9;13.0;0.0
26;2021-05-03;2020;1695;0;126860;59857;0;28.4;13.4;0.0
26;2021-05-04;2487;2250;0;129347;62107;0;29.0;13.9;0.0
26;2021-05-05;2520;2088;0;131867;64195;0;29.5;14.4;0.0
26;2021-05-06;3127;2136;0;134994;66331;0;30.2;14.8;0.0
26;2021-05-07;2612;2321;0;137606;68652;0;30.8;15.4;0.0
26;2021-05-08;1802;506;0;139408;69158;0;31.2;15.5;0.0
26;2021-05-09;588;121;0;139996;69279;0;31.3;15.5;0.0
26;2021-05-10;2696;1833;0;142692;71112;0;31.9;15.9;0.0
26;2021-05-11;3978;2214;0;146670;73326;0;32.8;16.4;0.0
26;2021-05-12;4191;1783;0;150861;75109;0;33.8;16.8;0.0
26;2021-05-13;3714;528;0;154575;75637;0;34.6;16.9;0.0
26;2021-05-14;3984;1457;0;158559;77094;0;35.5;17.3;0.0
26;2021-05-15;3468;545;0;162027;77639;0;36.3;17.4;0.0
26;2021-05-16;2791;281;0;164818;77920;0;36.9;17.4;0.0
26;2021-05-17;3141;1418;0;167959;79338;0;37.6;17.8;0.0
26;2021-05-18;3858;1657;0;171817;80995;0;38.5;18.1;0.0
26;2021-05-19;3802;1379;0;175619;82374;0;39.3;18.4;0.0
26;2021-05-20;3992;1677;0;179611;84051;0;40.2;18.8;0.0
26;2021-05-21;3984;1772;0;183595;85823;0;41.1;19.2;0.0
26;2021-05-22;2422;623;0;186017;86446;0;41.6;19.4;0.0
26;2021-05-23;1223;153;0;187240;86599;0;41.9;19.4;0.0
26;2021-05-24;2947;602;0;190187;87201;0;42.6;19.5;0.0
26;2021-05-25;2973;2297;0;193160;89498;0;43.2;20.0;0.0
26;2021-05-26;3355;2167;0;196515;91665;0;44.0;20.5;0.0
26;2021-05-27;3573;2327;0;200088;93992;0;44.8;21.0;0.0
26;2021-05-28;3141;2613;0;203229;96605;0;45.5;21.6;0.0
26;2021-05-29;2220;1436;0;205449;98041;0;46.0;21.9;0.0
26;2021-05-30;367;88;0;205816;98129;0;46.1;22.0;0.0
26;2021-05-31;2488;1766;0;208304;99895;0;46.6;22.4;0.0
26;2021-06-01;2891;2174;0;211195;102069;0;47.3;22.8;0.0
26;2021-06-02;2508;2088;0;213703;104157;0;47.8;23.3;0.0
26;2021-06-03;2672;2291;0;216375;106448;0;48.4;23.8;0.0
26;2021-06-04;2577;2720;0;218952;109168;0;49.0;24.4;0.0
26;2021-06-05;1432;1431;0;220384;110599;0;49.3;24.8;0.0
26;2021-06-06;81;39;0;220465;110638;0;49.4;24.8;0.0
26;2021-06-07;2023;2232;0;222488;112870;0;49.8;25.3;0.0
26;2021-06-08;2261;2099;0;224749;114969;0;50.3;25.7;0.0
26;2021-06-09;1877;2165;0;226626;117134;0;50.7;26.2;0.0
26;2021-06-10;1821;2543;0;228447;119677;0;51.1;26.8;0.0
26;2021-06-11;1714;2971;0;230161;122648;0;51.5;27.5;0.0
26;2021-06-12;1096;1593;0;231257;124241;0;51.8;27.8;0.0
26;2021-06-13;130;211;0;231387;124452;0;51.8;27.9;0.0
26;2021-06-14;1247;3201;0;232634;127653;0;52.1;28.6;0.0
26;2021-06-15;1478;3668;0;234112;131321;0;52.4;29.4;0.0
26;2021-06-16;1638;3223;0;235750;134544;0;52.8;30.1;0.0
26;2021-06-17;1449;2922;0;237199;137466;0;53.1;30.8;0.0
26;2021-06-18;1657;3985;0;238856;141451;0;53.5;31.7;0.0
26;2021-06-19;864;2718;0;239720;144169;0;53.7;32.3;0.0
26;2021-06-20;250;749;0;239970;144918;0;53.7;32.4;0.0
26;2021-06-21;894;4016;0;240864;148934;0;53.9;33.3;0.0
26;2021-06-22;981;4705;0;241845;153639;0;54.1;34.4;0.0
26;2021-06-23;1131;4421;0;242976;158060;0;54.4;35.4;0.0
26;2021-06-24;1250;3987;0;244226;162047;0;54.7;36.3;0.0
26;2021-06-25;1032;4803;0;245258;166850;0;54.9;37.4;0.0
26;2021-06-26;629;3129;0;245887;169979;0;55.0;38.1;0.0
26;2021-06-27;289;1107;0;246176;171086;0;55.1;38.3;0.0
26;2021-06-28;756;4117;0;246932;175203;0;55.3;39.2;0.0
26;2021-06-29;1003;4359;0;247935;179562;0;55.5;40.2;0.0
26;2021-06-30;1350;4191;0;249285;183753;0;55.8;41.1;0.0
26;2021-07-01;1627;3893;0;250912;187646;0;56.2;42.0;0.0
26;2021-07-02;1328;4507;0;252240;192153;0;56.5;43.0;0.0
26;2021-07-03;662;2568;0;252902;194721;0;56.6;43.6;0.0
26;2021-07-04;269;487;0;253171;195208;0;56.7;43.7;0.0
26;2021-07-05;868;3859;0;254039;199067;0;56.9;44.6;0.0
26;2021-07-06;1244;3724;0;255283;202791;0;57.1;45.4;0.0
26;2021-07-07;1393;3327;0;256676;206118;0;57.5;46.1;0.0
26;2021-07-08;2192;3039;0;258868;209157;0;57.9;46.8;0.0
26;2021-07-09;1488;4102;0;260356;213259;0;58.3;47.7;0.0
26;2021-07-10;804;2211;0;261160;215470;0;58.5;48.2;0.0
26;2021-07-11;260;283;0;261420;215753;0;58.5;48.3;0.0
26;2021-07-12;1042;3614;0;262462;219367;0;58.8;49.1;0.0
26;2021-07-13;2116;4100;0;264578;223467;0;59.2;50.0;0.0
26;2021-07-14;847;729;0;265425;224196;0;59.4;50.2;0.0
26;2021-07-15;2882;3415;0;268307;227611;0;60.1;51.0;0.0
26;2021-07-16;2807;3319;0;271114;230930;0;60.7;51.7;0.0
26;2021-07-17;1659;1520;0;272773;232450;0;61.1;52.0;0.0
26;2021-07-18;206;111;0;272979;232561;0;61.1;52.1;0.0
26;2021-07-19;2368;2843;0;275347;235404;0;61.6;52.7;0.0
26;2021-07-20;3306;3301;0;278653;238705;0;62.4;53.4;0.0
26;2021-07-21;3132;2802;0;281785;241507;0;63.1;54.1;0.0
26;2021-07-22;3601;2714;0;285386;244221;0;63.9;54.7;0.0
26;2021-07-23;3432;3061;0;288818;247282;0;64.7;55.4;0.0
26;2021-07-24;2036;1211;0;290854;248493;0;65.1;55.6;0.0
26;2021-07-25;460;112;0;291314;248605;0;65.2;55.7;0.0
26;2021-07-26;3057;2311;0;294371;250916;0;65.9;56.2;0.0
26;2021-07-27;4379;2529;0;298750;253445;0;66.9;56.7;0.0
26;2021-07-28;3929;2161;0;302679;255606;0;67.8;57.2;0.0
26;2021-07-29;3484;2615;0;306163;258221;0;68.5;57.8;0.0
26;2021-07-30;3168;2447;0;309331;260668;0;69.2;58.4;0.0
26;2021-07-31;1103;989;0;310434;261657;0;69.5;58.6;0.0
26;2021-08-01;400;128;0;310834;261785;0;69.6;58.6;0.0
26;2021-08-02;2637;2099;0;313471;263884;0;70.2;59.1;0.0
26;2021-08-03;3162;2120;0;316633;266004;0;70.9;59.5;0.0
26;2021-08-04;3549;1757;0;320182;267761;0;71.7;59.9;0.0
26;2021-08-05;2944;1951;0;323126;269712;0;72.3;60.4;0.0
26;2021-08-06;2945;2402;1;326071;272114;1;73.0;60.9;0.0
26;2021-08-07;681;744;0;326752;272858;1;73.1;61.1;0.0
26;2021-08-08;67;73;0;326819;272931;1;73.2;61.1;0.0
26;2021-08-09;2004;2556;0;328823;275487;1;73.6;61.7;0.0
26;2021-08-10;2297;2744;0;331120;278231;1;74.1;62.3;0.0
26;2021-08-11;2055;2429;0;333175;280660;1;74.6;62.8;0.0
26;2021-08-12;1777;2351;0;334952;283011;1;75.0;63.4;0.0
26;2021-08-13;1706;2233;0;336658;285244;1;75.4;63.9;0.0
26;2021-08-14;409;847;0;337067;286091;1;75.5;64.0;0.0
26;2021-08-15;42;61;0;337109;286152;1;75.5;64.1;0.0
26;2021-08-16;1128;2777;0;338237;288929;1;75.7;64.7;0.0
26;2021-08-17;1631;2917;0;339868;291846;1;76.1;65.3;0.0
26;2021-08-18;1560;3064;0;341428;294910;1;76.4;66.0;0.0
26;2021-08-19;1522;2737;0;342950;297647;1;76.8;66.6;0.0
26;2021-08-20;1307;2697;0;344257;300344;1;77.1;67.2;0.0
26;2021-08-21;527;997;0;344784;301341;1;77.2;67.5;0.0
26;2021-08-22;67;338;0;344851;301679;1;77.2;67.5;0.0
26;2021-08-23;1428;3124;0;346279;304803;1;77.5;68.2;0.0
26;2021-08-24;1630;3336;0;347909;308139;1;77.9;69.0;0.0
26;2021-08-25;1458;3292;0;349367;311431;1;78.2;69.7;0.0
26;2021-08-26;1367;3011;0;350734;314442;1;78.5;70.4;0.0
26;2021-08-27;1463;3309;0;352197;317751;1;78.8;71.1;0.0
26;2021-08-28;390;1054;0;352587;318805;1;78.9;71.4;0.0
26;2021-08-29;22;64;0;352609;318869;1;78.9;71.4;0.0
26;2021-08-30;1364;2957;61;353973;321826;62;79.2;72.0;0.0
26;2021-08-31;1252;3161;123;355225;324987;185;79.5;72.8;0.0
26;2021-09-01;1361;2455;215;356586;327442;400;79.8;73.3;0.1
26;2021-09-02;1072;1888;259;357658;329330;659;80.1;73.7;0.1
26;2021-09-03;1075;2444;276;358733;331774;935;80.3;74.3;0.2
26;2021-09-04;406;702;84;359139;332476;1019;80.4;74.4;0.2
26;2021-09-05;46;49;10;359185;332525;1029;80.4;74.4;0.2
26;2021-09-06;671;1383;380;359856;333908;1409;80.6;74.7;0.3
26;2021-09-07;772;1560;335;360628;335468;1744;80.7;75.1;0.4
26;2021-09-08;817;1682;286;361445;337150;2030;80.9;75.5;0.5
26;2021-09-09;584;1347;319;362029;338497;2349;81.0;75.8;0.5
26;2021-09-10;775;1740;313;362804;340237;2662;81.2;76.2;0.6
26;2021-09-11;305;698;81;363109;340935;2743;81.3;76.3;0.6
26;2021-09-12;14;24;2;363123;340959;2745;81.3;76.3;0.6
26;2021-09-13;535;1203;414;363658;342162;3159;81.4;76.6;0.7
26;2021-09-14;675;1278;422;364333;343440;3581;81.6;76.9;0.8
26;2021-09-15;683;1707;470;365016;345147;4051;81.7;77.3;0.9
26;2021-09-16;525;977;419;365541;346124;4470;81.8;77.5;1.0
26;2021-09-17;608;1645;424;366149;347769;4894;82.0;77.9;1.1
26;2021-09-18;232;660;100;366381;348429;4994;82.0;78.0;1.1
26;2021-09-19;5;36;1;366386;348465;4995;82.0;78.0;1.1
26;2021-09-20;322;1010;491;366708;349475;5486;82.1;78.2;1.2
26;2021-09-21;371;964;425;367079;350439;5911;82.2;78.4;1.3
26;2021-09-22;393;1404;455;367472;351843;6366;82.3;78.8;1.4
26;2021-09-23;348;773;265;367820;352616;6631;82.3;78.9;1.5
26;2021-09-24;431;1356;475;368251;353972;7106;82.4;79.2;1.6
26;2021-09-25;161;536;69;368412;354508;7175;82.5;79.4;1.6
26;2021-09-26;11;28;1;368423;354536;7176;82.5;79.4;1.6
26;2021-09-27;284;728;389;368707;355264;7565;82.5;79.5;1.7
26;2021-09-28;223;632;325;368930;355896;7890;82.6;79.7;1.8
26;2021-09-29;353;1019;328;369283;356915;8218;82.7;79.9;1.8
26;2021-09-30;231;573;461;369514;357488;8679;82.7;80.0;1.9
26;2021-10-01;460;935;564;369974;358423;9243;82.8;80.2;2.1
26;2021-10-02;188;308;99;370162;358731;9342;82.9;80.3;2.1
26;2021-10-03;11;19;3;370173;358750;9345;82.9;80.3;2.1
26;2021-10-04;313;576;554;370486;359326;9899;82.9;80.4;2.2
26;2021-10-05;162;510;536;370648;359836;10435;83.0;80.6;2.3
26;2021-10-06;385;784;575;371033;360620;11010;83.1;80.7;2.5
26;2021-10-07;195;423;472;371228;361043;11482;83.1;80.8;2.6
26;2021-10-08;370;806;670;371598;361849;12152;83.2;81.0;2.7
26;2021-10-09;181;274;165;371779;362123;12317;83.2;81.1;2.8
26;2021-10-10;2;22;3;371781;362145;12320;83.2;81.1;2.8
26;2021-10-11;242;497;763;372023;362642;13083;83.3;81.2;2.9
26;2021-10-12;200;358;546;372223;363000;13629;83.3;81.3;3.1
26;2021-10-13;300;564;684;372523;363564;14313;83.4;81.4;3.2
26;2021-10-14;213;411;594;372736;363975;14907;83.4;81.5;3.3
26;2021-10-15;383;585;817;373119;364560;15724;83.5;81.6;3.5
26;2021-10-16;167;166;178;373286;364726;15902;83.6;81.6;3.6
26;2021-10-17;7;13;13;373293;364739;15915;83.6;81.6;3.6
26;2021-10-18;226;365;758;373519;365104;16673;83.6;81.7;3.7
26;2021-10-19;90;197;529;373609;365301;17202;83.6;81.8;3.9
26;2021-10-20;174;356;708;373783;365657;17910;83.7;81.9;4.0
26;2021-10-21;144;304;887;373927;365961;18797;83.7;81.9;4.2
26;2021-10-22;146;450;825;374073;366411;19622;83.7;82.0;4.4
26;2021-10-23;75;121;122;374148;366532;19744;83.8;82.1;4.4
26;2021-10-24;3;16;12;374151;366548;19756;83.8;82.1;4.4
26;2021-10-25;151;334;888;374302;366882;20644;83.8;82.1;4.6
26;2021-10-26;104;158;649;374406;367040;21293;83.8;82.2;4.8
26;2021-10-27;160;363;902;374566;367403;22195;83.8;82.2;5.0
26;2021-10-28;146;204;953;374712;367607;23148;83.9;82.3;5.2
26;2021-10-29;147;342;877;374859;367949;24025;83.9;82.4;5.4
26;2021-10-30;54;126;309;374913;368075;24334;83.9;82.4;5.4
26;2021-10-31;1;3;3;374914;368078;24337;83.9;82.4;5.4
26;2021-11-01;18;9;16;374932;368087;24353;83.9;82.4;5.5
26;2021-11-02;85;216;729;375017;368303;25082;84.0;82.4;5.6
26;2021-11-03;152;408;1123;375169;368711;26205;84.0;82.5;5.9
26;2021-11-04;106;216;1178;375275;368927;27383;84.0;82.6;6.1
26;2021-11-05;152;293;963;375427;369220;28346;84.0;82.7;6.3
26;2021-11-06;73;158;331;375500;369378;28677;84.1;82.7;6.4
26;2021-11-07;0;12;4;375500;369390;28681;84.1;82.7;6.4
26;2021-11-08;101;255;1249;375601;369645;29930;84.1;82.7;6.7
26;2021-11-09;96;168;1072;375697;369813;31002;84.1;82.8;6.9
26;2021-11-10;166;252;1739;375863;370065;32741;84.1;82.8;7.3
26;2021-11-11;9;16;20;375872;370081;32761;84.1;82.8;7.3
26;2021-11-12;121;236;1390;375993;370317;34151;84.2;82.9;7.6
26;2021-11-13;48;84;428;376041;370401;34579;84.2;82.9;7.7
26;2021-11-14;4;7;4;376045;370408;34583;84.2;82.9;7.7
26;2021-11-15;136;168;1794;376181;370576;36377;84.2;83.0;8.1
26;2021-11-16;115;153;1706;376296;370729;38083;84.2;83.0;8.5
26;2021-11-17;202;245;1836;376498;370974;39919;84.3;83.0;8.9
26;2021-11-18;117;157;1684;376615;371131;41603;84.3;83.1;9.3
26;2021-11-19;158;177;1652;376773;371308;43255;84.3;83.1;9.7
26;2021-11-20;88;101;709;376861;371409;43964;84.4;83.1;9.8
26;2021-11-21;16;20;262;376877;371429;44226;84.4;83.1;9.9
26;2021-11-22;91;76;1764;376968;371505;45990;84.4;83.2;10.3
26;2021-11-23;122;115;2076;377090;371620;48066;84.4;83.2;10.8
26;2021-11-24;170;175;2108;377260;371795;50174;84.5;83.2;11.2
26;2021-11-25;136;125;2198;377396;371920;52372;84.5;83.3;11.7
26;2021-11-26;174;191;2973;377570;372111;55345;84.5;83.3;12.4
26;2021-11-27;82;114;1023;377652;372225;56368;84.5;83.3;12.6
26;2021-11-28;3;6;33;377655;372231;56401;84.5;83.3;12.6
26;2021-11-29;89;109;3121;377744;372340;59522;84.6;83.4;13.3
26;2021-11-30;117;104;3584;377861;372444;63106;84.6;83.4;14.1
26;2021-12-01;129;170;4236;377990;372614;67342;84.6;83.4;15.1
26;2021-12-02;100;109;3845;378090;372723;71187;84.6;83.4;15.9
26;2021-12-03;101;150;4540;378191;372873;75727;84.7;83.5;17.0
26;2021-12-04;75;75;1912;378266;372948;77639;84.7;83.5;17.4
26;2021-12-05;13;25;841;378279;372973;78480;84.7;83.5;17.6
26;2021-12-06;102;166;4144;378381;373139;82624;84.7;83.5;18.5
26;2021-12-07;129;155;5412;378510;373294;88036;84.7;83.6;19.7
26;2021-12-08;159;193;5543;378669;373487;93579;84.8;83.6;20.9
26;2021-12-09;135;143;5981;378804;373630;99560;84.8;83.6;22.3
26;2021-12-10;119;160;6097;378923;373790;105657;84.8;83.7;23.7
26;2021-12-11;85;78;2719;379008;373868;108376;84.8;83.7;24.3
26;2021-12-12;23;12;462;379031;373880;108838;84.8;83.7;24.4
26;2021-12-13;115;149;5385;379146;374029;114223;84.9;83.7;25.6
26;2021-12-14;145;170;6659;379291;374199;120882;84.9;83.8;27.1
26;2021-12-15;161;196;6218;379452;374395;127100;84.9;83.8;28.5
26;2021-12-16;154;176;6511;379606;374571;133611;85.0;83.9;29.9
26;2021-12-17;141;204;6284;379747;374775;139895;85.0;83.9;31.3
26;2021-12-18;186;144;4295;379933;374919;144190;85.1;83.9;32.3
26;2021-12-19;100;44;2345;380033;374963;146535;85.1;83.9;32.8
27;2020-12-27;0;0;0;0;0;0;0.0;0.0;0.0
27;2020-12-28;0;0;0;0;0;0;0.0;0.0;0.0
27;2020-12-29;1;0;0;1;0;0;0.0;0.0;0.0
27;2020-12-30;0;0;0;1;0;0;0.0;0.0;0.0
27;2020-12-31;0;0;0;1;0;0;0.0;0.0;0.0
27;2021-01-01;0;0;0;1;0;0;0.0;0.0;0.0
27;2021-01-02;0;0;0;1;0;0;0.0;0.0;0.0
27;2021-01-03;1;0;0;2;0;0;0.0;0.0;0.0
27;2021-01-04;4;0;0;6;0;0;0.0;0.0;0.0
27;2021-01-05;23;0;0;29;0;0;0.0;0.0;0.0
27;2021-01-06;200;0;0;229;0;0;0.0;0.0;0.0
27;2021-01-07;465;0;0;694;0;0;0.1;0.0;0.0
27;2021-01-08;501;3;0;1195;3;0;0.2;0.0;0.0
27;2021-01-09;92;2;0;1287;5;0;0.3;0.0;0.0
27;2021-01-10;103;0;0;1390;5;0;0.3;0.0;0.0
27;2021-01-11;406;0;0;1796;5;0;0.4;0.0;0.0
27;2021-01-12;492;2;0;2288;7;0;0.4;0.0;0.0
27;2021-01-13;844;3;0;3132;10;0;0.6;0.0;0.0
27;2021-01-14;1646;32;0;4778;42;0;0.9;0.0;0.0
27;2021-01-15;1218;8;0;5996;50;0;1.2;0.0;0.0
27;2021-01-16;309;2;0;6305;52;0;1.2;0.0;0.0
27;2021-01-17;220;2;0;6525;54;0;1.3;0.0;0.0
27;2021-01-18;788;5;0;7313;59;0;1.4;0.0;0.0
27;2021-01-19;871;5;0;8184;64;0;1.6;0.0;0.0
27;2021-01-20;906;1;0;9090;65;0;1.8;0.0;0.0
27;2021-01-21;710;6;0;9800;71;0;1.9;0.0;0.0
27;2021-01-22;807;6;0;10607;77;0;2.1;0.0;0.0
27;2021-01-23;328;0;0;10935;77;0;2.1;0.0;0.0
27;2021-01-24;137;4;0;11072;81;0;2.2;0.0;0.0
27;2021-01-25;621;16;0;11693;97;0;2.3;0.0;0.0
27;2021-01-26;546;27;0;12239;124;0;2.4;0.0;0.0
27;2021-01-27;569;133;0;12808;257;0;2.5;0.1;0.0
27;2021-01-28;593;339;0;13401;596;0;2.6;0.1;0.0
27;2021-01-29;530;146;0;13931;742;0;2.7;0.1;0.0
27;2021-01-30;224;29;0;14155;771;0;2.8;0.2;0.0
27;2021-01-31;27;26;0;14182;797;0;2.8;0.2;0.0
27;2021-02-01;380;242;0;14562;1039;0;2.8;0.2;0.0
27;2021-02-02;324;327;0;14886;1366;0;2.9;0.3;0.0
27;2021-02-03;461;404;0;15347;1770;0;3.0;0.3;0.0
27;2021-02-04;719;912;0;16066;2682;0;3.1;0.5;0.0
27;2021-02-05;668;1059;0;16734;3741;0;3.3;0.7;0.0
27;2021-02-06;72;211;0;16806;3952;0;3.3;0.8;0.0
27;2021-02-07;43;103;0;16849;4055;0;3.3;0.8;0.0
27;2021-02-08;389;437;0;17238;4492;0;3.4;0.9;0.0
27;2021-02-09;381;584;0;17619;5076;0;3.4;1.0;0.0
27;2021-02-10;348;543;0;17967;5619;0;3.5;1.1;0.0
27;2021-02-11;384;536;0;18351;6155;0;3.6;1.2;0.0
27;2021-02-12;353;598;0;18704;6753;0;3.7;1.3;0.0
27;2021-02-13;139;128;0;18843;6881;0;3.7;1.3;0.0
27;2021-02-14;7;85;0;18850;6966;0;3.7;1.4;0.0
27;2021-02-15;403;645;0;19253;7611;0;3.8;1.5;0.0
27;2021-02-16;349;776;0;19602;8387;0;3.8;1.6;0.0
27;2021-02-17;288;691;0;19890;9078;0;3.9;1.8;0.0
27;2021-02-18;388;754;0;20278;9832;0;4.0;1.9;0.0
27;2021-02-19;287;712;0;20565;10544;0;4.0;2.1;0.0
27;2021-02-20;127;230;0;20692;10774;0;4.0;2.1;0.0
27;2021-02-21;11;122;0;20703;10896;0;4.1;2.1;0.0
27;2021-02-22;450;622;0;21153;11518;0;4.1;2.3;0.0
27;2021-02-23;453;656;0;21606;12174;0;4.2;2.4;0.0
27;2021-02-24;431;640;0;22037;12814;0;4.3;2.5;0.0
27;2021-02-25;788;725;0;22825;13539;0;4.5;2.6;0.0
27;2021-02-26;798;717;0;23623;14256;0;4.6;2.8;0.0
27;2021-02-27;367;152;0;23990;14408;0;4.7;2.8;0.0
27;2021-02-28;105;24;0;24095;14432;0;4.7;2.8;0.0
27;2021-03-01;402;518;0;24497;14950;0;4.8;2.9;0.0
27;2021-03-02;679;412;0;25176;15362;0;4.9;3.0;0.0
27;2021-03-03;761;387;0;25937;15749;0;5.1;3.1;0.0
27;2021-03-04;868;275;0;26805;16024;0;5.2;3.1;0.0
27;2021-03-05;1368;294;0;28173;16318;0;5.5;3.2;0.0
27;2021-03-06;1437;99;0;29610;16417;0;5.8;3.2;0.0
27;2021-03-07;508;22;0;30118;16439;0;5.9;3.2;0.0
27;2021-03-08;1065;345;0;31183;16784;0;6.1;3.3;0.0
27;2021-03-09;1658;312;0;32841;17096;0;6.4;3.3;0.0
27;2021-03-10;1912;371;0;34753;17467;0;6.8;3.4;0.0
27;2021-03-11;1942;270;0;36695;17737;0;7.2;3.5;0.0
27;2021-03-12;2727;258;0;39422;17995;0;7.7;3.5;0.0
27;2021-03-13;1752;111;0;41174;18106;0;8.1;3.5;0.0
27;2021-03-14;544;17;0;41718;18123;0;8.2;3.5;0.0
27;2021-03-15;1418;216;0;43136;18339;0;8.4;3.6;0.0
27;2021-03-16;1311;245;0;44447;18584;0;8.7;3.6;0.0
27;2021-03-17;1505;334;0;45952;18918;0;9.0;3.7;0.0
27;2021-03-18;1400;344;0;47352;19262;0;9.3;3.8;0.0
27;2021-03-19;1656;193;0;49008;19455;0;9.6;3.8;0.0
27;2021-03-20;910;50;0;49918;19505;0;9.8;3.8;0.0
27;2021-03-21;296;6;0;50214;19511;0;9.8;3.8;0.0
27;2021-03-22;1290;420;0;51504;19931;0;10.1;3.9;0.0
27;2021-03-23;1769;395;0;53273;20326;0;10.4;4.0;0.0
27;2021-03-24;1678;375;0;54951;20701;0;10.8;4.1;0.0
27;2021-03-25;2231;394;0;57182;21095;0;11.2;4.1;0.0
27;2021-03-26;2800;358;0;59982;21453;0;11.7;4.2;0.0
27;2021-03-27;1645;162;0;61627;21615;0;12.1;4.2;0.0
27;2021-03-28;1047;41;0;62674;21656;0;12.3;4.2;0.0
27;2021-03-29;1675;653;0;64349;22309;0;12.6;4.4;0.0
27;2021-03-30;1744;724;0;66093;23033;0;12.9;4.5;0.0
27;2021-03-31;1829;744;0;67922;23777;0;13.3;4.7;0.0
27;2021-04-01;2417;711;0;70339;24488;0;13.8;4.8;0.0
27;2021-04-02;2275;998;0;72614;25486;0;14.2;5.0;0.0
27;2021-04-03;1570;576;0;74184;26062;0;14.5;5.1;0.0
27;2021-04-04;879;154;0;75063;26216;0;14.7;5.1;0.0
27;2021-04-05;431;35;0;75494;26251;0;14.8;5.1;0.0
27;2021-04-06;1668;1437;0;77162;27688;0;15.1;5.4;0.0
27;2021-04-07;1669;1458;0;78831;29146;0;15.4;5.7;0.0
27;2021-04-08;2137;1437;0;80968;30583;0;15.8;6.0;0.0
27;2021-04-09;3319;1354;0;84287;31937;0;16.5;6.2;0.0
27;2021-04-10;2244;830;0;86531;32767;0;16.9;6.4;0.0
27;2021-04-11;918;216;0;87449;32983;0;17.1;6.5;0.0
27;2021-04-12;2641;1318;0;90090;34301;0;17.6;6.7;0.0
27;2021-04-13;2655;1404;0;92745;35705;0;18.1;7.0;0.0
27;2021-04-14;2279;1340;0;95024;37045;0;18.6;7.2;0.0
27;2021-04-15;2156;1460;0;97180;38505;0;19.0;7.5;0.0
27;2021-04-16;3061;1099;0;100241;39604;0;19.6;7.8;0.0
27;2021-04-17;2192;471;0;102433;40075;0;20.0;7.8;0.0
27;2021-04-18;408;27;0;102841;40102;0;20.1;7.8;0.0
27;2021-04-19;1824;1257;0;104665;41359;0;20.5;8.1;0.0
27;2021-04-20;2426;1371;0;107091;42730;0;21.0;8.4;0.0
27;2021-04-21;2247;1265;0;109338;43995;0;21.4;8.6;0.0
27;2021-04-22;2300;1543;0;111638;45538;0;21.8;8.9;0.0
27;2021-04-23;2639;1378;0;114277;46916;0;22.4;9.2;0.0
27;2021-04-24;3193;1206;0;117470;48122;0;23.0;9.4;0.0
27;2021-04-25;921;942;0;118391;49064;0;23.2;9.6;0.0
27;2021-04-26;1992;1347;0;120383;50411;0;23.6;9.9;0.0
27;2021-04-27;2544;1405;0;122927;51816;0;24.1;10.1;0.0
27;2021-04-28;2488;1578;0;125415;53394;0;24.5;10.4;0.0
27;2021-04-29;2557;1738;0;127972;55132;0;25.0;10.8;0.0
27;2021-04-30;2630;1829;0;130602;56961;0;25.6;11.1;0.0
27;2021-05-01;2656;884;0;133258;57845;0;26.1;11.3;0.0
27;2021-05-02;1434;787;0;134692;58632;0;26.4;11.5;0.0
27;2021-05-03;2934;1206;0;137626;59838;0;26.9;11.7;0.0
27;2021-05-04;2785;1953;0;140411;61791;0;27.5;12.1;0.0
27;2021-05-05;2886;1961;0;143297;63752;0;28.0;12.5;0.0
27;2021-05-06;3168;1629;0;146465;65381;0;28.7;12.8;0.0
27;2021-05-07;3246;2343;0;149711;67724;0;29.3;13.3;0.0
27;2021-05-08;2756;1380;0;152467;69104;0;29.8;13.5;0.0
27;2021-05-09;1295;318;0;153762;69422;0;30.1;13.6;0.0
27;2021-05-10;2867;2486;0;156629;71908;0;30.7;14.1;0.0
27;2021-05-11;3238;2131;0;159867;74039;0;31.3;14.5;0.0
27;2021-05-12;3379;1883;0;163246;75922;0;31.9;14.9;0.0
27;2021-05-13;2391;361;0;165637;76283;0;32.4;14.9;0.0
27;2021-05-14;3798;1902;0;169435;78185;0;33.2;15.3;0.0
27;2021-05-15;5708;919;0;175143;79104;0;34.3;15.5;0.0
27;2021-05-16;2991;346;0;178134;79450;0;34.9;15.5;0.0
27;2021-05-17;2865;1322;0;180999;80772;0;35.4;15.8;0.0
27;2021-05-18;3721;1425;0;184720;82197;0;36.1;16.1;0.0
27;2021-05-19;3939;1254;0;188659;83451;0;36.9;16.3;0.0
27;2021-05-20;3965;1275;0;192624;84726;0;37.7;16.6;0.0
27;2021-05-21;3877;1837;0;196501;86563;0;38.5;16.9;0.0
27;2021-05-22;4145;843;0;200646;87406;0;39.3;17.1;0.0
27;2021-05-23;1073;173;0;201719;87579;0;39.5;17.1;0.0
27;2021-05-24;1827;411;0;203546;87990;0;39.8;17.2;0.0
27;2021-05-25;3308;1690;0;206854;89680;0;40.5;17.6;0.0
27;2021-05-26;3627;1809;0;210481;91489;0;41.2;17.9;0.0
27;2021-05-27;3605;1619;0;214086;93108;0;41.9;18.2;0.0
27;2021-05-28;3526;2727;0;217612;95835;0;42.6;18.8;0.0
27;2021-05-29;4192;2167;0;221804;98002;0;43.4;19.2;0.0
27;2021-05-30;984;247;0;222788;98249;0;43.6;19.2;0.0
27;2021-05-31;3300;2372;0;226088;100621;0;44.2;19.7;0.0
27;2021-06-01;3925;2307;0;230013;102928;0;45.0;20.1;0.0
27;2021-06-02;3519;2157;0;233532;105085;0;45.7;20.6;0.0
27;2021-06-03;4439;2145;0;237971;107230;0;46.6;21.0;0.0
27;2021-06-04;3779;3053;0;241750;110283;0;47.3;21.6;0.0
27;2021-06-05;3083;3153;0;244833;113436;0;47.9;22.2;0.0
27;2021-06-06;1543;761;0;246376;114197;0;48.2;22.3;0.0
27;2021-06-07;2954;2335;0;249330;116532;0;48.8;22.8;0.0
27;2021-06-08;3553;2463;0;252883;118995;0;49.5;23.3;0.0
27;2021-06-09;2629;2490;0;255512;121485;0;50.0;23.8;0.0
27;2021-06-10;2919;2154;0;258431;123639;0;50.6;24.2;0.0
27;2021-06-11;3461;3788;0;261892;127427;0;51.3;24.9;0.0
27;2021-06-12;2373;3963;0;264265;131390;0;51.7;25.7;0.0
27;2021-06-13;1089;2119;0;265354;133509;0;51.9;26.1;0.0
27;2021-06-14;2249;3178;0;267603;136687;0;52.4;26.7;0.0
27;2021-06-15;2934;3245;0;270537;139932;0;52.9;27.4;0.0
27;2021-06-16;2818;3367;0;273355;143299;0;53.5;28.0;0.0
27;2021-06-17;2676;3334;0;276031;146633;0;54.0;28.7;0.0
27;2021-06-18;3152;4433;0;279183;151066;0;54.6;29.6;0.0
27;2021-06-19;2222;2998;0;281405;154064;0;55.1;30.1;0.0
27;2021-06-20;668;710;0;282073;154774;0;55.2;30.3;0.0
27;2021-06-21;1921;3569;0;283994;158343;0;55.6;31.0;0.0
27;2021-06-22;2562;3881;0;286556;162224;0;56.1;31.7;0.0
27;2021-06-23;2111;3695;0;288667;165919;0;56.5;32.5;0.0
27;2021-06-24;2379;3459;0;291046;169378;0;57.0;33.1;0.0
27;2021-06-25;2105;4515;0;293151;173893;0;57.4;34.0;0.0
27;2021-06-26;1135;4921;0;294286;178814;0;57.6;35.0;0.0
27;2021-06-27;419;1551;0;294705;180365;0;57.7;35.3;0.0
27;2021-06-28;1435;3810;0;296140;184175;0;58.0;36.0;0.0
27;2021-06-29;1806;4538;0;297946;188713;0;58.3;36.9;0.0
27;2021-06-30;2205;4336;0;300151;193049;0;58.7;37.8;0.0
27;2021-07-01;2434;4035;0;302585;197084;0;59.2;38.6;0.0
27;2021-07-02;1769;5040;0;304354;202124;0;59.6;39.6;0.0
27;2021-07-03;1371;4617;0;305725;206741;0;59.8;40.5;0.0
27;2021-07-04;500;1542;0;306225;208283;0;59.9;40.8;0.0
27;2021-07-05;1718;3895;0;307943;212178;0;60.3;41.5;0.0
27;2021-07-06;1636;4238;0;309579;216416;0;60.6;42.4;0.0
27;2021-07-07;2007;4861;0;311586;221277;0;61.0;43.3;0.0
27;2021-07-08;2309;4402;0;313895;225679;0;61.4;44.2;0.0
27;2021-07-09;2261;5390;0;316156;231069;0;61.9;45.2;0.0
27;2021-07-10;1281;4243;0;317437;235312;0;62.1;46.0;0.0
27;2021-07-11;409;1033;0;317846;236345;0;62.2;46.3;0.0
27;2021-07-12;1383;4482;0;319229;240827;0;62.5;47.1;0.0
27;2021-07-13;2864;5558;0;322093;246385;0;63.0;48.2;0.0
27;2021-07-14;1880;2172;0;323973;248557;0;63.4;48.6;0.0
27;2021-07-15;3389;5619;0;327362;254176;0;64.1;49.7;0.0
27;2021-07-16;4012;5490;0;331374;259666;0;64.8;50.8;0.0
27;2021-07-17;3021;4007;0;334395;263673;0;65.4;51.6;0.0
27;2021-07-18;620;1167;0;335015;264840;0;65.6;51.8;0.0
27;2021-07-19;3402;4474;0;338417;269314;0;66.2;52.7;0.0
27;2021-07-20;3462;4332;0;341879;273646;0;66.9;53.6;0.0
27;2021-07-21;4051;4430;0;345930;278076;0;67.7;54.4;0.0
27;2021-07-22;4739;4324;0;350669;282400;0;68.6;55.3;0.0
27;2021-07-23;3960;4190;0;354629;286590;0;69.4;56.1;0.0
27;2021-07-24;3373;2760;0;358002;289350;0;70.1;56.6;0.0
27;2021-07-25;556;607;0;358558;289957;0;70.2;56.7;0.0
27;2021-07-26;3318;3832;0;361876;293789;0;70.8;57.5;0.0
27;2021-07-27;3903;3665;0;365779;297454;0;71.6;58.2;0.0
27;2021-07-28;3858;3667;0;369637;301121;0;72.3;58.9;0.0
27;2021-07-29;4846;3720;0;374483;304841;0;73.3;59.7;0.0
27;2021-07-30;4210;3695;0;378693;308536;0;74.1;60.4;0.0
27;2021-07-31;3211;2842;0;381904;311378;0;74.7;60.9;0.0
27;2021-08-01;572;581;0;382476;311959;0;74.8;61.0;0.0
27;2021-08-02;3492;2895;0;385968;314854;0;75.5;61.6;0.0
27;2021-08-03;3682;3048;0;389650;317902;0;76.3;62.2;0.0
27;2021-08-04;3464;2676;0;393114;320578;0;76.9;62.7;0.0
27;2021-08-05;3139;2799;0;396253;323377;0;77.5;63.3;0.0
27;2021-08-06;3592;3533;0;399845;326910;0;78.2;64.0;0.0
27;2021-08-07;2257;2646;0;402102;329556;0;78.7;64.5;0.0
27;2021-08-08;376;332;0;402478;329888;0;78.8;64.6;0.0
27;2021-08-09;2626;3309;0;405104;333197;0;79.3;65.2;0.0
27;2021-08-10;3018;3460;0;408122;336657;0;79.9;65.9;0.0
27;2021-08-11;2839;3028;0;410961;339685;0;80.4;66.5;0.0
27;2021-08-12;2558;3694;0;413519;343379;0;80.9;67.2;0.0
27;2021-08-13;2021;2944;0;415540;346323;0;81.3;67.8;0.0
27;2021-08-14;1335;2850;0;416875;349173;0;81.6;68.3;0.0
27;2021-08-15;114;134;0;416989;349307;0;81.6;68.4;0.0
27;2021-08-16;1865;3989;0;418854;353296;0;82.0;69.1;0.0
27;2021-08-17;2019;3593;0;420873;356889;0;82.4;69.8;0.0
27;2021-08-18;1745;3289;0;422618;360178;0;82.7;70.5;0.0
27;2021-08-19;1836;3669;0;424454;363847;0;83.1;71.2;0.0
27;2021-08-20;1699;3787;0;426153;367634;0;83.4;71.9;0.0
27;2021-08-21;1076;2792;0;427229;370426;0;83.6;72.5;0.0
27;2021-08-22;201;323;0;427430;370749;0;83.6;72.6;0.0
27;2021-08-23;1225;3955;0;428655;374704;0;83.9;73.3;0.0
27;2021-08-24;1469;3990;0;430124;378694;0;84.2;74.1;0.0
27;2021-08-25;1596;3492;0;431720;382186;0;84.5;74.8;0.0
27;2021-08-26;1184;3077;0;432904;385263;0;84.7;75.4;0.0
27;2021-08-27;1297;3629;0;434201;388892;0;85.0;76.1;0.0
27;2021-08-28;967;2993;0;435168;391885;0;85.2;76.7;0.0
27;2021-08-29;114;315;0;435282;392200;0;85.2;76.8;0.0
27;2021-08-30;1003;3651;39;436285;395851;39;85.4;77.5;0.0
27;2021-08-31;1254;3529;115;437539;399380;154;85.6;78.2;0.0
27;2021-09-01;1147;3184;238;438686;402564;392;85.8;78.8;0.1
27;2021-09-02;928;2428;267;439614;404992;659;86.0;79.3;0.1
27;2021-09-03;923;2504;286;440537;407496;945;86.2;79.7;0.2
27;2021-09-04;791;2092;136;441328;409588;1081;86.4;80.2;0.2
27;2021-09-05;83;260;11;441411;409848;1092;86.4;80.2;0.2
27;2021-09-06;617;1718;351;442028;411566;1443;86.5;80.5;0.3
27;2021-09-07;714;2113;267;442742;413679;1710;86.6;81.0;0.3
27;2021-09-08;783;2328;289;443525;416007;1999;86.8;81.4;0.4
27;2021-09-09;664;1717;267;444189;417724;2266;86.9;81.7;0.4
27;2021-09-10;904;2048;438;445093;419772;2704;87.1;82.1;0.5
27;2021-09-11;615;1867;130;445708;421639;2834;87.2;82.5;0.6
27;2021-09-12;67;209;14;445775;421848;2848;87.2;82.6;0.6
27;2021-09-13;441;1133;406;446216;422981;3254;87.3;82.8;0.6
27;2021-09-14;614;1152;427;446830;424133;3681;87.4;83.0;0.7
27;2021-09-15;605;1712;380;447435;425845;4061;87.6;83.3;0.8
27;2021-09-16;596;1147;377;448031;426992;4438;87.7;83.6;0.9
27;2021-09-17;773;1401;400;448804;428393;4838;87.8;83.8;0.9
27;2021-09-18;361;1283;154;449165;429676;4992;87.9;84.1;1.0
27;2021-09-19;59;193;26;449224;429869;5018;87.9;84.1;1.0
27;2021-09-20;305;911;496;449529;430780;5514;88.0;84.3;1.1
27;2021-09-21;412;963;474;449941;431743;5988;88.1;84.5;1.2
27;2021-09-22;326;1145;445;450267;432888;6433;88.1;84.7;1.3
27;2021-09-23;386;794;723;450653;433682;7156;88.2;84.9;1.4
27;2021-09-24;619;1261;518;451272;434943;7674;88.3;85.1;1.5
27;2021-09-25;278;1098;186;451550;436041;7860;88.4;85.3;1.5
27;2021-09-26;18;33;21;451568;436074;7881;88.4;85.3;1.5
27;2021-09-27;216;588;417;451784;436662;8298;88.4;85.5;1.6
27;2021-09-28;314;771;579;452098;437433;8877;88.5;85.6;1.7
27;2021-09-29;266;787;397;452364;438220;9274;88.5;85.8;1.8
27;2021-09-30;172;549;329;452536;438769;9603;88.6;85.9;1.9
27;2021-10-01;451;994;596;452987;439763;10199;88.6;86.1;2.0
27;2021-10-02;363;827;313;453350;440590;10512;88.7;86.2;2.1
27;2021-10-03;14;28;28;453364;440618;10540;88.7;86.2;2.1
27;2021-10-04;243;429;472;453607;441047;11012;88.8;86.3;2.2
27;2021-10-05;316;513;598;453923;441560;11610;88.8;86.4;2.3
27;2021-10-06;306;676;598;454229;442236;12208;88.9;86.5;2.4
27;2021-10-07;161;321;475;454390;442557;12683;88.9;86.6;2.5
27;2021-10-08;367;826;929;454757;443383;13612;89.0;86.8;2.7
27;2021-10-09;282;557;314;455039;443940;13926;89.0;86.9;2.7
27;2021-10-10;18;49;21;455057;443989;13947;89.1;86.9;2.7
27;2021-10-11;225;429;414;455282;444418;14361;89.1;87.0;2.8
27;2021-10-12;271;442;925;455553;444860;15286;89.2;87.1;3.0
27;2021-10-13;308;461;661;455861;445321;15947;89.2;87.1;3.1
27;2021-10-14;159;399;617;456020;445720;16564;89.2;87.2;3.2
27;2021-10-15;391;807;976;456411;446527;17540;89.3;87.4;3.4
27;2021-10-16;321;455;545;456732;446982;18085;89.4;87.5;3.5
27;2021-10-17;27;36;43;456759;447018;18128;89.4;87.5;3.5
27;2021-10-18;209;290;556;456968;447308;18684;89.4;87.5;3.7
27;2021-10-19;220;372;884;457188;447680;19568;89.5;87.6;3.8
27;2021-10-20;255;373;784;457443;448053;20352;89.5;87.7;4.0
27;2021-10-21;165;391;939;457608;448444;21291;89.6;87.8;4.2
27;2021-10-22;279;500;1194;457887;448944;22485;89.6;87.9;4.4
27;2021-10-23;211;436;481;458098;449380;22966;89.6;87.9;4.5
27;2021-10-24;7;12;35;458105;449392;23001;89.6;87.9;4.5
27;2021-10-25;166;215;645;458271;449607;23646;89.7;88.0;4.6
27;2021-10-26;174;251;850;458445;449858;24496;89.7;88.0;4.8
27;2021-10-27;189;318;822;458634;450176;25318;89.8;88.1;5.0
27;2021-10-28;139;177;745;458773;450353;26063;89.8;88.1;5.1
27;2021-10-29;255;439;1256;459028;450792;27319;89.8;88.2;5.3
27;2021-10-30;156;230;438;459184;451022;27757;89.9;88.3;5.4
27;2021-10-31;6;13;13;459190;451035;27770;89.9;88.3;5.4
27;2021-11-01;19;13;22;459209;451048;27792;89.9;88.3;5.4
27;2021-11-02;194;289;855;459403;451337;28647;89.9;88.3;5.6
27;2021-11-03;186;361;1079;459589;451698;29726;89.9;88.4;5.8
27;2021-11-04;168;201;751;459757;451899;30477;90.0;88.4;6.0
27;2021-11-05;255;345;1476;460012;452244;31953;90.0;88.5;6.3
27;2021-11-06;201;356;695;460213;452600;32648;90.1;88.6;6.4
27;2021-11-07;22;30;83;460235;452630;32731;90.1;88.6;6.4
27;2021-11-08;127;207;1044;460362;452837;33775;90.1;88.6;6.6
27;2021-11-09;181;284;1434;460543;453121;35209;90.1;88.7;6.9
27;2021-11-10;240;324;1719;460783;453445;36928;90.2;88.7;7.2
27;2021-11-11;10;12;36;460793;453457;36964;90.2;88.7;7.2
27;2021-11-12;219;290;1624;461012;453747;38588;90.2;88.8;7.6
27;2021-11-13;197;260;893;461209;454007;39481;90.3;88.8;7.7
27;2021-11-14;11;19;51;461220;454026;39532;90.3;88.9;7.7
27;2021-11-15;130;181;1328;461350;454207;40860;90.3;88.9;8.0
27;2021-11-16;182;231;2413;461532;454438;43273;90.3;88.9;8.5
27;2021-11-17;230;247;1909;461762;454685;45182;90.4;89.0;8.8
27;2021-11-18;148;133;1390;461910;454818;46572;90.4;89.0;9.1
27;2021-11-19;229;274;2212;462139;455092;48784;90.4;89.1;9.5
27;2021-11-20;234;266;914;462373;455358;49698;90.5;89.1;9.7
27;2021-11-21;3;7;69;462376;455365;49767;90.5;89.1;9.7
27;2021-11-22;187;108;1644;462563;455473;51411;90.5;89.1;10.1
27;2021-11-23;228;195;2497;462791;455668;53908;90.6;89.2;10.5
27;2021-11-24;256;276;2253;463047;455944;56161;90.6;89.2;11.0
27;2021-11-25;124;123;1751;463171;456067;57912;90.6;89.3;11.3
27;2021-11-26;231;297;3274;463402;456364;61186;90.7;89.3;12.0
27;2021-11-27;198;261;1714;463600;456625;62900;90.7;89.4;12.3
27;2021-11-28;10;16;150;463610;456641;63050;90.7;89.4;12.3
27;2021-11-29;141;137;2921;463751;456778;65971;90.8;89.4;12.9
27;2021-11-30;184;193;5104;463935;456971;71075;90.8;89.4;13.9
27;2021-12-01;185;222;4651;464120;457193;75726;90.8;89.5;14.8
27;2021-12-02;165;100;4433;464285;457293;80159;90.9;89.5;15.7
27;2021-12-03;168;246;5785;464453;457539;85944;90.9;89.5;16.8
27;2021-12-04;204;279;4472;464657;457818;90416;90.9;89.6;17.7
27;2021-12-05;31;36;1179;464688;457854;91595;90.9;89.6;17.9
27;2021-12-06;111;170;4840;464799;458024;96435;91.0;89.6;18.9
27;2021-12-07;148;196;6932;464947;458220;103367;91.0;89.7;20.2
27;2021-12-08;165;234;5767;465112;458454;109134;91.0;89.7;21.4
27;2021-12-09;160;151;7263;465272;458605;116397;91.1;89.7;22.8
27;2021-12-10;159;215;7217;465431;458820;123614;91.1;89.8;24.2
27;2021-12-11;192;286;5264;465623;459106;128878;91.1;89.8;25.2
27;2021-12-12;39;29;1273;465662;459135;130151;91.1;89.9;25.5
27;2021-12-13;116;184;5346;465778;459319;135497;91.2;89.9;26.5
27;2021-12-14;176;267;7713;465954;459586;143210;91.2;89.9;28.0
27;2021-12-15;157;262;5950;466111;459848;149160;91.2;90.0;29.2
27;2021-12-16;217;233;7748;466328;460081;156908;91.3;90.0;30.7
27;2021-12-17;197;266;7684;466525;460347;164592;91.3;90.1;32.2
27;2021-12-18;213;221;5508;466738;460568;170100;91.3;90.1;33.3
27;2021-12-19;64;38;1833;466802;460606;171933;91.4;90.1;33.6
28;2020-12-27;0;0;0;0;0;0;0.0;0.0;0.0
28;2020-12-28;0;0;0;0;0;0;0.0;0.0;0.0
28;2020-12-29;0;0;0;0;0;0;0.0;0.0;0.0
28;2020-12-30;1;0;0;1;0;0;0.0;0.0;0.0
28;2020-12-31;0;0;0;1;0;0;0.0;0.0;0.0
28;2021-01-01;1;0;0;2;0;0;0.0;0.0;0.0
28;2021-01-02;0;0;0;2;0;0;0.0;0.0;0.0
28;2021-01-03;0;0;0;2;0;0;0.0;0.0;0.0
28;2021-01-04;3;0;0;5;0;0;0.0;0.0;0.0
28;2021-01-05;14;0;0;19;0;0;0.0;0.0;0.0
28;2021-01-06;84;0;0;103;0;0;0.0;0.0;0.0
28;2021-01-07;116;0;0;219;0;0;0.1;0.0;0.0
28;2021-01-08;157;2;0;376;2;0;0.1;0.0;0.0
28;2021-01-09;78;0;0;454;2;0;0.1;0.0;0.0
28;2021-01-10;7;0;0;461;2;0;0.1;0.0;0.0
28;2021-01-11;196;1;0;657;3;0;0.2;0.0;0.0
28;2021-01-12;287;2;0;944;5;0;0.3;0.0;0.0
28;2021-01-13;391;3;0;1335;8;0;0.4;0.0;0.0
28;2021-01-14;449;6;0;1784;14;0;0.5;0.0;0.0
28;2021-01-15;403;4;0;2187;18;0;0.6;0.0;0.0
28;2021-01-16;191;2;0;2378;20;0;0.6;0.0;0.0
28;2021-01-17;34;0;0;2412;20;0;0.7;0.0;0.0
28;2021-01-18;416;2;0;2828;22;0;0.8;0.0;0.0
28;2021-01-19;504;3;0;3332;25;0;0.9;0.0;0.0
28;2021-01-20;644;3;0;3976;28;0;1.1;0.0;0.0
28;2021-01-21;826;3;0;4802;31;0;1.3;0.0;0.0
28;2021-01-22;517;2;0;5319;33;0;1.5;0.0;0.0
28;2021-01-23;307;0;0;5626;33;0;1.5;0.0;0.0
28;2021-01-24;11;0;0;5637;33;0;1.5;0.0;0.0
28;2021-01-25;454;5;0;6091;38;0;1.7;0.0;0.0
28;2021-01-26;686;10;0;6777;48;0;1.9;0.0;0.0
28;2021-01-27;1124;54;0;7901;102;0;2.2;0.0;0.0
28;2021-01-28;1460;97;0;9361;199;0;2.6;0.1;0.0
28;2021-01-29;841;101;0;10202;300;0;2.8;0.1;0.0
28;2021-01-30;225;54;0;10427;354;0;2.8;0.1;0.0
28;2021-01-31;1;21;0;10428;375;0;2.8;0.1;0.0
28;2021-02-01;341;97;0;10769;472;0;2.9;0.1;0.0
28;2021-02-02;378;203;0;11147;675;0;3.0;0.2;0.0
28;2021-02-03;466;247;0;11613;922;0;3.2;0.3;0.0
28;2021-02-04;476;252;0;12089;1174;0;3.3;0.3;0.0
28;2021-02-05;405;227;0;12494;1401;0;3.4;0.4;0.0
28;2021-02-06;198;118;0;12692;1519;0;3.5;0.4;0.0
28;2021-02-07;4;4;0;12696;1523;0;3.5;0.4;0.0
28;2021-02-08;314;237;0;13010;1760;0;3.6;0.5;0.0
28;2021-02-09;305;350;0;13315;2110;0;3.6;0.6;0.0
28;2021-02-10;463;424;0;13778;2534;0;3.8;0.7;0.0
28;2021-02-11;575;536;0;14353;3070;0;3.9;0.8;0.0
28;2021-02-12;464;414;0;14817;3484;0;4.0;1.0;0.0
28;2021-02-13;146;192;0;14963;3676;0;4.1;1.0;0.0
28;2021-02-14;0;11;0;14963;3687;0;4.1;1.0;0.0
28;2021-02-15;301;475;0;15264;4162;0;4.2;1.1;0.0
28;2021-02-16;379;704;0;15643;4866;0;4.3;1.3;0.0
28;2021-02-17;566;1078;0;16209;5944;0;4.4;1.6;0.0
28;2021-02-18;694;1393;0;16903;7337;0;4.6;2.0;0.0
28;2021-02-19;577;773;0;17480;8110;0;4.8;2.2;0.0
28;2021-02-20;113;152;0;17593;8262;0;4.8;2.3;0.0
28;2021-02-21;6;35;0;17599;8297;0;4.8;2.3;0.0
28;2021-02-22;248;492;0;17847;8789;0;4.9;2.4;0.0
28;2021-02-23;219;430;0;18066;9219;0;4.9;2.5;0.0
28;2021-02-24;279;463;0;18345;9682;0;5.0;2.6;0.0
28;2021-02-25;567;441;0;18912;10123;0;5.2;2.8;0.0
28;2021-02-26;753;379;0;19665;10502;0;5.4;2.9;0.0
28;2021-02-27;277;76;0;19942;10578;0;5.5;2.9;0.0
28;2021-02-28;22;22;0;19964;10600;0;5.5;2.9;0.0
28;2021-03-01;307;247;0;20271;10847;0;5.5;3.0;0.0
28;2021-03-02;421;300;0;20692;11147;0;5.7;3.0;0.0
28;2021-03-03;440;398;0;21132;11545;0;5.8;3.2;0.0
28;2021-03-04;721;425;0;21853;11970;0;6.0;3.3;0.0
28;2021-03-05;1377;389;0;23230;12359;0;6.3;3.4;0.0
28;2021-03-06;2025;104;0;25255;12463;0;6.9;3.4;0.0
28;2021-03-07;981;46;0;26236;12509;0;7.2;3.4;0.0
28;2021-03-08;448;296;0;26684;12805;0;7.3;3.5;0.0
28;2021-03-09;1030;330;0;27714;13135;0;7.6;3.6;0.0
28;2021-03-10;1386;547;0;29100;13682;0;8.0;3.7;0.0
28;2021-03-11;1558;670;0;30658;14352;0;8.4;3.9;0.0
28;2021-03-12;2314;591;0;32972;14943;0;9.0;4.1;0.0
28;2021-03-13;1124;82;0;34096;15025;0;9.3;4.1;0.0
28;2021-03-14;505;23;0;34601;15048;0;9.5;4.1;0.0
28;2021-03-15;828;245;0;35429;15293;0;9.7;4.2;0.0
28;2021-03-16;778;230;0;36207;15523;0;9.9;4.2;0.0
28;2021-03-17;802;300;0;37009;15823;0;10.1;4.3;0.0
28;2021-03-18;1222;276;0;38231;16099;0;10.4;4.4;0.0
28;2021-03-19;1587;318;0;39818;16417;0;10.9;4.5;0.0
28;2021-03-20;685;28;0;40503;16445;0;11.1;4.5;0.0
28;2021-03-21;18;9;0;40521;16454;0;11.1;4.5;0.0
28;2021-03-22;865;333;0;41386;16787;0;11.3;4.6;0.0
28;2021-03-23;1135;206;0;42521;16993;0;11.6;4.6;0.0
28;2021-03-24;1374;265;0;43895;17258;0;12.0;4.7;0.0
28;2021-03-25;1810;295;0;45705;17553;0;12.5;4.8;0.0
28;2021-03-26;2196;344;0;47901;17897;0;13.1;4.9;0.0
28;2021-03-27;499;50;0;48400;17947;0;13.2;4.9;0.0
28;2021-03-28;41;3;0;48441;17950;0;13.2;4.9;0.0
28;2021-03-29;1176;385;0;49617;18335;0;13.6;5.0;0.0
28;2021-03-30;1794;279;0;51411;18614;0;14.1;5.1;0.0
28;2021-03-31;2020;477;0;53431;19091;0;14.6;5.2;0.0
28;2021-04-01;1918;629;0;55349;19720;0;15.1;5.4;0.0
28;2021-04-02;1671;1330;0;57020;21050;0;15.6;5.8;0.0
28;2021-04-03;636;1072;0;57656;22122;0;15.8;6.0;0.0
28;2021-04-04;58;307;0;57714;22429;0;15.8;6.1;0.0
28;2021-04-05;66;4;0;57780;22433;0;15.8;6.1;0.0
28;2021-04-06;1242;558;0;59022;22991;0;16.1;6.3;0.0
28;2021-04-07;1851;1051;0;60873;24042;0;16.6;6.6;0.0
28;2021-04-08;2111;1117;0;62984;25159;0;17.2;6.9;0.0
28;2021-04-09;3271;941;0;66255;26100;0;18.1;7.1;0.0
28;2021-04-10;1655;196;0;67910;26296;0;18.6;7.2;0.0
28;2021-04-11;157;441;0;68067;26737;0;18.6;7.3;0.0
28;2021-04-12;1692;637;0;69759;27374;0;19.1;7.5;0.0
28;2021-04-13;1995;732;0;71754;28106;0;19.6;7.7;0.0
28;2021-04-14;2859;964;0;74613;29070;0;20.4;7.9;0.0
28;2021-04-15;2563;1214;0;77176;30284;0;21.1;8.3;0.0
28;2021-04-16;2524;888;0;79700;31172;0;21.8;8.5;0.0
28;2021-04-17;2232;188;0;81932;31360;0;22.4;8.6;0.0
28;2021-04-18;48;9;0;81980;31369;0;22.4;8.6;0.0
28;2021-04-19;1558;714;0;83538;32083;0;22.8;8.8;0.0
28;2021-04-20;1824;728;0;85362;32811;0;23.3;9.0;0.0
28;2021-04-21;2602;972;0;87964;33783;0;24.0;9.2;0.0
28;2021-04-22;1835;1239;0;89799;35022;0;24.5;9.6;0.0
28;2021-04-23;2338;1146;0;92137;36168;0;25.2;9.9;0.0
28;2021-04-24;3453;208;0;95590;36376;0;26.1;9.9;0.0
28;2021-04-25;901;71;0;96491;36447;0;26.4;10.0;0.0
28;2021-04-26;1345;947;0;97836;37394;0;26.7;10.2;0.0
28;2021-04-27;1520;1386;0;99356;38780;0;27.2;10.6;0.0
28;2021-04-28;2450;1796;0;101806;40576;0;27.8;11.1;0.0
28;2021-04-29;2261;1499;0;104067;42075;0;28.4;11.5;0.0
28;2021-04-30;3069;1257;0;107136;43332;0;29.3;11.8;0.0
28;2021-05-01;251;141;0;107387;43473;0;29.3;11.9;0.0
28;2021-05-02;188;103;0;107575;43576;0;29.4;11.9;0.0
28;2021-05-03;1322;1079;0;108897;44655;0;29.8;12.2;0.0
28;2021-05-04;1593;1692;0;110490;46347;0;30.2;12.7;0.0
28;2021-05-05;3038;1666;0;113528;48013;0;31.0;13.1;0.0
28;2021-05-06;2620;1479;0;116148;49492;0;31.7;13.5;0.0
28;2021-05-07;2442;1990;0;118590;51482;0;32.4;14.1;0.0
28;2021-05-08;1446;161;0;120036;51643;0;32.8;14.1;0.0
28;2021-05-09;237;624;0;120273;52267;0;32.9;14.3;0.0
28;2021-05-10;1524;1929;0;121797;54196;0;33.3;14.8;0.0
28;2021-05-11;2239;2347;0;124036;56543;0;33.9;15.5;0.0
28;2021-05-12;2733;3185;0;126769;59728;0;34.6;16.3;0.0
28;2021-05-13;696;449;0;127465;60177;0;34.8;16.4;0.0
28;2021-05-14;2158;1574;0;129623;61751;0;35.4;16.9;0.0
28;2021-05-15;1579;1629;0;131202;63380;0;35.9;17.3;0.0
28;2021-05-16;1969;142;0;133171;63522;0;36.4;17.4;0.0
28;2021-05-17;2779;1478;0;135950;65000;0;37.2;17.8;0.0
28;2021-05-18;3188;1340;0;139138;66340;0;38.0;18.1;0.0
28;2021-05-19;4662;1321;0;143800;67661;0;39.3;18.5;0.0
28;2021-05-20;3958;1267;0;147758;68928;0;40.4;18.8;0.0
28;2021-05-21;3321;1594;0;151079;70522;0;41.3;19.3;0.0
28;2021-05-22;879;1145;0;151958;71667;0;41.5;19.6;0.0
28;2021-05-23;1903;137;0;153861;71804;0;42.1;19.6;0.0
28;2021-05-24;1663;390;0;155524;72194;0;42.5;19.7;0.0
28;2021-05-25;2016;1428;0;157540;73622;0;43.1;20.1;0.0
28;2021-05-26;2676;1370;0;160216;74992;0;43.8;20.5;0.0
28;2021-05-27;2907;1268;0;163123;76260;0;44.6;20.8;0.0
28;2021-05-28;3189;1833;0;166312;78093;0;45.5;21.3;0.0
28;2021-05-29;2027;947;0;168339;79040;0;46.0;21.6;0.0
28;2021-05-30;76;60;0;168415;79100;0;46.0;21.6;0.0
28;2021-05-31;2336;1010;0;170751;80110;0;46.7;21.9;0.0
28;2021-06-01;2632;1761;0;173383;81871;0;47.4;22.4;0.0
28;2021-06-02;2444;2466;0;175827;84337;0;48.1;23.0;0.0
28;2021-06-03;2910;1650;0;178737;85987;0;48.8;23.5;0.0
28;2021-06-04;2807;2453;0;181544;88440;0;49.6;24.2;0.0
28;2021-06-05;2001;2492;0;183545;90932;0;50.2;24.9;0.0
28;2021-06-06;1076;946;0;184621;91878;0;50.5;25.1;0.0
28;2021-06-07;3481;1690;0;188102;93568;0;51.4;25.6;0.0
28;2021-06-08;3230;1650;0;191332;95218;0;52.3;26.0;0.0
28;2021-06-09;3725;2249;0;195057;97467;0;53.3;26.6;0.0
28;2021-06-10;3162;1475;0;198219;98942;0;54.2;27.0;0.0
28;2021-06-11;3737;2309;0;201956;101251;0;55.2;27.7;0.0
28;2021-06-12;1300;678;0;203256;101929;0;55.6;27.9;0.0
28;2021-06-13;388;230;0;203644;102159;0;55.7;27.9;0.0
28;2021-06-14;2152;2275;0;205796;104434;0;56.2;28.5;0.0
28;2021-06-15;2079;2466;0;207875;106900;0;56.8;29.2;0.0
28;2021-06-16;2485;4039;0;210360;110939;0;57.5;30.3;0.0
28;2021-06-17;1979;3231;0;212339;114170;0;58.0;31.2;0.0
28;2021-06-18;2462;3834;0;214801;118004;0;58.7;32.3;0.0
28;2021-06-19;819;1880;0;215620;119884;0;58.9;32.8;0.0
28;2021-06-20;60;150;0;215680;120034;0;58.9;32.8;0.0
28;2021-06-21;1683;2226;0;217363;122260;0;59.4;33.4;0.0
28;2021-06-22;1351;2385;0;218714;124645;0;59.8;34.1;0.0
28;2021-06-23;1719;3209;0;220433;127854;0;60.2;34.9;0.0
28;2021-06-24;815;1332;0;221248;129186;0;60.5;35.3;0.0
28;2021-06-25;1871;3253;0;223119;132439;0;61.0;36.2;0.0
28;2021-06-26;402;2134;0;223521;134573;0;61.1;36.8;0.0
28;2021-06-27;499;1195;0;224020;135768;0;61.2;37.1;0.0
28;2021-06-28;1180;3571;0;225200;139339;0;61.5;38.1;0.0
28;2021-06-29;1266;3673;0;226466;143012;0;61.9;39.1;0.0
28;2021-06-30;1419;3998;0;227885;147010;0;62.3;40.2;0.0
28;2021-07-01;1242;3397;0;229127;150407;0;62.6;41.1;0.0
28;2021-07-02;1323;4503;0;230450;154910;0;63.0;42.3;0.0
28;2021-07-03;1105;2439;0;231555;157349;0;63.3;43.0;0.0
28;2021-07-04;184;1267;0;231739;158616;0;63.3;43.4;0.0
28;2021-07-05;1342;2786;0;233081;161402;0;63.7;44.1;0.0
28;2021-07-06;1528;3071;0;234609;164473;0;64.1;45.0;0.0
28;2021-07-07;1555;4023;0;236164;168496;0;64.5;46.1;0.0
28;2021-07-08;1485;3376;0;237649;171872;0;65.0;47.0;0.0
28;2021-07-09;1325;4616;0;238974;176488;0;65.3;48.2;0.0
28;2021-07-10;484;2264;0;239458;178752;0;65.4;48.9;0.0
28;2021-07-11;45;95;0;239503;178847;0;65.5;48.9;0.0
28;2021-07-12;1307;4024;0;240810;182871;0;65.8;50.0;0.0
28;2021-07-13;2004;4283;0;242814;187154;0;66.4;51.1;0.0
28;2021-07-14;1160;1431;0;243974;188585;0;66.7;51.5;0.0
28;2021-07-15;2588;4033;0;246562;192618;0;67.4;52.6;0.0
28;2021-07-16;2284;4813;0;248846;197431;0;68.0;54.0;0.0
28;2021-07-17;1375;2505;0;250221;199936;0;68.4;54.6;0.0
28;2021-07-18;396;953;0;250617;200889;0;68.5;54.9;0.0
28;2021-07-19;1765;4178;0;252382;205067;0;69.0;56.0;0.0
28;2021-07-20;2387;4039;0;254769;209106;0;69.6;57.1;0.0
28;2021-07-21;2748;4325;0;257517;213431;0;70.4;58.3;0.0
28;2021-07-22;3379;3541;0;260896;216972;0;71.3;59.3;0.0
28;2021-07-23;2903;3952;0;263799;220924;0;72.1;60.4;0.0
28;2021-07-24;1789;1423;0;265588;222347;0;72.6;60.8;0.0
28;2021-07-25;145;109;0;265733;222456;0;72.6;60.8;0.0
28;2021-07-26;2744;3200;0;268477;225656;0;73.4;61.7;0.0
28;2021-07-27;3529;2577;0;272006;228233;0;74.3;62.4;0.0
28;2021-07-28;3719;2623;0;275725;230856;0;75.4;63.1;0.0
28;2021-07-29;4023;2118;0;279748;232974;0;76.5;63.7;0.0
28;2021-07-30;3514;2762;0;283262;235736;0;77.4;64.4;0.0
28;2021-07-31;891;810;0;284153;236546;0;77.7;64.6;0.0
28;2021-08-01;410;97;0;284563;236643;0;77.8;64.7;0.0
28;2021-08-02;1715;1448;0;286278;238091;0;78.2;65.1;0.0
28;2021-08-03;2548;2030;0;288826;240121;0;78.9;65.6;0.0
28;2021-08-04;2023;2113;0;290849;242234;0;79.5;66.2;0.0
28;2021-08-05;1806;1772;0;292655;244006;0;80.0;66.7;0.0
28;2021-08-06;1745;2062;0;294400;246068;0;80.5;67.3;0.0
28;2021-08-07;891;1143;0;295291;247211;0;80.7;67.6;0.0
28;2021-08-08;84;97;0;295375;247308;0;80.7;67.6;0.0
28;2021-08-09;1405;1303;0;296780;248611;0;81.1;67.9;0.0
28;2021-08-10;1815;2015;0;298595;250626;0;81.6;68.5;0.0
28;2021-08-11;1406;1821;0;300001;252447;0;82.0;69.0;0.0
28;2021-08-12;1350;2062;0;301351;254509;0;82.4;69.6;0.0
28;2021-08-13;1416;1807;0;302767;256316;0;82.7;70.1;0.0
28;2021-08-14;725;1008;0;303492;257324;0;82.9;70.3;0.0
28;2021-08-15;254;100;0;303746;257424;0;83.0;70.4;0.0
28;2021-08-16;956;2078;0;304702;259502;0;83.3;70.9;0.0
28;2021-08-17;1187;2756;0;305889;262258;0;83.6;71.7;0.0
28;2021-08-18;911;2498;0;306800;264756;0;83.8;72.4;0.0
28;2021-08-19;929;2638;0;307729;267394;0;84.1;73.1;0.0
28;2021-08-20;928;2706;0;308657;270100;0;84.4;73.8;0.0
28;2021-08-21;440;1195;0;309097;271295;0;84.5;74.1;0.0
28;2021-08-22;37;102;0;309134;271397;0;84.5;74.2;0.0
28;2021-08-23;984;2060;0;310118;273457;0;84.8;74.7;0.0
28;2021-08-24;872;2593;0;310990;276050;0;85.0;75.4;0.0
28;2021-08-25;997;2235;0;311987;278285;0;85.3;76.1;0.0
28;2021-08-26;730;1981;0;312717;280266;0;85.5;76.6;0.0
28;2021-08-27;787;2426;0;313504;282692;0;85.7;77.3;0.0
28;2021-08-28;544;1248;0;314048;283940;0;85.8;77.6;0.0
28;2021-08-29;43;81;0;314091;284021;0;85.8;77.6;0.0
28;2021-08-30;928;2028;23;315019;286049;23;86.1;78.2;0.0
28;2021-08-31;744;2204;55;315763;288253;78;86.3;78.8;0.0
28;2021-09-01;754;2285;174;316517;290538;252;86.5;79.4;0.1
28;2021-09-02;581;1983;170;317098;292521;422;86.7;79.9;0.1
28;2021-09-03;723;2320;211;317821;294841;633;86.9;80.6;0.2
28;2021-09-04;608;2311;95;318429;297152;728;87.0;81.2;0.2
28;2021-09-05;178;145;97;318607;297297;825;87.1;81.3;0.2
28;2021-09-06;442;1299;241;319049;298596;1066;87.2;81.6;0.3
28;2021-09-07;385;1376;166;319434;299972;1232;87.3;82.0;0.3
28;2021-09-08;553;1389;181;319987;301361;1413;87.5;82.4;0.4
28;2021-09-09;345;1046;166;320332;302407;1579;87.5;82.6;0.4
28;2021-09-10;605;1378;243;320937;303785;1822;87.7;83.0;0.5
28;2021-09-11;332;1217;75;321269;305002;1897;87.8;83.4;0.5
28;2021-09-12;53;57;29;321322;305059;1926;87.8;83.4;0.5
28;2021-09-13;327;714;308;321649;305773;2234;87.9;83.6;0.6
28;2021-09-14;363;895;341;322012;306668;2575;88.0;83.8;0.7
28;2021-09-15;537;1032;392;322549;307700;2967;88.2;84.1;0.8
28;2021-09-16;277;731;404;322826;308431;3371;88.2;84.3;0.9
28;2021-09-17;319;1041;392;323145;309472;3763;88.3;84.6;1.0
28;2021-09-18;180;358;83;323325;309830;3846;88.4;84.7;1.1
28;2021-09-19;14;29;5;323339;309859;3851;88.4;84.7;1.1
28;2021-09-20;167;487;298;323506;310346;4149;88.4;84.8;1.1
28;2021-09-21;321;872;437;323827;311218;4586;88.5;85.1;1.3
28;2021-09-22;330;976;522;324157;312194;5108;88.6;85.3;1.4
28;2021-09-23;189;497;492;324346;312691;5600;88.6;85.5;1.5
28;2021-09-24;256;967;405;324602;313658;6005;88.7;85.7;1.6
28;2021-09-25;134;423;129;324736;314081;6134;88.8;85.8;1.7
28;2021-09-26;22;49;15;324758;314130;6149;88.8;85.9;1.7
28;2021-09-27;165;678;364;324923;314808;6513;88.8;86.0;1.8
28;2021-09-28;172;466;629;325095;315274;7142;88.8;86.2;2.0
28;2021-09-29;363;731;399;325458;316005;7541;88.9;86.4;2.1
28;2021-09-30;238;451;711;325696;316456;8252;89.0;86.5;2.3
28;2021-10-01;302;697;485;325998;317153;8737;89.1;86.7;2.4
28;2021-10-02;121;222;76;326119;317375;8813;89.1;86.7;2.4
28;2021-10-03;8;22;4;326127;317397;8817;89.1;86.7;2.4
28;2021-10-04;158;255;447;326285;317652;9264;89.2;86.8;2.5
28;2021-10-05;175;394;581;326460;318046;9845;89.2;86.9;2.7
28;2021-10-06;221;624;504;326681;318670;10349;89.3;87.1;2.8
28;2021-10-07;136;294;490;326817;318964;10839;89.3;87.2;3.0
28;2021-10-08;260;516;545;327077;319480;11384;89.4;87.3;3.1
28;2021-10-09;98;204;164;327175;319684;11548;89.4;87.4;3.2
28;2021-10-10;13;26;14;327188;319710;11562;89.4;87.4;3.2
28;2021-10-11;165;226;440;327353;319936;12002;89.5;87.4;3.3
28;2021-10-12;172;322;534;327525;320258;12536;89.5;87.5;3.4
28;2021-10-13;200;406;590;327725;320664;13126;89.6;87.6;3.6
28;2021-10-14;170;263;552;327895;320927;13678;89.6;87.7;3.7
28;2021-10-15;228;374;644;328123;321301;14322;89.7;87.8;3.9
28;2021-10-16;77;159;124;328200;321460;14446;89.7;87.9;3.9
28;2021-10-17;22;22;51;328222;321482;14497;89.7;87.9;4.0
28;2021-10-18;131;142;328;328353;321624;14825;89.7;87.9;4.1
28;2021-10-19;176;261;634;328529;321885;15459;89.8;88.0;4.2
28;2021-10-20;187;413;748;328716;322298;16207;89.8;88.1;4.4
28;2021-10-21;131;173;579;328847;322471;16786;89.9;88.1;4.6
28;2021-10-22;220;302;597;329067;322773;17383;89.9;88.2;4.8
28;2021-10-23;73;125;132;329140;322898;17515;90.0;88.2;4.8
28;2021-10-24;5;13;7;329145;322911;17522;90.0;88.3;4.8
28;2021-10-25;166;204;601;329311;323115;18123;90.0;88.3;5.0
28;2021-10-26;97;181;540;329408;323296;18663;90.0;88.4;5.1
28;2021-10-27;152;228;671;329560;323524;19334;90.1;88.4;5.3
28;2021-10-28;99;157;657;329659;323681;19991;90.1;88.5;5.5
28;2021-10-29;201;270;777;329860;323951;20768;90.2;88.5;5.7
28;2021-10-30;63;79;113;329923;324030;20881;90.2;88.6;5.7
28;2021-10-31;5;8;8;329928;324038;20889;90.2;88.6;5.7
28;2021-11-01;31;33;64;329959;324071;20953;90.2;88.6;5.7
28;2021-11-02;159;215;684;330118;324286;21637;90.2;88.6;5.9
28;2021-11-03;154;221;879;330272;324507;22516;90.3;88.7;6.2
28;2021-11-04;94;174;874;330366;324681;23390;90.3;88.7;6.4
28;2021-11-05;143;230;1001;330509;324911;24391;90.3;88.8;6.7
28;2021-11-06;82;114;280;330591;325025;24671;90.4;88.8;6.7
28;2021-11-07;3;27;32;330594;325052;24703;90.4;88.8;6.8
28;2021-11-08;117;174;1233;330711;325226;25936;90.4;88.9;7.1
28;2021-11-09;128;212;1223;330839;325438;27159;90.4;88.9;7.4
28;2021-11-10;159;204;1634;330998;325642;28793;90.5;89.0;7.9
28;2021-11-11;37;55;242;331035;325697;29035;90.5;89.0;7.9
28;2021-11-12;129;175;1184;331164;325872;30219;90.5;89.1;8.3
28;2021-11-13;69;79;378;331233;325951;30597;90.5;89.1;8.4
28;2021-11-14;3;2;8;331236;325953;30605;90.5;89.1;8.4
28;2021-11-15;120;166;1502;331356;326119;32107;90.6;89.1;8.8
28;2021-11-16;133;156;1792;331489;326275;33899;90.6;89.2;9.3
28;2021-11-17;163;202;1728;331652;326477;35627;90.6;89.2;9.7
28;2021-11-18;139;150;1633;331791;326627;37260;90.7;89.3;10.2
28;2021-11-19;198;250;1878;331989;326877;39138;90.7;89.3;10.7
28;2021-11-20;91;128;474;332080;327005;39612;90.8;89.4;10.8
28;2021-11-21;24;10;145;332104;327015;39757;90.8;89.4;10.9
28;2021-11-22;152;116;1755;332256;327131;41512;90.8;89.4;11.3
28;2021-11-23;127;123;1550;332383;327254;43062;90.8;89.4;11.8
28;2021-11-24;170;205;1559;332553;327459;44621;90.9;89.5;12.2
28;2021-11-25;140;149;2296;332693;327608;46917;90.9;89.5;12.8
28;2021-11-26;175;219;2899;332868;327827;49816;91.0;89.6;13.6
28;2021-11-27;66;99;780;332934;327926;50596;91.0;89.6;13.8
28;2021-11-28;3;10;74;332937;327936;50670;91.0;89.6;13.8
28;2021-11-29;127;123;2904;333064;328059;53574;91.0;89.7;14.6
28;2021-11-30;96;143;3632;333160;328202;57206;91.1;89.7;15.6
28;2021-12-01;127;182;3750;333287;328384;60956;91.1;89.7;16.7
28;2021-12-02;105;104;4311;333392;328488;65267;91.1;89.8;17.8
28;2021-12-03;142;182;5017;333534;328670;70284;91.2;89.8;19.2
28;2021-12-04;57;73;1507;333591;328743;71791;91.2;89.8;19.6
28;2021-12-05;20;20;991;333611;328763;72782;91.2;89.9;19.9
28;2021-12-06;100;149;4448;333711;328912;77230;91.2;89.9;21.1
28;2021-12-07;102;137;4781;333813;329049;82011;91.2;89.9;22.4
28;2021-12-08;149;165;4479;333962;329214;86490;91.3;90.0;23.6
28;2021-12-09;95;124;5608;334057;329338;92098;91.3;90.0;25.2
28;2021-12-10;121;193;5452;334178;329531;97550;91.3;90.1;26.7
28;2021-12-11;66;68;2050;334244;329599;99600;91.3;90.1;27.2
28;2021-12-12;14;12;397;334258;329611;99997;91.4;90.1;27.3
28;2021-12-13;101;134;4658;334359;329745;104655;91.4;90.1;28.6
28;2021-12-14;108;157;7591;334467;329902;112246;91.4;90.2;30.7
28;2021-12-15;116;206;6895;334583;330108;119141;91.4;90.2;32.6
28;2021-12-16;127;188;6133;334710;330296;125274;91.5;90.3;34.2
28;2021-12-17;140;215;6100;334850;330511;131374;91.5;90.3;35.9
28;2021-12-18;101;103;2477;334951;330614;133851;91.5;90.4;36.6
28;2021-12-19;41;17;1468;334992;330631;135319;91.6;90.4;37.0
29;2020-12-27;0;0;0;0;0;0;0.0;0.0;0.0
29;2020-12-28;0;0;0;0;0;0;0.0;0.0;0.0
29;2020-12-29;0;0;0;0;0;0;0.0;0.0;0.0
29;2020-12-30;0;0;0;0;0;0;0.0;0.0;0.0
29;2020-12-31;1;0;0;1;0;0;0.0;0.0;0.0
29;2021-01-01;4;0;0;5;0;0;0.0;0.0;0.0
29;2021-01-02;2;0;0;7;0;0;0.0;0.0;0.0
29;2021-01-03;1;0;0;8;0;0;0.0;0.0;0.0
29;2021-01-04;34;0;0;42;0;0;0.0;0.0;0.0
29;2021-01-05;33;0;0;75;0;0;0.0;0.0;0.0
29;2021-01-06;43;0;0;118;0;0;0.0;0.0;0.0
29;2021-01-07;151;0;0;269;0;0;0.0;0.0;0.0
29;2021-01-08;407;1;0;676;1;0;0.1;0.0;0.0
29;2021-01-09;2;0;0;678;1;0;0.1;0.0;0.0
29;2021-01-10;5;0;0;683;1;0;0.1;0.0;0.0
29;2021-01-11;669;0;0;1352;1;0;0.2;0.0;0.0
29;2021-01-12;1126;0;0;2478;1;0;0.3;0.0;0.0
29;2021-01-13;1085;2;0;3563;3;0;0.4;0.0;0.0
29;2021-01-14;934;5;0;4497;8;0;0.6;0.0;0.0
29;2021-01-15;1278;7;0;5775;15;0;0.7;0.0;0.0
29;2021-01-16;174;1;0;5949;16;0;0.7;0.0;0.0
29;2021-01-17;115;1;0;6064;17;0;0.8;0.0;0.0
29;2021-01-18;919;5;0;6983;22;0;0.9;0.0;0.0
29;2021-01-19;1354;5;0;8337;27;0;1.1;0.0;0.0
29;2021-01-20;2365;3;0;10702;30;0;1.3;0.0;0.0
29;2021-01-21;5547;19;0;16249;49;0;2.0;0.0;0.0
29;2021-01-22;3716;8;0;19965;57;0;2.5;0.0;0.0
29;2021-01-23;539;0;0;20504;57;0;2.6;0.0;0.0
29;2021-01-24;191;0;0;20695;57;0;2.6;0.0;0.0
29;2021-01-25;607;7;0;21302;64;0;2.7;0.0;0.0
29;2021-01-26;961;33;0;22263;97;0;2.8;0.0;0.0
29;2021-01-27;1354;52;0;23617;149;0;3.0;0.0;0.0
29;2021-01-28;893;139;0;24510;288;0;3.1;0.0;0.0
29;2021-01-29;835;204;0;25345;492;0;3.2;0.1;0.0
29;2021-01-30;279;4;0;25624;496;0;3.2;0.1;0.0
29;2021-01-31;67;3;0;25691;499;0;3.2;0.1;0.0
29;2021-02-01;435;441;0;26126;940;0;3.3;0.1;0.0
29;2021-02-02;925;804;0;27051;1744;0;3.4;0.2;0.0
29;2021-02-03;833;869;0;27884;2613;0;3.5;0.3;0.0
29;2021-02-04;948;629;0;28832;3242;0;3.6;0.4;0.0
29;2021-02-05;724;596;0;29556;3838;0;3.7;0.5;0.0
29;2021-02-06;267;105;0;29823;3943;0;3.8;0.5;0.0
29;2021-02-07;75;108;0;29898;4051;0;3.8;0.5;0.0
29;2021-02-08;378;462;0;30276;4513;0;3.8;0.6;0.0
29;2021-02-09;886;832;0;31162;5345;0;3.9;0.7;0.0
29;2021-02-10;1156;1032;0;32318;6377;0;4.1;0.8;0.0
29;2021-02-11;1798;4094;0;34116;10471;0;4.3;1.3;0.0
29;2021-02-12;2310;2505;0;36426;12976;0;4.6;1.6;0.0
29;2021-02-13;623;376;0;37049;13352;0;4.7;1.7;0.0
29;2021-02-14;12;226;0;37061;13578;0;4.7;1.7;0.0
29;2021-02-15;289;1029;0;37350;14607;0;4.7;1.8;0.0
29;2021-02-16;916;1038;0;38266;15645;0;4.8;2.0;0.0
29;2021-02-17;866;902;0;39132;16547;0;4.9;2.1;0.0
29;2021-02-18;1537;876;0;40669;17423;0;5.1;2.2;0.0
29;2021-02-19;1386;1040;0;42055;18463;0;5.3;2.3;0.0
29;2021-02-20;208;360;0;42263;18823;0;5.3;2.4;0.0
29;2021-02-21;155;161;0;42418;18984;0;5.3;2.4;0.0
29;2021-02-22;777;583;0;43195;19567;0;5.4;2.5;0.0
29;2021-02-23;1248;907;0;44443;20474;0;5.6;2.6;0.0
29;2021-02-24;1475;897;0;45918;21371;0;5.8;2.7;0.0
29;2021-02-25;2450;948;0;48368;22319;0;6.1;2.8;0.0
29;2021-02-26;2715;766;0;51083;23085;0;6.4;2.9;0.0
29;2021-02-27;1278;275;0;52361;23360;0;6.6;2.9;0.0
29;2021-02-28;191;69;0;52552;23429;0;6.6;3.0;0.0
29;2021-03-01;942;485;0;53494;23914;0;6.7;3.0;0.0
29;2021-03-02;1834;845;0;55328;24759;0;7.0;3.1;0.0
29;2021-03-03;2126;1053;0;57454;25812;0;7.2;3.3;0.0
29;2021-03-04;2844;1603;0;60298;27415;0;7.6;3.5;0.0
29;2021-03-05;3547;1693;0;63845;29108;0;8.0;3.7;0.0
29;2021-03-06;2008;437;0;65853;29545;0;8.3;3.7;0.0
29;2021-03-07;419;80;0;66272;29625;0;8.3;3.7;0.0
29;2021-03-08;1311;594;0;67583;30219;0;8.5;3.8;0.0
29;2021-03-09;2612;983;0;70195;31202;0;8.8;3.9;0.0
29;2021-03-10;2449;902;0;72644;32104;0;9.2;4.0;0.0
29;2021-03-11;4438;1021;0;77082;33125;0;9.7;4.2;0.0
29;2021-03-12;5252;966;0;82334;34091;0;10.4;4.3;0.0
29;2021-03-13;2799;411;0;85133;34502;0;10.7;4.3;0.0
29;2021-03-14;354;4;0;85487;34506;0;10.8;4.3;0.0
29;2021-03-15;2085;278;0;87572;34784;0;11.0;4.4;0.0
29;2021-03-16;1873;786;0;89445;35570;0;11.3;4.5;0.0
29;2021-03-17;1921;732;0;91366;36302;0;11.5;4.6;0.0
29;2021-03-18;1928;1045;0;93294;37347;0;11.8;4.7;0.0
29;2021-03-19;3322;900;0;96616;38247;0;12.2;4.8;0.0
29;2021-03-20;1935;223;0;98551;38470;0;12.4;4.8;0.0
29;2021-03-21;131;12;0;98682;38482;0;12.4;4.8;0.0
29;2021-03-22;1683;610;0;100365;39092;0;12.6;4.9;0.0
29;2021-03-23;3531;1062;0;103896;40154;0;13.1;5.1;0.0
29;2021-03-24;3857;1006;0;107753;41160;0;13.6;5.2;0.0
29;2021-03-25;4886;1070;0;112639;42230;0;14.2;5.3;0.0
29;2021-03-26;5386;1172;0;118025;43402;0;14.9;5.5;0.0
29;2021-03-27;2484;324;0;120509;43726;0;15.2;5.5;0.0
29;2021-03-28;180;47;0;120689;43773;0;15.2;5.5;0.0
29;2021-03-29;2126;837;0;122815;44610;0;15.5;5.6;0.0
29;2021-03-30;4135;1363;0;126950;45973;0;16.0;5.8;0.0
29;2021-03-31;4138;1169;0;131088;47142;0;16.5;5.9;0.0
29;2021-04-01;5220;1169;0;136308;48311;0;17.2;6.1;0.0
29;2021-04-02;4917;1195;0;141225;49506;0;17.8;6.2;0.0
29;2021-04-03;2669;542;0;143894;50048;0;18.1;6.3;0.0
29;2021-04-04;147;31;0;144041;50079;0;18.1;6.3;0.0
29;2021-04-05;928;313;0;144969;50392;0;18.3;6.3;0.0
29;2021-04-06;3352;1278;0;148321;51670;0;18.7;6.5;0.0
29;2021-04-07;3784;997;0;152105;52667;0;19.2;6.6;0.0
29;2021-04-08;5342;2027;0;157447;54694;0;19.8;6.9;0.0
29;2021-04-09;6828;1585;0;164275;56279;0;20.7;7.1;0.0
29;2021-04-10;3554;714;0;167829;56993;0;21.1;7.2;0.0
29;2021-04-11;116;73;0;167945;57066;0;21.2;7.2;0.0
29;2021-04-12;4001;1526;0;171946;58592;0;21.7;7.4;0.0
29;2021-04-13;5988;1811;0;177934;60403;0;22.4;7.6;0.0
29;2021-04-14;4883;1778;0;182817;62181;0;23.0;7.8;0.0
29;2021-04-15;7228;1796;0;190045;63977;0;23.9;8.1;0.0
29;2021-04-16;6690;1397;0;196735;65374;0;24.8;8.2;0.0
29;2021-04-17;3751;1013;0;200486;66387;0;25.3;8.4;0.0
29;2021-04-18;461;43;0;200947;66430;0;25.3;8.4;0.0
29;2021-04-19;3938;1483;0;204885;67913;0;25.8;8.6;0.0
29;2021-04-20;4477;2241;0;209362;70154;0;26.4;8.8;0.0
29;2021-04-21;4447;2293;0;213809;72447;0;26.9;9.1;0.0
29;2021-04-22;6697;2911;0;220506;75358;0;27.8;9.5;0.0
29;2021-04-23;6103;2282;0;226609;77640;0;28.5;9.8;0.0
29;2021-04-24;3952;1424;0;230561;79064;0;29.0;10.0;0.0
29;2021-04-25;423;159;0;230984;79223;0;29.1;10.0;0.0
29;2021-04-26;5340;1955;0;236324;81178;0;29.8;10.2;0.0
29;2021-04-27;5410;3349;0;241734;84527;0;30.5;10.6;0.0
29;2021-04-28;5525;3089;0;247259;87616;0;31.1;11.0;0.0
29;2021-04-29;6627;3531;0;253886;91147;0;32.0;11.5;0.0
29;2021-04-30;6271;4103;0;260157;95250;0;32.8;12.0;0.0
29;2021-05-01;1973;954;0;262130;96204;0;33.0;12.1;0.0
29;2021-05-02;1219;168;0;263349;96372;0;33.2;12.1;0.0
29;2021-05-03;4543;2369;0;267892;98741;0;33.7;12.4;0.0
29;2021-05-04;4191;3878;0;272083;102619;0;34.3;12.9;0.0
29;2021-05-05;4610;3565;0;276693;106184;0;34.9;13.4;0.0
29;2021-05-06;6195;3828;0;282888;110012;0;35.6;13.9;0.0
29;2021-05-07;5984;4692;0;288872;114704;0;36.4;14.5;0.0
29;2021-05-08;2102;557;0;290974;115261;0;36.7;14.5;0.0
29;2021-05-09;1672;146;0;292646;115407;0;36.9;14.5;0.0
29;2021-05-10;4871;3810;0;297517;119217;0;37.5;15.0;0.0
29;2021-05-11;4838;5107;0;302355;124324;0;38.1;15.7;0.0
29;2021-05-12;5186;4475;0;307541;128799;0;38.7;16.2;0.0
29;2021-05-13;3405;1494;0;310946;130293;0;39.2;16.4;0.0
29;2021-05-14;5768;3980;0;316714;134273;0;39.9;16.9;0.0
29;2021-05-15;4128;2272;0;320842;136545;0;40.4;17.2;0.0
29;2021-05-16;1531;282;0;322373;136827;0;40.6;17.2;0.0
29;2021-05-17;5506;3120;0;327879;139947;0;41.3;17.6;0.0
29;2021-05-18;5758;3119;0;333637;143066;0;42.0;18.0;0.0
29;2021-05-19;6110;3022;0;339747;146088;0;42.8;18.4;0.0
29;2021-05-20;7123;4610;0;346870;150698;0;43.7;19.0;0.0
29;2021-05-21;7117;3890;0;353987;154588;0;44.6;19.5;0.0
29;2021-05-22;5337;2081;0;359324;156669;0;45.3;19.7;0.0
29;2021-05-23;1635;69;0;360959;156738;0;45.5;19.7;0.0
29;2021-05-24;3587;544;0;364546;157282;0;45.9;19.8;0.0
29;2021-05-25;5855;3143;0;370401;160425;0;46.7;20.2;0.0
29;2021-05-26;5876;3172;0;376277;163597;0;47.4;20.6;0.0
29;2021-05-27;6748;4100;0;383025;167697;0;48.3;21.1;0.0
29;2021-05-28;6527;4626;0;389552;172323;0;49.1;21.7;0.0
29;2021-05-29;4346;2796;0;393898;175119;0;49.6;22.1;0.0
29;2021-05-30;1107;364;0;395005;175483;0;49.8;22.1;0.0
29;2021-05-31;6222;3602;0;401227;179085;0;50.5;22.6;0.0
29;2021-06-01;6628;4428;0;407855;183513;0;51.4;23.1;0.0
29;2021-06-02;6170;4149;0;414025;187662;0;52.2;23.6;0.0
29;2021-06-03;7606;4482;0;421631;192144;0;53.1;24.2;0.0
29;2021-06-04;6882;6152;0;428513;198296;0;54.0;25.0;0.0
29;2021-06-05;5496;3034;0;434009;201330;0;54.7;25.4;0.0
29;2021-06-06;1267;532;0;435276;201862;0;54.8;25.4;0.0
29;2021-06-07;4752;5541;0;440028;207403;0;55.4;26.1;0.0
29;2021-06-08;7082;5193;0;447110;212596;0;56.3;26.8;0.0
29;2021-06-09;6435;4703;0;453545;217299;0;57.1;27.4;0.0
29;2021-06-10;7729;4962;0;461274;222261;0;58.1;28.0;0.0
29;2021-06-11;8200;5752;0;469474;228013;0;59.1;28.7;0.0
29;2021-06-12;6369;2739;0;475843;230752;0;59.9;29.1;0.0
29;2021-06-13;2221;1328;0;478064;232080;0;60.2;29.2;0.0
29;2021-06-14;3971;6273;0;482035;238353;0;60.7;30.0;0.0
29;2021-06-15;5332;6101;0;487367;244454;0;61.4;30.8;0.0
29;2021-06-16;5422;5609;0;492789;250063;0;62.1;31.5;0.0
29;2021-06-17;6190;6295;0;498979;256358;0;62.9;32.3;0.0
29;2021-06-18;6000;7447;0;504979;263805;0;63.6;33.2;0.0
29;2021-06-19;4530;3476;0;509509;267281;0;64.2;33.7;0.0
29;2021-06-20;850;1427;0;510359;268708;0;64.3;33.9;0.0
29;2021-06-21;3642;6476;0;514001;275184;0;64.8;34.7;0.0
29;2021-06-22;4300;6354;0;518301;281538;0;65.3;35.5;0.0
29;2021-06-23;4466;6145;0;522767;287683;0;65.9;36.2;0.0
29;2021-06-24;4580;6688;0;527347;294371;0;66.4;37.1;0.0
29;2021-06-25;3506;7489;0;530853;301860;0;66.9;38.0;0.0
29;2021-06-26;2045;4073;0;532898;305933;0;67.1;38.5;0.0
29;2021-06-27;933;1574;0;533831;307507;0;67.3;38.7;0.0
29;2021-06-28;2670;6807;0;536501;314314;0;67.6;39.6;0.0
29;2021-06-29;2721;7649;0;539222;321963;0;67.9;40.6;0.0
29;2021-06-30;2926;7361;0;542148;329324;0;68.3;41.5;0.0
29;2021-07-01;3668;8227;0;545816;337551;0;68.8;42.5;0.0
29;2021-07-02;3415;9415;0;549231;346966;0;69.2;43.7;0.0
29;2021-07-03;2275;5978;0;551506;352944;0;69.5;44.5;0.0
29;2021-07-04;806;1707;0;552312;354651;0;69.6;44.7;0.0
29;2021-07-05;1836;7166;0;554148;361817;0;69.8;45.6;0.0
29;2021-07-06;1599;8053;0;555747;369870;0;70.0;46.6;0.0
29;2021-07-07;1755;6973;0;557502;376843;0;70.2;47.5;0.0
29;2021-07-08;2417;8030;0;559919;384873;0;70.5;48.5;0.0
29;2021-07-09;2584;8963;0;562503;393836;0;70.9;49.6;0.0
29;2021-07-10;1862;6002;0;564365;399838;0;71.1;50.4;0.0
29;2021-07-11;446;1072;0;564811;400910;0;71.2;50.5;0.0
29;2021-07-12;1972;8149;0;566783;409059;0;71.4;51.5;0.0
29;2021-07-13;2796;8605;0;569579;417664;0;71.8;52.6;0.0
29;2021-07-14;2054;3322;0;571633;420986;0;72.0;53.0;0.0
29;2021-07-15;3804;9444;0;575437;430430;0;72.5;54.2;0.0
29;2021-07-16;4496;9038;0;579933;439468;0;73.1;55.4;0.0
29;2021-07-17;3185;5977;0;583118;445445;0;73.5;56.1;0.0
29;2021-07-18;650;1070;0;583768;446515;0;73.5;56.3;0.0
29;2021-07-19;3182;7379;0;586950;453894;0;73.9;57.2;0.0
29;2021-07-20;3668;9179;0;590618;463073;0;74.4;58.3;0.0
29;2021-07-21;3698;7663;0;594316;470736;0;74.9;59.3;0.0
29;2021-07-22;3582;8338;0;597898;479074;0;75.3;60.4;0.0
29;2021-07-23;4118;10369;0;602016;489443;0;75.8;61.7;0.0
29;2021-07-24;2511;5778;0;604527;495221;0;76.2;62.4;0.0
29;2021-07-25;651;2295;0;605178;497516;0;76.2;62.7;0.0
29;2021-07-26;3415;6937;0;608593;504453;0;76.7;63.6;0.0
29;2021-07-27;3863;6932;0;612456;511385;0;77.2;64.4;0.0
29;2021-07-28;4284;5804;0;616740;517189;0;77.7;65.2;0.0
29;2021-07-29;5670;6107;0;622410;523296;0;78.4;65.9;0.0
29;2021-07-30;5371;6222;0;627781;529518;0;79.1;66.7;0.0
29;2021-07-31;2970;4676;0;630751;534194;0;79.5;67.3;0.0
29;2021-08-01;702;861;0;631453;535055;0;79.6;67.4;0.0
29;2021-08-02;4224;4930;0;635677;539985;0;80.1;68.0;0.0
29;2021-08-03;5373;4133;0;641050;544118;0;80.8;68.5;0.0
29;2021-08-04;5521;3499;0;646571;547617;0;81.5;69.0;0.0
29;2021-08-05;6283;3767;0;652854;551384;0;82.2;69.5;0.0
29;2021-08-06;5796;4092;0;658650;555476;0;83.0;70.0;0.0
29;2021-08-07;3910;2726;1;662560;558202;1;83.5;70.3;0.0
29;2021-08-08;835;676;0;663395;558878;1;83.6;70.4;0.0
29;2021-08-09;3031;4406;0;666426;563284;1;84.0;71.0;0.0
29;2021-08-10;4269;3663;0;670695;566947;1;84.5;71.4;0.0
29;2021-08-11;3851;3082;0;674546;570029;1;85.0;71.8;0.0
29;2021-08-12;4434;4252;0;678980;574281;1;85.5;72.3;0.0
29;2021-08-13;4066;3644;0;683046;577925;1;86.1;72.8;0.0
29;2021-08-14;2701;2682;0;685747;580607;1;86.4;73.1;0.0
29;2021-08-15;355;422;0;686102;581029;1;86.4;73.2;0.0
29;2021-08-16;3092;4212;0;689194;585241;1;86.8;73.7;0.0
29;2021-08-17;4085;3344;0;693279;588585;1;87.3;74.2;0.0
29;2021-08-18;3475;3584;0;696754;592169;1;87.8;74.6;0.0
29;2021-08-19;3599;4401;0;700353;596570;1;88.2;75.2;0.0
29;2021-08-20;3244;4490;0;703597;601060;1;88.6;75.7;0.0
29;2021-08-21;2068;3019;0;705665;604079;1;88.9;76.1;0.0
29;2021-08-22;221;422;0;705886;604501;1;88.9;76.2;0.0
29;2021-08-23;2239;4443;0;708125;608944;1;89.2;76.7;0.0
29;2021-08-24;2352;4835;0;710477;613779;1;89.5;77.3;0.0
29;2021-08-25;2052;4200;0;712529;617979;1;89.8;77.9;0.0
29;2021-08-26;2164;5216;0;714693;623195;1;90.0;78.5;0.0
29;2021-08-27;1873;5753;0;716566;628948;1;90.3;79.2;0.0
29;2021-08-28;1358;3855;0;717924;632803;1;90.4;79.7;0.0
29;2021-08-29;384;1264;0;718308;634067;1;90.5;79.9;0.0
29;2021-08-30;1368;4127;66;719676;638194;67;90.7;80.4;0.0
29;2021-08-31;1436;4317;117;721112;642511;184;90.8;80.9;0.0
29;2021-09-01;1310;3743;229;722422;646254;413;91.0;81.4;0.1
29;2021-09-02;1067;3958;338;723489;650212;751;91.1;81.9;0.1
29;2021-09-03;1369;4689;501;724858;654901;1252;91.3;82.5;0.2
29;2021-09-04;1318;3675;257;726176;658576;1509;91.5;83.0;0.2
29;2021-09-05;195;658;44;726371;659234;1553;91.5;83.1;0.2
29;2021-09-06;703;3249;361;727074;662483;1914;91.6;83.5;0.2
29;2021-09-07;862;3339;572;727936;665822;2486;91.7;83.9;0.3
29;2021-09-08;846;3367;488;728782;669189;2974;91.8;84.3;0.4
29;2021-09-09;891;3302;489;729673;672491;3463;91.9;84.7;0.4
29;2021-09-10;1151;4267;731;730824;676758;4194;92.1;85.3;0.5
29;2021-09-11;660;3303;197;731484;680061;4391;92.2;85.7;0.6
29;2021-09-12;109;391;28;731593;680452;4419;92.2;85.7;0.6
29;2021-09-13;794;3081;679;732387;683533;5098;92.3;86.1;0.6
29;2021-09-14;714;2908;1100;733101;686441;6198;92.4;86.5;0.8
29;2021-09-15;690;3158;696;733791;689599;6894;92.4;86.9;0.9
29;2021-09-16;801;2613;1380;734592;692212;8274;92.5;87.2;1.0
29;2021-09-17;853;3068;978;735445;695280;9252;92.7;87.6;1.2
29;2021-09-18;566;3299;502;736011;698579;9754;92.7;88.0;1.2
29;2021-09-19;68;369;38;736079;698948;9792;92.7;88.1;1.2
29;2021-09-20;447;2036;795;736526;700984;10587;92.8;88.3;1.3
29;2021-09-21;432;1773;1146;736958;702757;11733;92.8;88.5;1.5
29;2021-09-22;361;2144;1212;737319;704901;12945;92.9;88.8;1.6
29;2021-09-23;443;1672;1775;737762;706573;14720;92.9;89.0;1.9
29;2021-09-24;461;2102;1367;738223;708675;16087;93.0;89.3;2.0
29;2021-09-25;337;2576;401;738560;711251;16488;93.0;89.6;2.1
29;2021-09-26;51;215;27;738611;711466;16515;93.1;89.6;2.1
29;2021-09-27;305;1499;752;738916;712965;17267;93.1;89.8;2.2
29;2021-09-28;246;1434;785;739162;714399;18052;93.1;90.0;2.3
29;2021-09-29;393;1609;1054;739555;716008;19106;93.2;90.2;2.4
29;2021-09-30;296;1217;1078;739851;717225;20184;93.2;90.4;2.5
29;2021-10-01;503;1441;1305;740354;718666;21489;93.3;90.5;2.7
29;2021-10-02;339;1562;362;740693;720228;21851;93.3;90.7;2.8
29;2021-10-03;13;35;10;740706;720263;21861;93.3;90.7;2.8
29;2021-10-04;313;1198;676;741019;721461;22537;93.4;90.9;2.8
29;2021-10-05;231;1002;861;741250;722463;23398;93.4;91.0;2.9
29;2021-10-06;316;1102;1014;741566;723565;24412;93.4;91.2;3.1
29;2021-10-07;282;873;895;741848;724438;25307;93.5;91.3;3.2
29;2021-10-08;459;1205;1382;742307;725643;26689;93.5;91.4;3.4
29;2021-10-09;313;933;519;742620;726576;27208;93.6;91.5;3.4
29;2021-10-10;5;18;11;742625;726594;27219;93.6;91.5;3.4
29;2021-10-11;278;835;917;742903;727429;28136;93.6;91.6;3.5
29;2021-10-12;229;580;977;743132;728009;29113;93.6;91.7;3.7
29;2021-10-13;293;721;1120;743425;728730;30233;93.7;91.8;3.8
29;2021-10-14;277;638;1119;743702;729368;31352;93.7;91.9;3.9
29;2021-10-15;361;701;1260;744063;730069;32612;93.7;92.0;4.1
29;2021-10-16;303;574;639;744366;730643;33251;93.8;92.0;4.2
29;2021-10-17;13;27;29;744379;730670;33280;93.8;92.1;4.2
29;2021-10-18;205;520;858;744584;731190;34138;93.8;92.1;4.3
29;2021-10-19;203;348;950;744787;731538;35088;93.8;92.2;4.4
29;2021-10-20;305;523;1490;745092;732061;36578;93.9;92.2;4.6
29;2021-10-21;217;396;1143;745309;732457;37721;93.9;92.3;4.8
29;2021-10-22;307;554;1440;745616;733011;39161;93.9;92.3;4.9
29;2021-10-23;273;444;932;745889;733455;40093;94.0;92.4;5.1
29;2021-10-24;1;16;3;745890;733471;40096;94.0;92.4;5.1
29;2021-10-25;168;325;842;746058;733796;40938;94.0;92.4;5.2
29;2021-10-26;172;260;966;746230;734056;41904;94.0;92.5;5.3
29;2021-10-27;317;408;1841;746547;734464;43745;94.1;92.5;5.5
29;2021-10-28;268;327;1397;746815;734791;45142;94.1;92.6;5.7
29;2021-10-29;266;418;1667;747081;735209;46809;94.1;92.6;5.9
29;2021-10-30;209;375;1258;747290;735584;48067;94.1;92.7;6.1
29;2021-10-31;6;14;20;747296;735598;48087;94.1;92.7;6.1
29;2021-11-01;23;8;22;747319;735606;48109;94.1;92.7;6.1
29;2021-11-02;169;271;1205;747488;735877;49314;94.2;92.7;6.2
29;2021-11-03;195;265;1381;747683;736142;50695;94.2;92.7;6.4
29;2021-11-04;212;354;1555;747895;736496;52250;94.2;92.8;6.6
29;2021-11-05;271;393;2464;748166;736889;54714;94.3;92.8;6.9
29;2021-11-06;258;397;1382;748424;737286;56096;94.3;92.9;7.1
29;2021-11-07;10;28;66;748434;737314;56162;94.3;92.9;7.1
29;2021-11-08;157;272;1818;748591;737586;57980;94.3;92.9;7.3
29;2021-11-09;161;261;2249;748752;737847;60229;94.3;93.0;7.6
29;2021-11-10;220;322;2841;748972;738169;63070;94.4;93.0;7.9
29;2021-11-11;8;13;62;748980;738182;63132;94.4;93.0;8.0
29;2021-11-12;200;356;2467;749180;738538;65599;94.4;93.0;8.3
29;2021-11-13;242;327;1684;749422;738865;67283;94.4;93.1;8.5
29;2021-11-14;11;11;70;749433;738876;67353;94.4;93.1;8.5
29;2021-11-15;181;218;2743;749614;739094;70096;94.4;93.1;8.8
29;2021-11-16;196;208;3385;749810;739302;73481;94.5;93.1;9.3
29;2021-11-17;303;316;3371;750113;739618;76852;94.5;93.2;9.7
29;2021-11-18;241;283;3919;750354;739901;80771;94.5;93.2;10.2
29;2021-11-19;340;422;5076;750694;740323;85847;94.6;93.3;10.8
29;2021-11-20;309;284;2357;751003;740607;88204;94.6;93.3;11.1
29;2021-11-21;34;23;134;751037;740630;88338;94.6;93.3;11.1
29;2021-11-22;215;176;3248;751252;740806;91586;94.6;93.3;11.5
29;2021-11-23;223;177;3824;751475;740983;95410;94.7;93.3;12.0
29;2021-11-24;296;287;3996;751771;741270;99406;94.7;93.4;12.5
29;2021-11-25;264;207;4842;752035;741477;104248;94.7;93.4;13.1
29;2021-11-26;324;446;7226;752359;741923;111474;94.8;93.5;14.0
29;2021-11-27;264;293;4025;752623;742216;115499;94.8;93.5;14.6
29;2021-11-28;21;21;405;752644;742237;115904;94.8;93.5;14.6
29;2021-11-29;180;204;4755;752824;742441;120659;94.8;93.5;15.2
29;2021-11-30;248;217;7936;753072;742658;128595;94.9;93.6;16.2
29;2021-12-01;211;236;7519;753283;742894;136114;94.9;93.6;17.1
29;2021-12-02;217;211;9784;753500;743105;145898;94.9;93.6;18.4
29;2021-12-03;215;283;10397;753715;743388;156295;95.0;93.7;19.7
29;2021-12-04;143;330;4900;753858;743718;161195;95.0;93.7;20.3
29;2021-12-05;12;27;779;753870;743745;161974;95.0;93.7;20.4
29;2021-12-06;169;268;7789;754039;744013;169763;95.0;93.7;21.4
29;2021-12-07;213;250;11010;754252;744263;180773;95.0;93.8;22.8
29;2021-12-08;192;326;9061;754444;744589;189834;95.0;93.8;23.9
29;2021-12-09;227;245;12333;754671;744834;202167;95.1;93.8;25.5
29;2021-12-10;277;398;13827;754948;745232;215994;95.1;93.9;27.2
29;2021-12-11;172;364;7267;755120;745596;223261;95.1;93.9;28.1
29;2021-12-12;40;64;1681;755160;745660;224942;95.1;93.9;28.3
29;2021-12-13;195;243;8796;755355;745903;233738;95.2;94.0;29.4
29;2021-12-14;217;290;13218;755572;746193;246956;95.2;94.0;31.1
29;2021-12-15;271;284;12462;755843;746477;259418;95.2;94.0;32.7
29;2021-12-16;252;318;14154;756095;746795;273572;95.3;94.1;34.5
29;2021-12-17;315;466;15275;756410;747261;288847;95.3;94.1;36.4
29;2021-12-18;238;352;8607;756648;747613;297454;95.3;94.2;37.5
29;2021-12-19;52;78;2228;756700;747691;299682;95.3;94.2;37.8
2A;2020-12-27;0;0;0;0;0;0;0.0;0.0;0.0
2A;2020-12-28;0;0;0;0;0;0;0.0;0.0;0.0
2A;2020-12-29;0;0;0;0;0;0;0.0;0.0;0.0
2A;2020-12-30;0;0;0;0;0;0;0.0;0.0;0.0
2A;2020-12-31;0;0;0;0;0;0;0.0;0.0;0.0
2A;2021-01-01;0;0;0;0;0;0;0.0;0.0;0.0
2A;2021-01-02;0;0;0;0;0;0;0.0;0.0;0.0
2A;2021-01-03;0;0;0;0;0;0;0.0;0.0;0.0
2A;2021-01-04;0;0;0;0;0;0;0.0;0.0;0.0
2A;2021-01-05;1;0;0;1;0;0;0.0;0.0;0.0
2A;2021-01-06;6;0;0;7;0;0;0.0;0.0;0.0
2A;2021-01-07;109;1;0;116;1;0;0.1;0.0;0.0
2A;2021-01-08;108;1;0;224;2;0;0.2;0.0;0.0
2A;2021-01-09;38;0;0;262;2;0;0.2;0.0;0.0
2A;2021-01-10;28;0;0;290;2;0;0.2;0.0;0.0
2A;2021-01-11;76;0;0;366;2;0;0.3;0.0;0.0
2A;2021-01-12;82;0;0;448;2;0;0.3;0.0;0.0
2A;2021-01-13;114;1;0;562;3;0;0.4;0.0;0.0
2A;2021-01-14;191;1;0;753;4;0;0.5;0.0;0.0
2A;2021-01-15;135;0;0;888;4;0;0.6;0.0;0.0
2A;2021-01-16;141;2;0;1029;6;0;0.7;0.0;0.0
2A;2021-01-17;72;1;0;1101;7;0;0.8;0.0;0.0
2A;2021-01-18;193;2;0;1294;9;0;0.9;0.0;0.0
2A;2021-01-19;461;5;0;1755;14;0;1.2;0.0;0.0
2A;2021-01-20;349;2;0;2104;16;0;1.5;0.0;0.0
2A;2021-01-21;435;1;0;2539;17;0;1.8;0.0;0.0
2A;2021-01-22;353;0;0;2892;17;0;2.0;0.0;0.0
2A;2021-01-23;171;0;0;3063;17;0;2.1;0.0;0.0
2A;2021-01-24;110;1;0;3173;18;0;2.2;0.0;0.0
2A;2021-01-25;206;0;0;3379;18;0;2.4;0.0;0.0
2A;2021-01-26;400;9;0;3779;27;0;2.6;0.0;0.0
2A;2021-01-27;295;6;0;4074;33;0;2.9;0.0;0.0
2A;2021-01-28;317;72;0;4391;105;0;3.1;0.1;0.0
2A;2021-01-29;329;59;0;4720;164;0;3.3;0.1;0.0
2A;2021-01-30;112;33;0;4832;197;0;3.4;0.1;0.0
2A;2021-01-31;73;11;0;4905;208;0;3.4;0.1;0.0
2A;2021-02-01;215;50;0;5120;258;0;3.6;0.2;0.0
2A;2021-02-02;282;117;0;5402;375;0;3.8;0.3;0.0
2A;2021-02-03;257;72;0;5659;447;0;4.0;0.3;0.0
2A;2021-02-04;247;128;0;5906;575;0;4.1;0.4;0.0
2A;2021-02-05;260;96;0;6166;671;0;4.3;0.5;0.0
2A;2021-02-06;115;58;0;6281;729;0;4.4;0.5;0.0
2A;2021-02-07;49;45;0;6330;774;0;4.4;0.5;0.0
2A;2021-02-08;94;190;0;6424;964;0;4.5;0.7;0.0
2A;2021-02-09;147;285;0;6571;1249;0;4.6;0.9;0.0
2A;2021-02-10;170;214;0;6741;1463;0;4.7;1.0;0.0
2A;2021-02-11;292;324;0;7033;1787;0;4.9;1.3;0.0
2A;2021-02-12;319;283;0;7352;2070;0;5.1;1.4;0.0
2A;2021-02-13;211;58;0;7563;2128;0;5.3;1.5;0.0
2A;2021-02-14;114;70;0;7677;2198;0;5.4;1.5;0.0
2A;2021-02-15;187;180;0;7864;2378;0;5.5;1.7;0.0
2A;2021-02-16;359;319;0;8223;2697;0;5.8;1.9;0.0
2A;2021-02-17;269;181;0;8492;2878;0;5.9;2.0;0.0
2A;2021-02-18;325;198;0;8817;3076;0;6.2;2.2;0.0
2A;2021-02-19;147;287;0;8964;3363;0;6.3;2.4;0.0
2A;2021-02-20;221;117;0;9185;3480;0;6.4;2.4;0.0
2A;2021-02-21;47;42;0;9232;3522;0;6.5;2.5;0.0
2A;2021-02-22;79;203;0;9311;3725;0;6.5;2.6;0.0
2A;2021-02-23;114;284;0;9425;4009;0;6.6;2.8;0.0
2A;2021-02-24;84;280;0;9509;4289;0;6.7;3.0;0.0
2A;2021-02-25;112;258;0;9621;4547;0;6.7;3.2;0.0
2A;2021-02-26;121;251;0;9742;4798;0;6.8;3.4;0.0
2A;2021-02-27;289;66;0;10031;4864;0;7.0;3.4;0.0
2A;2021-02-28;60;54;0;10091;4918;0;7.1;3.4;0.0
2A;2021-03-01;116;140;0;10207;5058;0;7.1;3.5;0.0
2A;2021-03-02;198;269;0;10405;5327;0;7.3;3.7;0.0
2A;2021-03-03;232;242;0;10637;5569;0;7.4;3.9;0.0
2A;2021-03-04;493;206;0;11130;5775;0;7.8;4.0;0.0
2A;2021-03-05;929;287;0;12059;6062;0;8.4;4.2;0.0
2A;2021-03-06;1095;76;0;13154;6138;0;9.2;4.3;0.0
2A;2021-03-07;916;41;0;14070;6179;0;9.8;4.3;0.0
2A;2021-03-08;874;97;0;14944;6276;0;10.5;4.4;0.0
2A;2021-03-09;882;166;0;15826;6442;0;11.1;4.5;0.0
2A;2021-03-10;612;139;0;16438;6581;0;11.5;4.6;0.0
2A;2021-03-11;685;274;0;17123;6855;0;12.0;4.8;0.0
2A;2021-03-12;563;298;0;17686;7153;0;12.4;5.0;0.0
2A;2021-03-13;578;192;0;18264;7345;0;12.8;5.1;0.0
2A;2021-03-14;298;108;0;18562;7453;0;13.0;5.2;0.0
2A;2021-03-15;380;192;0;18942;7645;0;13.3;5.3;0.0
2A;2021-03-16;483;345;0;19425;7990;0;13.6;5.6;0.0
2A;2021-03-17;681;255;0;20106;8245;0;14.1;5.8;0.0
2A;2021-03-18;438;294;0;20544;8539;0;14.4;6.0;0.0
2A;2021-03-19;515;149;0;21059;8688;0;14.7;6.1;0.0
2A;2021-03-20;1005;246;0;22064;8934;0;15.4;6.3;0.0
2A;2021-03-21;632;49;0;22696;8983;0;15.9;6.3;0.0
2A;2021-03-22;333;67;0;23029;9050;0;16.1;6.3;0.0
2A;2021-03-23;493;55;0;23522;9105;0;16.5;6.4;0.0
2A;2021-03-24;825;90;0;24347;9195;0;17.0;6.4;0.0
2A;2021-03-25;901;136;0;25248;9331;0;17.7;6.5;0.0
2A;2021-03-26;1026;152;0;26274;9483;0;18.4;6.6;0.0
2A;2021-03-27;1118;191;0;27392;9674;0;19.2;6.8;0.0
2A;2021-03-28;232;86;0;27624;9760;0;19.3;6.8;0.0
2A;2021-03-29;289;126;0;27913;9886;0;19.5;6.9;0.0
2A;2021-03-30;384;233;0;28297;10119;0;19.8;7.1;0.0
2A;2021-03-31;453;225;0;28750;10344;0;20.1;7.2;0.0
2A;2021-04-01;603;424;0;29353;10768;0;20.5;7.5;0.0
2A;2021-04-02;846;761;0;30199;11529;0;21.1;8.1;0.0
2A;2021-04-03;616;923;0;30815;12452;0;21.6;8.7;0.0
2A;2021-04-04;528;694;0;31343;13146;0;21.9;9.2;0.0
2A;2021-04-05;473;639;0;31816;13785;0;22.3;9.6;0.0
2A;2021-04-06;497;522;0;32313;14307;0;22.6;10.0;0.0
2A;2021-04-07;708;417;0;33021;14724;0;23.1;10.3;0.0
2A;2021-04-08;954;353;0;33975;15077;0;23.8;10.5;0.0
2A;2021-04-09;864;389;0;34839;15466;0;24.4;10.8;0.0
2A;2021-04-10;953;364;0;35792;15830;0;25.0;11.1;0.0
2A;2021-04-11;327;242;0;36119;16072;0;25.3;11.2;0.0
2A;2021-04-12;614;355;0;36733;16427;0;25.7;11.5;0.0
2A;2021-04-13;304;377;0;37037;16804;0;25.9;11.8;0.0
2A;2021-04-14;961;572;0;37998;17376;0;26.6;12.2;0.0
2A;2021-04-15;921;514;0;38919;17890;0;27.2;12.5;0.0
2A;2021-04-16;788;380;0;39707;18270;0;27.8;12.8;0.0
2A;2021-04-17;1214;875;0;40921;19145;0;28.6;13.4;0.0
2A;2021-04-18;868;853;0;41789;19998;0;29.2;14.0;0.0
2A;2021-04-19;230;330;0;42019;20328;0;29.4;14.2;0.0
2A;2021-04-20;305;343;0;42324;20671;0;29.6;14.5;0.0
2A;2021-04-21;647;702;0;42971;21373;0;30.1;15.0;0.0
2A;2021-04-22;794;628;0;43765;22001;0;30.6;15.4;0.0
2A;2021-04-23;874;732;0;44639;22733;0;31.2;15.9;0.0
2A;2021-04-24;1541;914;0;46180;23647;0;32.3;16.5;0.0
2A;2021-04-25;844;277;0;47024;23924;0;32.9;16.7;0.0
2A;2021-04-26;298;218;0;47322;24142;0;33.1;16.9;0.0
2A;2021-04-27;302;355;0;47624;24497;0;33.3;17.1;0.0
2A;2021-04-28;1475;411;0;49099;24908;0;34.4;17.4;0.0
2A;2021-04-29;948;360;0;50047;25268;0;35.0;17.7;0.0
2A;2021-04-30;1019;970;0;51066;26238;0;35.7;18.4;0.0
2A;2021-05-01;868;546;0;51934;26784;0;36.3;18.7;0.0
2A;2021-05-02;574;632;0;52508;27416;0;36.7;19.2;0.0
2A;2021-05-03;544;530;0;53052;27946;0;37.1;19.6;0.0
2A;2021-05-04;666;504;0;53718;28450;0;37.6;19.9;0.0
2A;2021-05-05;880;918;0;54598;29368;0;38.2;20.5;0.0
2A;2021-05-06;788;845;0;55386;30213;0;38.8;21.1;0.0
2A;2021-05-07;949;745;0;56335;30958;0;39.4;21.7;0.0
2A;2021-05-08;372;455;0;56707;31413;0;39.7;22.0;0.0
2A;2021-05-09;635;580;0;57342;31993;0;40.1;22.4;0.0
2A;2021-05-10;375;687;0;57717;32680;0;40.4;22.9;0.0
2A;2021-05-11;502;392;0;58219;33072;0;40.7;23.1;0.0
2A;2021-05-12;696;441;0;58915;33513;0;41.2;23.5;0.0
2A;2021-05-13;666;101;0;59581;33614;0;41.7;23.5;0.0
2A;2021-05-14;558;588;0;60139;34202;0;42.1;23.9;0.0
2A;2021-05-15;623;584;0;60762;34786;0;42.5;24.3;0.0
2A;2021-05-16;548;422;0;61310;35208;0;42.9;24.6;0.0
2A;2021-05-17;449;504;0;61759;35712;0;43.2;25.0;0.0
2A;2021-05-18;494;449;0;62253;36161;0;43.6;25.3;0.0
2A;2021-05-19;635;426;0;62888;36587;0;44.0;25.6;0.0
2A;2021-05-20;581;486;0;63469;37073;0;44.4;25.9;0.0
2A;2021-05-21;420;420;0;63889;37493;0;44.7;26.2;0.0
2A;2021-05-22;338;258;0;64227;37751;0;44.9;26.4;0.0
2A;2021-05-23;390;220;0;64617;37971;0;45.2;26.6;0.0
2A;2021-05-24;84;33;0;64701;38004;0;45.3;26.6;0.0
2A;2021-05-25;338;430;0;65039;38434;0;45.5;26.9;0.0
2A;2021-05-26;341;1060;0;65380;39494;0;45.7;27.6;0.0
2A;2021-05-27;361;1021;0;65741;40515;0;46.0;28.4;0.0
2A;2021-05-28;257;833;0;65998;41348;0;46.2;28.9;0.0
2A;2021-05-29;263;817;0;66261;42165;0;46.4;29.5;0.0
2A;2021-05-30;128;446;0;66389;42611;0;46.5;29.8;0.0
2A;2021-05-31;163;397;0;66552;43008;0;46.6;30.1;0.0
2A;2021-06-01;293;634;0;66845;43642;0;46.8;30.5;0.0
2A;2021-06-02;264;867;0;67109;44509;0;47.0;31.1;0.0
2A;2021-06-03;265;800;0;67374;45309;0;47.1;31.7;0.0
2A;2021-06-04;270;959;0;67644;46268;0;47.3;32.4;0.0
2A;2021-06-05;257;1322;0;67901;47590;0;47.5;33.3;0.0
2A;2021-06-06;130;803;0;68031;48393;0;47.6;33.9;0.0
2A;2021-06-07;144;582;0;68175;48975;0;47.7;34.3;0.0
2A;2021-06-08;297;591;0;68472;49566;0;47.9;34.7;0.0
2A;2021-06-09;303;1198;0;68775;50764;0;48.1;35.5;0.0
2A;2021-06-10;314;780;0;69089;51544;0;48.3;36.1;0.0
2A;2021-06-11;251;912;0;69340;52456;0;48.5;36.7;0.0
2A;2021-06-12;187;611;0;69527;53067;0;48.7;37.1;0.0
2A;2021-06-13;133;679;0;69660;53746;0;48.7;37.6;0.0
2A;2021-06-14;217;789;0;69877;54535;0;48.9;38.2;0.0
2A;2021-06-15;213;467;0;70090;55002;0;49.0;38.5;0.0
2A;2021-06-16;184;679;0;70274;55681;0;49.2;39.0;0.0
2A;2021-06-17;202;513;0;70476;56194;0;49.3;39.3;0.0
2A;2021-06-18;229;713;0;70705;56907;0;49.5;39.8;0.0
2A;2021-06-19;186;572;0;70891;57479;0;49.6;40.2;0.0
2A;2021-06-20;119;586;0;71010;58065;0;49.7;40.6;0.0
2A;2021-06-21;163;674;0;71173;58739;0;49.8;41.1;0.0
2A;2021-06-22;218;697;0;71391;59436;0;50.0;41.6;0.0
2A;2021-06-23;181;489;0;71572;59925;0;50.1;41.9;0.0
2A;2021-06-24;130;330;0;71702;60255;0;50.2;42.2;0.0
2A;2021-06-25;164;434;0;71866;60689;0;50.3;42.5;0.0
2A;2021-06-26;160;714;0;72026;61403;0;50.4;43.0;0.0
2A;2021-06-27;149;645;0;72175;62048;0;50.5;43.4;0.0
2A;2021-06-28;164;556;0;72339;62604;0;50.6;43.8;0.0
2A;2021-06-29;191;586;0;72530;63190;0;50.8;44.2;0.0
2A;2021-06-30;196;420;0;72726;63610;0;50.9;44.5;0.0
2A;2021-07-01;219;433;0;72945;64043;0;51.0;44.8;0.0
2A;2021-07-02;194;334;0;73139;64377;0;51.2;45.0;0.0
2A;2021-07-03;172;520;0;73311;64897;0;51.3;45.4;0.0
2A;2021-07-04;129;501;0;73440;65398;0;51.4;45.8;0.0
2A;2021-07-05;165;222;0;73605;65620;0;51.5;45.9;0.0
2A;2021-07-06;214;334;0;73819;65954;0;51.7;46.2;0.0
2A;2021-07-07;344;507;0;74163;66461;0;51.9;46.5;0.0
2A;2021-07-08;471;512;0;74634;66973;0;52.2;46.9;0.0
2A;2021-07-09;313;351;0;74947;67324;0;52.4;47.1;0.0
2A;2021-07-10;260;311;0;75207;67635;0;52.6;47.3;0.0
2A;2021-07-11;61;103;0;75268;67738;0;52.7;47.4;0.0
2A;2021-07-12;279;313;0;75547;68051;0;52.9;47.6;0.0
2A;2021-07-13;949;440;0;76496;68491;0;53.5;47.9;0.0
2A;2021-07-14;1301;227;0;77797;68718;0;54.4;48.1;0.0
2A;2021-07-15;1091;549;0;78888;69267;0;55.2;48.5;0.0
2A;2021-07-16;871;331;0;79759;69598;0;55.8;48.7;0.0
2A;2021-07-17;864;289;0;80623;69887;0;56.4;48.9;0.0
2A;2021-07-18;427;89;0;81050;69976;0;56.7;49.0;0.0
2A;2021-07-19;694;320;0;81744;70296;0;57.2;49.2;0.0
2A;2021-07-20;899;347;0;82643;70643;0;57.8;49.4;0.0
2A;2021-07-21;1027;492;0;83670;71135;0;58.5;49.8;0.0
2A;2021-07-22;942;503;0;84612;71638;0;59.2;50.1;0.0
2A;2021-07-23;1012;315;0;85624;71953;0;59.9;50.3;0.0
2A;2021-07-24;665;214;0;86289;72167;0;60.4;50.5;0.0
2A;2021-07-25;282;56;0;86571;72223;0;60.6;50.5;0.0
2A;2021-07-26;731;310;0;87302;72533;0;61.1;50.8;0.0
2A;2021-07-27;812;360;0;88114;72893;0;61.7;51.0;0.0
2A;2021-07-28;870;404;0;88984;73297;0;62.3;51.3;0.0
2A;2021-07-29;848;418;0;89832;73715;0;62.9;51.6;0.0
2A;2021-07-30;638;423;0;90470;74138;0;63.3;51.9;0.0
2A;2021-07-31;396;254;0;90866;74392;0;63.6;52.1;0.0
2A;2021-08-01;312;54;0;91178;74446;0;63.8;52.1;0.0
2A;2021-08-02;303;344;0;91481;74790;0;64.0;52.3;0.0
2A;2021-08-03;546;656;0;92027;75446;0;64.4;52.8;0.0
2A;2021-08-04;536;896;0;92563;76342;0;64.8;53.4;0.0
2A;2021-08-05;634;969;0;93197;77311;0;65.2;54.1;0.0
2A;2021-08-06;341;595;0;93538;77906;0;65.5;54.5;0.0
2A;2021-08-07;266;712;0;93804;78618;0;65.6;55.0;0.0
2A;2021-08-08;72;171;0;93876;78789;0;65.7;55.1;0.0
2A;2021-08-09;497;825;0;94373;79614;0;66.0;55.7;0.0
2A;2021-08-10;477;819;0;94850;80433;0;66.4;56.3;0.0
2A;2021-08-11;485;753;0;95335;81186;0;66.7;56.8;0.0
2A;2021-08-12;549;1055;0;95884;82241;0;67.1;57.5;0.0
2A;2021-08-13;397;806;0;96281;83047;0;67.4;58.1;0.0
2A;2021-08-14;338;571;0;96619;83618;0;67.6;58.5;0.0
2A;2021-08-15;27;26;0;96646;83644;0;67.6;58.5;0.0
2A;2021-08-16;402;919;0;97048;84563;0;67.9;59.2;0.0
2A;2021-08-17;647;903;0;97695;85466;0;68.4;59.8;0.0
2A;2021-08-18;425;837;0;98120;86303;0;68.7;60.4;0.0
2A;2021-08-19;341;711;0;98461;87014;0;68.9;60.9;0.0
2A;2021-08-20;293;450;0;98754;87464;0;69.1;61.2;0.0
2A;2021-08-21;182;407;0;98936;87871;0;69.2;61.5;0.0
2A;2021-08-22;115;350;0;99051;88221;0;69.3;61.7;0.0
2A;2021-08-23;286;528;0;99337;88749;0;69.5;62.1;0.0
2A;2021-08-24;279;623;0;99616;89372;0;69.7;62.5;0.0
2A;2021-08-25;324;674;0;99940;90046;0;69.9;63.0;0.0
2A;2021-08-26;308;617;0;100248;90663;0;70.1;63.4;0.0
2A;2021-08-27;207;575;0;100455;91238;0;70.3;63.8;0.0
2A;2021-08-28;213;294;0;100668;91532;0;70.4;64.0;0.0
2A;2021-08-29;77;96;0;100745;91628;0;70.5;64.1;0.0
2A;2021-08-30;236;468;27;100981;92096;27;70.7;64.4;0.0
2A;2021-08-31;166;449;29;101147;92545;56;70.8;64.8;0.0
2A;2021-09-01;333;595;56;101480;93140;112;71.0;65.2;0.1
2A;2021-09-02;258;520;81;101738;93660;193;71.2;65.5;0.1
2A;2021-09-03;210;418;130;101948;94078;323;71.3;65.8;0.2
2A;2021-09-04;130;338;32;102078;94416;355;71.4;66.1;0.2
2A;2021-09-05;28;23;17;102106;94439;372;71.4;66.1;0.3
2A;2021-09-06;110;302;80;102216;94741;452;71.5;66.3;0.3
2A;2021-09-07;193;464;147;102409;95205;599;71.7;66.6;0.4
2A;2021-09-08;206;553;122;102615;95758;721;71.8;67.0;0.5
2A;2021-09-09;199;413;114;102814;96171;835;71.9;67.3;0.6
2A;2021-09-10;171;334;122;102985;96505;957;72.1;67.5;0.7
2A;2021-09-11;130;257;50;103115;96762;1007;72.2;67.7;0.7
2A;2021-09-12;36;66;46;103151;96828;1053;72.2;67.8;0.7
2A;2021-09-13;122;179;57;103273;97007;1110;72.3;67.9;0.8
2A;2021-09-14;212;212;176;103485;97219;1286;72.4;68.0;0.9
2A;2021-09-15;182;457;143;103667;97676;1429;72.5;68.3;1.0
2A;2021-09-16;206;323;175;103873;97999;1604;72.7;68.6;1.1
2A;2021-09-17;127;184;84;104000;98183;1688;72.8;68.7;1.2
2A;2021-09-18;87;250;105;104087;98433;1793;72.8;68.9;1.3
2A;2021-09-19;11;47;14;104098;98480;1807;72.8;68.9;1.3
2A;2021-09-20;45;155;101;104143;98635;1908;72.9;69.0;1.3
2A;2021-09-21;81;221;210;104224;98856;2118;72.9;69.2;1.5
2A;2021-09-22;96;377;225;104320;99233;2343;73.0;69.4;1.6
2A;2021-09-23;85;273;159;104405;99506;2502;73.1;69.6;1.8
2A;2021-09-24;66;268;101;104471;99774;2603;73.1;69.8;1.8
2A;2021-09-25;75;141;41;104546;99915;2644;73.2;69.9;1.9
2A;2021-09-26;13;30;2;104559;99945;2646;73.2;69.9;1.9
2A;2021-09-27;43;104;69;104602;100049;2715;73.2;70.0;1.9
2A;2021-09-28;81;134;133;104683;100183;2848;73.3;70.1;2.0
2A;2021-09-29;115;286;132;104798;100469;2980;73.3;70.3;2.1
2A;2021-09-30;77;201;219;104875;100670;3199;73.4;70.4;2.2
2A;2021-10-01;124;125;210;104999;100795;3409;73.5;70.5;2.4
2A;2021-10-02;82;136;68;105081;100931;3477;73.5;70.6;2.4
2A;2021-10-03;17;38;23;105098;100969;3500;73.5;70.7;2.4
2A;2021-10-04;73;79;107;105171;101048;3607;73.6;70.7;2.5
2A;2021-10-05;51;123;118;105222;101171;3725;73.6;70.8;2.6
2A;2021-10-06;68;128;156;105290;101299;3881;73.7;70.9;2.7
2A;2021-10-07;62;119;147;105352;101418;4028;73.7;71.0;2.8
2A;2021-10-08;73;131;127;105425;101549;4155;73.8;71.1;2.9
2A;2021-10-09;75;220;212;105500;101769;4367;73.8;71.2;3.1
2A;2021-10-10;56;71;171;105556;101840;4538;73.9;71.3;3.2
2A;2021-10-11;44;78;110;105600;101918;4648;73.9;71.3;3.3
2A;2021-10-12;46;70;106;105646;101988;4754;73.9;71.4;3.3
2A;2021-10-13;66;127;234;105712;102115;4988;74.0;71.5;3.5
2A;2021-10-14;73;129;206;105785;102244;5194;74.0;71.5;3.6
2A;2021-10-15;85;94;193;105870;102338;5387;74.1;71.6;3.8
2A;2021-10-16;81;153;332;105951;102491;5719;74.1;71.7;4.0
2A;2021-10-17;38;37;109;105989;102528;5828;74.2;71.7;4.1
2A;2021-10-18;59;82;155;106048;102610;5983;74.2;71.8;4.2
2A;2021-10-19;45;75;207;106093;102685;6190;74.2;71.9;4.3
2A;2021-10-20;81;90;271;106174;102775;6461;74.3;71.9;4.5
2A;2021-10-21;62;78;312;106236;102853;6773;74.3;72.0;4.7
2A;2021-10-22;63;107;287;106299;102960;7060;74.4;72.0;4.9
2A;2021-10-23;60;96;203;106359;103056;7263;74.4;72.1;5.1
2A;2021-10-24;32;45;128;106391;103101;7391;74.4;72.1;5.2
2A;2021-10-25;50;55;181;106441;103156;7572;74.5;72.2;5.3
2A;2021-10-26;41;60;216;106482;103216;7788;74.5;72.2;5.4
2A;2021-10-27;71;91;333;106553;103307;8121;74.6;72.3;5.7
2A;2021-10-28;48;74;276;106601;103381;8397;74.6;72.3;5.9
2A;2021-10-29;53;78;352;106654;103459;8749;74.6;72.4;6.1
2A;2021-10-30;51;81;255;106705;103540;9004;74.7;72.5;6.3
2A;2021-10-31;27;61;96;106732;103601;9100;74.7;72.5;6.4
2A;2021-11-01;14;9;6;106746;103610;9106;74.7;72.5;6.4
2A;2021-11-02;50;49;140;106796;103659;9246;74.7;72.5;6.5
2A;2021-11-03;60;69;340;106856;103728;9586;74.8;72.6;6.7
2A;2021-11-04;54;64;358;106910;103792;9944;74.8;72.6;7.0
2A;2021-11-05;56;94;500;106966;103886;10444;74.8;72.7;7.3
2A;2021-11-06;88;74;303;107054;103960;10747;74.9;72.7;7.5
2A;2021-11-07;30;42;124;107084;104002;10871;74.9;72.8;7.6
2A;2021-11-08;38;73;338;107122;104075;11209;75.0;72.8;7.8
2A;2021-11-09;44;62;454;107166;104137;11663;75.0;72.9;8.2
2A;2021-11-10;72;75;513;107238;104212;12176;75.0;72.9;8.5
2A;2021-11-11;20;12;82;107258;104224;12258;75.1;72.9;8.6
2A;2021-11-12;40;70;518;107298;104294;12776;75.1;73.0;8.9
2A;2021-11-13;69;71;711;107367;104365;13487;75.1;73.0;9.4
2A;2021-11-14;35;53;265;107402;104418;13752;75.2;73.1;9.6
2A;2021-11-15;47;74;538;107449;104492;14290;75.2;73.1;10.0
2A;2021-11-16;60;86;517;107509;104578;14807;75.2;73.2;10.4
2A;2021-11-17;58;79;622;107567;104657;15429;75.3;73.2;10.8
2A;2021-11-18;62;48;662;107629;104705;16091;75.3;73.3;11.3
2A;2021-11-19;74;87;720;107703;104792;16811;75.4;73.3;11.8
2A;2021-11-20;100;83;551;107803;104875;17362;75.4;73.4;12.1
2A;2021-11-21;65;39;370;107868;104914;17732;75.5;73.4;12.4
2A;2021-11-22;55;53;648;107923;104967;18380;75.5;73.4;12.9
2A;2021-11-23;53;62;772;107976;105029;19152;75.6;73.5;13.4
2A;2021-11-24;89;74;731;108065;105103;19883;75.6;73.5;13.9
2A;2021-11-25;75;97;1041;108140;105200;20924;75.7;73.6;14.6
2A;2021-11-26;63;83;1478;108203;105283;22402;75.7;73.7;15.7
2A;2021-11-27;124;110;1469;108327;105393;23871;75.8;73.7;16.7
2A;2021-11-28;66;42;1012;108393;105435;24883;75.8;73.8;17.4
2A;2021-11-29;72;70;1135;108465;105505;26018;75.9;73.8;18.2
2A;2021-11-30;73;58;1261;108538;105563;27279;75.9;73.9;19.1
2A;2021-12-01;91;93;1262;108629;105656;28541;76.0;73.9;20.0
2A;2021-12-02;63;64;1586;108692;105720;30127;76.1;74.0;21.1
2A;2021-12-03;88;82;1731;108780;105802;31858;76.1;74.0;22.3
2A;2021-12-04;90;104;1857;108870;105906;33715;76.2;74.1;23.6
2A;2021-12-05;47;56;949;108917;105962;34664;76.2;74.1;24.3
2A;2021-12-06;77;75;1173;108994;106037;35837;76.3;74.2;25.1
2A;2021-12-07;56;84;1294;109050;106121;37131;76.3;74.3;26.0
2A;2021-12-08;52;92;1273;109102;106213;38404;76.3;74.3;26.9
2A;2021-12-09;56;92;1450;109158;106305;39854;76.4;74.4;27.9
2A;2021-12-10;76;113;1506;109234;106418;41360;76.4;74.5;28.9
2A;2021-12-11;66;99;1470;109300;106517;42830;76.5;74.5;30.0
2A;2021-12-12;55;95;797;109355;106612;43627;76.5;74.6;30.5
2A;2021-12-13;44;73;1126;109399;106685;44753;76.6;74.7;31.3
2A;2021-12-14;47;82;1331;109446;106767;46084;76.6;74.7;32.2
2A;2021-12-15;84;118;1321;109530;106885;47405;76.6;74.8;33.2
2A;2021-12-16;70;109;1454;109600;106994;48859;76.7;74.9;34.2
2A;2021-12-17;77;101;1321;109677;107095;50180;76.7;74.9;35.1
2A;2021-12-18;113;131;1271;109790;107226;51451;76.8;75.0;36.0
2A;2021-12-19;82;87;963;109872;107313;52414;76.9;75.1;36.7
2B;2020-12-27;0;0;0;0;0;0;0.0;0.0;0.0
2B;2020-12-28;3;0;0;3;0;0;0.0;0.0;0.0
2B;2020-12-29;0;0;0;3;0;0;0.0;0.0;0.0
2B;2020-12-30;0;0;0;3;0;0;0.0;0.0;0.0
2B;2020-12-31;0;0;0;3;0;0;0.0;0.0;0.0
2B;2021-01-01;0;0;0;3;0;0;0.0;0.0;0.0
2B;2021-01-02;0;0;0;3;0;0;0.0;0.0;0.0
2B;2021-01-03;0;0;0;3;0;0;0.0;0.0;0.0
2B;2021-01-04;1;0;0;4;0;0;0.0;0.0;0.0
2B;2021-01-05;0;0;0;4;0;0;0.0;0.0;0.0
2B;2021-01-06;48;1;0;52;1;0;0.0;0.0;0.0
2B;2021-01-07;203;0;0;255;1;0;0.2;0.0;0.0
2B;2021-01-08;189;5;0;444;6;0;0.3;0.0;0.0
2B;2021-01-09;42;1;0;486;7;0;0.3;0.0;0.0
2B;2021-01-10;5;0;0;491;7;0;0.3;0.0;0.0
2B;2021-01-11;70;0;0;561;7;0;0.3;0.0;0.0
2B;2021-01-12;129;1;0;690;8;0;0.4;0.0;0.0
2B;2021-01-13;95;0;0;785;8;0;0.5;0.0;0.0
2B;2021-01-14;72;0;0;857;8;0;0.5;0.0;0.0
2B;2021-01-15;258;2;0;1115;10;0;0.7;0.0;0.0
2B;2021-01-16;51;0;0;1166;10;0;0.7;0.0;0.0
2B;2021-01-17;10;0;0;1176;10;0;0.7;0.0;0.0
2B;2021-01-18;265;1;0;1441;11;0;0.9;0.0;0.0
2B;2021-01-19;485;2;0;1926;13;0;1.2;0.0;0.0
2B;2021-01-20;427;3;0;2353;16;0;1.5;0.0;0.0
2B;2021-01-21;345;0;0;2698;16;0;1.7;0.0;0.0
2B;2021-01-22;374;1;0;3072;17;0;1.9;0.0;0.0
2B;2021-01-23;63;0;0;3135;17;0;2.0;0.0;0.0
2B;2021-01-24;26;0;0;3161;17;0;2.0;0.0;0.0
2B;2021-01-25;204;2;0;3365;19;0;2.1;0.0;0.0
2B;2021-01-26;367;1;0;3732;20;0;2.3;0.0;0.0
2B;2021-01-27;323;48;0;4055;68;0;2.5;0.0;0.0
2B;2021-01-28;342;138;0;4397;206;0;2.7;0.1;0.0
2B;2021-01-29;292;158;0;4689;364;0;2.9;0.2;0.0
2B;2021-01-30;86;35;0;4775;399;0;3.0;0.2;0.0
2B;2021-01-31;66;0;0;4841;399;0;3.0;0.2;0.0
2B;2021-02-01;223;91;0;5064;490;0;3.2;0.3;0.0
2B;2021-02-02;331;77;0;5395;567;0;3.4;0.4;0.0
2B;2021-02-03;490;88;0;5885;655;0;3.7;0.4;0.0
2B;2021-02-04;433;164;0;6318;819;0;3.9;0.5;0.0
2B;2021-02-05;375;101;0;6693;920;0;4.2;0.6;0.0
2B;2021-02-06;81;18;0;6774;938;0;4.2;0.6;0.0
2B;2021-02-07;59;3;0;6833;941;0;4.3;0.6;0.0
2B;2021-02-08;222;149;0;7055;1090;0;4.4;0.7;0.0
2B;2021-02-09;531;292;0;7586;1382;0;4.7;0.9;0.0
2B;2021-02-10;441;211;0;8027;1593;0;5.0;1.0;0.0
2B;2021-02-11;358;133;0;8385;1726;0;5.2;1.1;0.0
2B;2021-02-12;284;123;0;8669;1849;0;5.4;1.2;0.0
2B;2021-02-13;77;15;0;8746;1864;0;5.5;1.2;0.0
2B;2021-02-14;64;4;0;8810;1868;0;5.5;1.2;0.0
2B;2021-02-15;185;129;0;8995;1997;0;5.6;1.2;0.0
2B;2021-02-16;236;274;0;9231;2271;0;5.8;1.4;0.0
2B;2021-02-17;295;276;0;9526;2547;0;5.9;1.6;0.0
2B;2021-02-18;207;330;0;9733;2877;0;6.1;1.8;0.0
2B;2021-02-19;163;285;0;9896;3162;0;6.2;2.0;0.0
2B;2021-02-20;35;66;0;9931;3228;0;6.2;2.0;0.0
2B;2021-02-21;24;28;0;9955;3256;0;6.2;2.0;0.0
2B;2021-02-22;134;172;0;10089;3428;0;6.3;2.1;0.0
2B;2021-02-23;228;333;0;10317;3761;0;6.4;2.3;0.0
2B;2021-02-24;218;279;0;10535;4040;0;6.6;2.5;0.0
2B;2021-02-25;239;321;0;10774;4361;0;6.7;2.7;0.0
2B;2021-02-26;302;274;0;11076;4635;0;6.9;2.9;0.0
2B;2021-02-27;63;87;0;11139;4722;0;6.9;2.9;0.0
2B;2021-02-28;5;62;0;11144;4784;0;6.9;3.0;0.0
2B;2021-03-01;239;254;0;11383;5038;0;7.1;3.1;0.0
2B;2021-03-02;332;361;0;11715;5399;0;7.3;3.4;0.0
2B;2021-03-03;298;413;0;12013;5812;0;7.5;3.6;0.0
2B;2021-03-04;412;384;0;12425;6196;0;7.7;3.9;0.0
2B;2021-03-05;592;359;0;13017;6555;0;8.1;4.1;0.0
2B;2021-03-06;678;97;0;13695;6652;0;8.5;4.1;0.0
2B;2021-03-07;361;60;0;14056;6712;0;8.8;4.2;0.0
2B;2021-03-08;300;236;0;14356;6948;0;8.9;4.3;0.0
2B;2021-03-09;384;464;0;14740;7412;0;9.2;4.6;0.0
2B;2021-03-10;602;408;0;15342;7820;0;9.6;4.9;0.0
2B;2021-03-11;593;335;0;15935;8155;0;9.9;5.1;0.0
2B;2021-03-12;914;225;0;16849;8380;0;10.5;5.2;0.0
2B;2021-03-13;493;105;0;17342;8485;0;10.8;5.3;0.0
2B;2021-03-14;221;67;0;17563;8552;0;10.9;5.3;0.0
2B;2021-03-15;479;201;0;18042;8753;0;11.2;5.5;0.0
2B;2021-03-16;537;270;0;18579;9023;0;11.6;5.6;0.0
2B;2021-03-17;515;246;0;19094;9269;0;11.9;5.8;0.0
2B;2021-03-18;522;219;0;19616;9488;0;12.2;5.9;0.0
2B;2021-03-19;738;197;0;20354;9685;0;12.7;6.0;0.0
2B;2021-03-20;643;37;0;20997;9722;0;13.1;6.1;0.0
2B;2021-03-21;418;34;0;21415;9756;0;13.3;6.1;0.0
2B;2021-03-22;513;129;0;21928;9885;0;13.7;6.2;0.0
2B;2021-03-23;756;247;0;22684;10132;0;14.1;6.3;0.0
2B;2021-03-24;811;214;0;23495;10346;0;14.6;6.4;0.0
2B;2021-03-25;774;154;0;24269;10500;0;15.1;6.5;0.0
2B;2021-03-26;918;179;0;25187;10679;0;15.7;6.7;0.0
2B;2021-03-27;1040;38;0;26227;10717;0;16.3;6.7;0.0
2B;2021-03-28;800;127;0;27027;10844;0;16.8;6.8;0.0
2B;2021-03-29;705;184;0;27732;11028;0;17.3;6.9;0.0
2B;2021-03-30;896;304;0;28628;11332;0;17.8;7.1;0.0
2B;2021-03-31;919;256;0;29547;11588;0;18.4;7.2;0.0
2B;2021-04-01;971;214;0;30518;11802;0;19.0;7.4;0.0
2B;2021-04-02;933;392;0;31451;12194;0;19.6;7.6;0.0
2B;2021-04-03;1190;171;0;32641;12365;0;20.3;7.7;0.0
2B;2021-04-04;190;88;0;32831;12453;0;20.5;7.8;0.0
2B;2021-04-05;120;113;0;32951;12566;0;20.5;7.8;0.0
2B;2021-04-06;933;361;0;33884;12927;0;21.1;8.1;0.0
2B;2021-04-07;1151;418;0;35035;13345;0;21.8;8.3;0.0
2B;2021-04-08;1056;399;0;36091;13744;0;22.5;8.6;0.0
2B;2021-04-09;1111;542;0;37202;14286;0;23.2;8.9;0.0
2B;2021-04-10;1266;251;0;38468;14537;0;24.0;9.1;0.0
2B;2021-04-11;773;78;0;39241;14615;0;24.5;9.1;0.0
2B;2021-04-12;803;516;0;40044;15131;0;25.0;9.4;0.0
2B;2021-04-13;995;602;0;41039;15733;0;25.6;9.8;0.0
2B;2021-04-14;979;467;0;42018;16200;0;26.2;10.1;0.0
2B;2021-04-15;857;505;0;42875;16705;0;26.7;10.4;0.0
2B;2021-04-16;854;598;0;43729;17303;0;27.3;10.8;0.0
2B;2021-04-17;367;433;0;44096;17736;0;27.5;11.1;0.0
2B;2021-04-18;241;332;0;44337;18068;0;27.6;11.3;0.0
2B;2021-04-19;767;424;0;45104;18492;0;28.1;11.5;0.0
2B;2021-04-20;846;793;0;45950;19285;0;28.6;12.0;0.0
2B;2021-04-21;964;585;0;46914;19870;0;29.2;12.4;0.0
2B;2021-04-22;870;701;0;47784;20571;0;29.8;12.8;0.0
2B;2021-04-23;590;599;0;48374;21170;0;30.1;13.2;0.0
2B;2021-04-24;280;743;0;48654;21913;0;30.3;13.7;0.0
2B;2021-04-25;261;457;0;48915;22370;0;30.5;13.9;0.0
2B;2021-04-26;637;864;0;49552;23234;0;30.9;14.5;0.0
2B;2021-04-27;922;830;0;50474;24064;0;31.5;15.0;0.0
2B;2021-04-28;855;809;0;51329;24873;0;32.0;15.5;0.0
2B;2021-04-29;895;830;0;52224;25703;0;32.5;16.0;0.0
2B;2021-04-30;1071;790;0;53295;26493;0;33.2;16.5;0.0
2B;2021-05-01;419;1070;0;53714;27563;0;33.5;17.2;0.0
2B;2021-05-02;300;231;0;54014;27794;0;33.7;17.3;0.0
2B;2021-05-03;911;462;0;54925;28256;0;34.2;17.6;0.0
2B;2021-05-04;735;1062;0;55660;29318;0;34.7;18.3;0.0
2B;2021-05-05;768;1286;0;56428;30604;0;35.2;19.1;0.0
2B;2021-05-06;1166;848;0;57594;31452;0;35.9;19.6;0.0
2B;2021-05-07;962;939;0;58556;32391;0;36.5;20.2;0.0
2B;2021-05-08;387;811;0;58943;33202;0;36.7;20.7;0.0
2B;2021-05-09;368;647;0;59311;33849;0;37.0;21.1;0.0
2B;2021-05-10;822;776;0;60133;34625;0;37.5;21.6;0.0
2B;2021-05-11;793;1065;0;60926;35690;0;38.0;22.2;0.0
2B;2021-05-12;758;843;0;61684;36533;0;38.4;22.8;0.0
2B;2021-05-13;856;348;0;62540;36881;0;39.0;23.0;0.0
2B;2021-05-14;587;522;0;63127;37403;0;39.3;23.3;0.0
2B;2021-05-15;571;325;0;63698;37728;0;39.7;23.5;0.0
2B;2021-05-16;220;169;0;63918;37897;0;39.8;23.6;0.0
2B;2021-05-17;882;374;0;64800;38271;0;40.4;23.9;0.0
2B;2021-05-18;848;348;0;65648;38619;0;40.9;24.1;0.0
2B;2021-05-19;660;376;0;66308;38995;0;41.3;24.3;0.0
2B;2021-05-20;601;343;0;66909;39338;0;41.7;24.5;0.0
2B;2021-05-21;586;472;0;67495;39810;0;42.1;24.8;0.0
2B;2021-05-22;471;353;0;67966;40163;0;42.4;25.0;0.0
2B;2021-05-23;130;41;0;68096;40204;0;42.4;25.1;0.0
2B;2021-05-24;57;109;0;68153;40313;0;42.5;25.1;0.0
2B;2021-05-25;458;323;0;68611;40636;0;42.8;25.3;0.0
2B;2021-05-26;471;720;0;69082;41356;0;43.1;25.8;0.0
2B;2021-05-27;379;1074;0;69461;42430;0;43.3;26.4;0.0
2B;2021-05-28;430;830;0;69891;43260;0;43.6;27.0;0.0
2B;2021-05-29;250;319;0;70141;43579;0;43.7;27.2;0.0
2B;2021-05-30;35;48;0;70176;43627;0;43.7;27.2;0.0
2B;2021-05-31;337;766;0;70513;44393;0;43.9;27.7;0.0
2B;2021-06-01;362;951;0;70875;45344;0;44.2;28.3;0.0
2B;2021-06-02;317;929;0;71192;46273;0;44.4;28.8;0.0
2B;2021-06-03;452;733;0;71644;47006;0;44.6;29.3;0.0
2B;2021-06-04;312;1135;0;71956;48141;0;44.8;30.0;0.0
2B;2021-06-05;237;450;0;72193;48591;0;45.0;30.3;0.0
2B;2021-06-06;38;131;0;72231;48722;0;45.0;30.4;0.0
2B;2021-06-07;270;885;0;72501;49607;0;45.2;30.9;0.0
2B;2021-06-08;341;1093;0;72842;50700;0;45.4;31.6;0.0
2B;2021-06-09;453;1089;0;73295;51789;0;45.7;32.3;0.0
2B;2021-06-10;336;882;0;73631;52671;0;45.9;32.8;0.0
2B;2021-06-11;386;1155;0;74017;53826;0;46.1;33.5;0.0
2B;2021-06-12;140;500;0;74157;54326;0;46.2;33.9;0.0
2B;2021-06-13;29;71;0;74186;54397;0;46.2;33.9;0.0
2B;2021-06-14;175;1001;0;74361;55398;0;46.3;34.5;0.0
2B;2021-06-15;328;1116;0;74689;56514;0;46.5;35.2;0.0
2B;2021-06-16;346;854;0;75035;57368;0;46.8;35.8;0.0
2B;2021-06-17;345;919;0;75380;58287;0;47.0;36.3;0.0
2B;2021-06-18;298;844;0;75678;59131;0;47.2;36.9;0.0
2B;2021-06-19;137;311;0;75815;59442;0;47.2;37.0;0.0
2B;2021-06-20;45;194;0;75860;59636;0;47.3;37.2;0.0
2B;2021-06-21;246;878;0;76106;60514;0;47.4;37.7;0.0
2B;2021-06-22;273;1016;0;76379;61530;0;47.6;38.3;0.0
2B;2021-06-23;196;791;0;76575;62321;0;47.7;38.8;0.0
2B;2021-06-24;281;682;0;76856;63003;0;47.9;39.3;0.0
2B;2021-06-25;193;923;0;77049;63926;0;48.0;39.8;0.0
2B;2021-06-26;96;477;0;77145;64403;0;48.1;40.1;0.0
2B;2021-06-27;26;195;0;77171;64598;0;48.1;40.3;0.0
2B;2021-06-28;292;857;0;77463;65455;0;48.3;40.8;0.0
2B;2021-06-29;240;860;0;77703;66315;0;48.4;41.3;0.0
2B;2021-06-30;321;825;0;78024;67140;0;48.6;41.8;0.0
2B;2021-07-01;213;442;0;78237;67582;0;48.8;42.1;0.0
2B;2021-07-02;191;474;0;78428;68056;0;48.9;42.4;0.0
2B;2021-07-03;87;362;0;78515;68418;0;48.9;42.6;0.0
2B;2021-07-04;6;11;0;78521;68429;0;48.9;42.6;0.0
2B;2021-07-05;237;589;0;78758;69018;0;49.1;43.0;0.0
2B;2021-07-06;403;606;0;79161;69624;0;49.3;43.4;0.0
2B;2021-07-07;355;764;0;79516;70388;0;49.6;43.9;0.0
2B;2021-07-08;169;289;0;79685;70677;0;49.7;44.0;0.0
2B;2021-07-09;216;330;0;79901;71007;0;49.8;44.3;0.0
2B;2021-07-10;161;153;0;80062;71160;0;49.9;44.3;0.0
2B;2021-07-11;19;26;0;80081;71186;0;49.9;44.4;0.0
2B;2021-07-12;429;640;0;80510;71826;0;50.2;44.8;0.0
2B;2021-07-13;730;852;0;81240;72678;0;50.6;45.3;0.0
2B;2021-07-14;293;75;0;81533;72753;0;50.8;45.3;0.0
2B;2021-07-15;1130;508;0;82663;73261;0;51.5;45.7;0.0
2B;2021-07-16;1003;481;0;83666;73742;0;52.1;46.0;0.0
2B;2021-07-17;646;284;0;84312;74026;0;52.5;46.1;0.0
2B;2021-07-18;152;40;0;84464;74066;0;52.6;46.2;0.0
2B;2021-07-19;780;604;0;85244;74670;0;53.1;46.5;0.0
2B;2021-07-20;1048;529;0;86292;75199;0;53.8;46.9;0.0
2B;2021-07-21;1183;603;0;87475;75802;0;54.5;47.2;0.0
2B;2021-07-22;1102;460;0;88577;76262;0;55.2;47.5;0.0
2B;2021-07-23;1111;387;0;89688;76649;0;55.9;47.8;0.0
2B;2021-07-24;457;254;0;90145;76903;0;56.2;47.9;0.0
2B;2021-07-25;166;40;0;90311;76943;0;56.3;48.0;0.0
2B;2021-07-26;795;507;0;91106;77450;0;56.8;48.3;0.0
2B;2021-07-27;1306;552;0;92412;78002;0;57.6;48.6;0.0
2B;2021-07-28;996;487;0;93408;78489;0;58.2;48.9;0.0
2B;2021-07-29;929;356;0;94337;78845;0;58.8;49.1;0.0
2B;2021-07-30;658;295;0;94995;79140;0;59.2;49.3;0.0
2B;2021-07-31;502;187;0;95497;79327;0;59.5;49.4;0.0
2B;2021-08-01;203;31;0;95700;79358;0;59.6;49.5;0.0
2B;2021-08-02;664;388;0;96364;79746;0;60.1;49.7;0.0
2B;2021-08-03;940;571;0;97304;80317;0;60.6;50.1;0.0
2B;2021-08-04;690;372;0;97994;80689;0;61.1;50.3;0.0
2B;2021-08-05;879;433;0;98873;81122;0;61.6;50.6;0.0
2B;2021-08-06;597;428;0;99470;81550;0;62.0;50.8;0.0
2B;2021-08-07;276;304;0;99746;81854;0;62.2;51.0;0.0
2B;2021-08-08;82;70;0;99828;81924;0;62.2;51.1;0.0
2B;2021-08-09;460;632;0;100288;82556;0;62.5;51.4;0.0
2B;2021-08-10;607;943;0;100895;83499;0;62.9;52.0;0.0
2B;2021-08-11;632;717;0;101527;84216;0;63.3;52.5;0.0
2B;2021-08-12;625;884;0;102152;85100;0;63.7;53.0;0.0
2B;2021-08-13;396;771;0;102548;85871;0;63.9;53.5;0.0
2B;2021-08-14;176;349;0;102724;86220;0;64.0;53.7;0.0
2B;2021-08-15;96;107;0;102820;86327;0;64.1;53.8;0.0
2B;2021-08-16;462;925;0;103282;87252;0;64.4;54.4;0.0
2B;2021-08-17;527;1100;0;103809;88352;0;64.7;55.1;0.0
2B;2021-08-18;442;991;0;104251;89343;0;65.0;55.7;0.0
2B;2021-08-19;371;736;0;104622;90079;0;65.2;56.1;0.0
2B;2021-08-20;292;709;0;104914;90788;0;65.4;56.6;0.0
2B;2021-08-21;135;429;0;105049;91217;0;65.5;56.8;0.0
2B;2021-08-22;71;174;0;105120;91391;0;65.5;57.0;0.0
2B;2021-08-23;336;828;0;105456;92219;0;65.7;57.5;0.0
2B;2021-08-24;419;992;0;105875;93211;0;66.0;58.1;0.0
2B;2021-08-25;299;866;0;106174;94077;0;66.2;58.6;0.0
2B;2021-08-26;372;707;0;106546;94784;0;66.4;59.1;0.0
2B;2021-08-27;233;508;0;106779;95292;0;66.5;59.4;0.0
2B;2021-08-28;148;374;0;106927;95666;0;66.6;59.6;0.0
2B;2021-08-29;51;106;0;106978;95772;0;66.7;59.7;0.0
2B;2021-08-30;329;740;18;107307;96512;18;66.9;60.1;0.0
2B;2021-08-31;340;777;47;107647;97289;65;67.1;60.6;0.0
2B;2021-09-01;380;831;62;108027;98120;127;67.3;61.1;0.1
2B;2021-09-02;287;575;73;108314;98695;200;67.5;61.5;0.1
2B;2021-09-03;217;384;69;108531;99079;269;67.6;61.7;0.2
2B;2021-09-04;123;289;40;108654;99368;309;67.7;61.9;0.2
2B;2021-09-05;14;96;25;108668;99464;334;67.7;62.0;0.2
2B;2021-09-06;173;532;84;108841;99996;418;67.8;62.3;0.3
2B;2021-09-07;231;685;200;109072;100681;618;68.0;62.7;0.4
2B;2021-09-08;193;580;110;109265;101261;728;68.1;63.1;0.5
2B;2021-09-09;174;351;112;109439;101612;840;68.2;63.3;0.5
2B;2021-09-10;197;334;110;109636;101946;950;68.3;63.5;0.6
2B;2021-09-11;129;233;54;109765;102179;1004;68.4;63.7;0.6
2B;2021-09-12;15;86;24;109780;102265;1028;68.4;63.7;0.6
2B;2021-09-13;177;438;61;109957;102703;1089;68.5;64.0;0.7
2B;2021-09-14;266;579;274;110223;103282;1363;68.7;64.4;0.8
2B;2021-09-15;158;550;107;110381;103832;1470;68.8;64.7;0.9
2B;2021-09-16;206;288;327;110587;104120;1797;68.9;64.9;1.1
2B;2021-09-17;122;188;134;110709;104308;1931;69.0;65.0;1.2
2B;2021-09-18;58;165;81;110767;104473;2012;69.0;65.1;1.3
2B;2021-09-19;14;21;23;110781;104494;2035;69.0;65.1;1.3
2B;2021-09-20;104;376;122;110885;104870;2157;69.1;65.4;1.3
2B;2021-09-21;103;368;192;110988;105238;2349;69.2;65.6;1.5
2B;2021-09-22;121;403;184;111109;105641;2533;69.2;65.8;1.6
2B;2021-09-23;99;214;207;111208;105855;2740;69.3;66.0;1.7
2B;2021-09-24;92;198;160;111300;106053;2900;69.4;66.1;1.8
2B;2021-09-25;42;127;67;111342;106180;2967;69.4;66.2;1.8
2B;2021-09-26;3;28;28;111345;106208;2995;69.4;66.2;1.9
2B;2021-09-27;66;224;97;111411;106432;3092;69.4;66.3;1.9
2B;2021-09-28;84;189;106;111495;106621;3198;69.5;66.4;2.0
2B;2021-09-29;120;322;133;111615;106943;3331;69.6;66.6;2.1
2B;2021-09-30;71;118;123;111686;107061;3454;69.6;66.7;2.2
2B;2021-10-01;142;162;114;111828;107223;3568;69.7;66.8;2.2
2B;2021-10-02;56;109;117;111884;107332;3685;69.7;66.9;2.3
2B;2021-10-03;8;15;7;111892;107347;3692;69.7;66.9;2.3
2B;2021-10-04;99;149;115;111991;107496;3807;69.8;67.0;2.4
2B;2021-10-05;89;216;218;112080;107712;4025;69.8;67.1;2.5
2B;2021-10-06;126;261;220;112206;107973;4245;69.9;67.3;2.6
2B;2021-10-07;48;119;256;112254;108092;4501;70.0;67.4;2.8
2B;2021-10-08;85;172;146;112339;108264;4647;70.0;67.5;2.9
2B;2021-10-09;79;116;203;112418;108380;4850;70.1;67.5;3.0
2B;2021-10-10;12;23;7;112430;108403;4857;70.1;67.6;3.0
2B;2021-10-11;61;137;163;112491;108540;5020;70.1;67.6;3.1
2B;2021-10-12;82;161;262;112573;108701;5282;70.2;67.7;3.3
2B;2021-10-13;123;235;283;112696;108936;5565;70.2;67.9;3.5
2B;2021-10-14;97;171;336;112793;109107;5901;70.3;68.0;3.7
2B;2021-10-15;83;125;215;112876;109232;6116;70.3;68.1;3.8
2B;2021-10-16;71;100;183;112947;109332;6299;70.4;68.1;3.9
2B;2021-10-17;15;2;14;112962;109334;6313;70.4;68.1;3.9
2B;2021-10-18;72;95;208;113034;109429;6521;70.4;68.2;4.1
2B;2021-10-19;66;85;268;113100;109514;6789;70.5;68.3;4.2
2B;2021-10-20;83;162;429;113183;109676;7218;70.5;68.4;4.5
2B;2021-10-21;76;113;374;113259;109789;7592;70.6;68.4;4.7
2B;2021-10-22;82;114;269;113341;109903;7861;70.6;68.5;4.9
2B;2021-10-23;53;63;172;113394;109966;8033;70.7;68.5;5.0
2B;2021-10-24;0;14;15;113394;109980;8048;70.7;68.5;5.0
2B;2021-10-25;72;107;253;113466;110087;8301;70.7;68.6;5.2
2B;2021-10-26;37;111;347;113503;110198;8648;70.7;68.7;5.4
2B;2021-10-27;61;126;478;113564;110324;9126;70.8;68.8;5.7
2B;2021-10-28;50;69;259;113614;110393;9385;70.8;68.8;5.8
2B;2021-10-29;56;94;462;113670;110487;9847;70.8;68.9;6.1
2B;2021-10-30;43;78;264;113713;110565;10111;70.9;68.9;6.3
2B;2021-10-31;4;12;23;113717;110577;10134;70.9;68.9;6.3
2B;2021-11-01;12;5;7;113729;110582;10141;70.9;68.9;6.3
2B;2021-11-02;76;109;367;113805;110691;10508;70.9;69.0;6.5
2B;2021-11-03;59;105;509;113864;110796;11017;71.0;69.0;6.9
2B;2021-11-04;57;88;454;113921;110884;11471;71.0;69.1;7.1
2B;2021-11-05;63;84;359;113984;110968;11830;71.0;69.2;7.4
2B;2021-11-06;56;54;302;114040;111022;12132;71.1;69.2;7.6
2B;2021-11-07;4;15;13;114044;111037;12145;71.1;69.2;7.6
2B;2021-11-08;39;78;374;114083;111115;12519;71.1;69.2;7.8
2B;2021-11-09;67;92;517;114150;111207;13036;71.1;69.3;8.1
2B;2021-11-10;68;132;660;114218;111339;13696;71.2;69.4;8.5
2B;2021-11-11;12;10;33;114230;111349;13729;71.2;69.4;8.6
2B;2021-11-12;70;93;724;114300;111442;14453;71.2;69.5;9.0
2B;2021-11-13;21;74;398;114321;111516;14851;71.2;69.5;9.3
2B;2021-11-14;14;10;110;114335;111526;14961;71.3;69.5;9.3
2B;2021-11-15;69;71;524;114404;111597;15485;71.3;69.5;9.7
2B;2021-11-16;55;77;682;114459;111674;16167;71.3;69.6;10.1
2B;2021-11-17;80;95;748;114539;111769;16915;71.4;69.7;10.5
2B;2021-11-18;70;68;890;114609;111837;17805;71.4;69.7;11.1
2B;2021-11-19;96;75;692;114705;111912;18497;71.5;69.7;11.5
2B;2021-11-20;38;58;455;114743;111970;18952;71.5;69.8;11.8
2B;2021-11-21;16;17;171;114759;111987;19123;71.5;69.8;11.9
2B;2021-11-22;88;52;669;114847;112039;19792;71.6;69.8;12.3
2B;2021-11-23;82;65;1010;114929;112104;20802;71.6;69.9;13.0
2B;2021-11-24;91;81;947;115020;112185;21749;71.7;69.9;13.6
2B;2021-11-25;74;67;989;115094;112252;22738;71.7;70.0;14.2
2B;2021-11-26;82;94;1320;115176;112346;24058;71.8;70.0;15.0
2B;2021-11-27;91;70;1087;115267;112416;25145;71.8;70.1;15.7
2B;2021-11-28;15;12;198;115282;112428;25343;71.8;70.1;15.8
2B;2021-11-29;68;51;1377;115350;112479;26720;71.9;70.1;16.7
2B;2021-11-30;114;87;1784;115464;112566;28504;72.0;70.2;17.8
2B;2021-12-01;96;101;1793;115560;112667;30297;72.0;70.2;18.9
2B;2021-12-02;109;54;2228;115669;112721;32525;72.1;70.2;20.3
2B;2021-12-03;107;74;2130;115776;112795;34655;72.2;70.3;21.6
2B;2021-12-04;79;67;1256;115855;112862;35911;72.2;70.3;22.4
2B;2021-12-05;9;22;245;115864;112884;36156;72.2;70.4;22.5
2B;2021-12-06;73;86;1279;115937;112970;37435;72.3;70.4;23.3
2B;2021-12-07;78;77;1759;116015;113047;39194;72.3;70.5;24.4
2B;2021-12-08;84;138;1798;116099;113185;40992;72.4;70.5;25.5
2B;2021-12-09;81;83;1665;116180;113268;42657;72.4;70.6;26.6
2B;2021-12-10;121;105;1808;116301;113373;44465;72.5;70.7;27.7
2B;2021-12-11;71;59;1166;116372;113432;45631;72.5;70.7;28.4
2B;2021-12-12;16;22;341;116388;113454;45972;72.5;70.7;28.7
2B;2021-12-13;81;115;1297;116469;113569;47269;72.6;70.8;29.5
2B;2021-12-14;91;115;1703;116560;113684;48972;72.6;70.8;30.5
2B;2021-12-15;123;144;1714;116683;113828;50686;72.7;70.9;31.6
2B;2021-12-16;101;103;1553;116784;113931;52239;72.8;71.0;32.6
2B;2021-12-17;109;132;1559;116893;114063;53798;72.8;71.1;33.5
2B;2021-12-18;98;76;915;116991;114139;54713;72.9;71.1;34.1
2B;2021-12-19;31;26;246;117022;114165;54959;72.9;71.1;34.3
30;2020-12-27;0;0;0;0;0;0;0.0;0.0;0.0
30;2020-12-28;0;0;0;0;0;0;0.0;0.0;0.0
30;2020-12-29;0;0;0;0;0;0;0.0;0.0;0.0
30;2020-12-30;1;0;0;1;0;0;0.0;0.0;0.0
30;2020-12-31;0;0;0;1;0;0;0.0;0.0;0.0
30;2021-01-01;1;0;0;2;0;0;0.0;0.0;0.0
30;2021-01-02;1;0;0;3;0;0;0.0;0.0;0.0
30;2021-01-03;0;0;0;3;0;0;0.0;0.0;0.0
30;2021-01-04;2;0;0;5;0;0;0.0;0.0;0.0
30;2021-01-05;6;0;0;11;0;0;0.0;0.0;0.0
30;2021-01-06;122;1;0;133;1;0;0.0;0.0;0.0
30;2021-01-07;307;0;0;440;1;0;0.1;0.0;0.0
30;2021-01-08;476;1;0;916;2;0;0.1;0.0;0.0
30;2021-01-09;259;0;0;1175;2;0;0.2;0.0;0.0
30;2021-01-10;4;0;0;1179;2;0;0.2;0.0;0.0
30;2021-01-11;512;1;0;1691;3;0;0.3;0.0;0.0
30;2021-01-12;788;3;0;2479;6;0;0.4;0.0;0.0
30;2021-01-13;633;1;0;3112;7;0;0.5;0.0;0.0
30;2021-01-14;714;5;0;3826;12;0;0.6;0.0;0.0
30;2021-01-15;772;4;0;4598;16;0;0.7;0.0;0.0
30;2021-01-16;305;1;0;4903;17;0;0.8;0.0;0.0
30;2021-01-17;2;0;0;4905;17;0;0.8;0.0;0.0
30;2021-01-18;918;7;0;5823;24;0;0.9;0.0;0.0
30;2021-01-19;1735;8;0;7558;32;0;1.2;0.0;0.0
30;2021-01-20;1353;4;0;8911;36;0;1.4;0.0;0.0
30;2021-01-21;1303;5;0;10214;41;0;1.6;0.0;0.0
30;2021-01-22;1116;5;0;11330;46;0;1.7;0.0;0.0
30;2021-01-23;646;1;0;11976;47;0;1.8;0.0;0.0
30;2021-01-24;3;0;0;11979;47;0;1.8;0.0;0.0
30;2021-01-25;841;4;0;12820;51;0;2.0;0.0;0.0
30;2021-01-26;1091;18;0;13911;69;0;2.1;0.0;0.0
30;2021-01-27;1006;97;0;14917;166;0;2.3;0.0;0.0
30;2021-01-28;839;251;0;15756;417;0;2.4;0.1;0.0
30;2021-01-29;777;372;0;16533;789;0;2.5;0.1;0.0
30;2021-01-30;485;266;0;17018;1055;0;2.6;0.2;0.0
30;2021-01-31;3;7;0;17021;1062;0;2.6;0.2;0.0
30;2021-02-01;815;412;0;17836;1474;0;2.7;0.2;0.0
30;2021-02-02;1809;631;0;19645;2105;0;3.0;0.3;0.0
30;2021-02-03;1263;463;0;20908;2568;0;3.2;0.4;0.0
30;2021-02-04;1067;661;0;21975;3229;0;3.4;0.5;0.0
30;2021-02-05;709;732;0;22684;3961;0;3.5;0.6;0.0
30;2021-02-06;317;236;0;23001;4197;0;3.5;0.6;0.0
30;2021-02-07;5;10;0;23006;4207;0;3.5;0.6;0.0
30;2021-02-08;606;718;0;23612;4925;0;3.6;0.8;0.0
30;2021-02-09;982;1035;0;24594;5960;0;3.8;0.9;0.0
30;2021-02-10;995;1067;0;25589;7027;0;3.9;1.1;0.0
30;2021-02-11;995;1012;0;26584;8039;0;4.1;1.2;0.0
30;2021-02-12;724;932;0;27308;8971;0;4.2;1.4;0.0
30;2021-02-13;425;401;0;27733;9372;0;4.3;1.4;0.0
30;2021-02-14;3;22;0;27736;9394;0;4.3;1.4;0.0
30;2021-02-15;460;656;0;28196;10050;0;4.3;1.5;0.0
30;2021-02-16;456;930;0;28652;10980;0;4.4;1.7;0.0
30;2021-02-17;696;637;0;29348;11617;0;4.5;1.8;0.0
30;2021-02-18;807;654;0;30155;12271;0;4.6;1.9;0.0
30;2021-02-19;624;766;0;30779;13037;0;4.7;2.0;0.0
30;2021-02-20;230;234;0;31009;13271;0;4.8;2.0;0.0
30;2021-02-21;4;6;0;31013;13277;0;4.8;2.0;0.0
30;2021-02-22;508;786;0;31521;14063;0;4.9;2.2;0.0
30;2021-02-23;961;1482;0;32482;15545;0;5.0;2.4;0.0
30;2021-02-24;901;1169;0;33383;16714;0;5.1;2.6;0.0
30;2021-02-25;1198;983;0;34581;17697;0;5.3;2.7;0.0
30;2021-02-26;1325;697;0;35906;18394;0;5.5;2.8;0.0
30;2021-02-27;529;511;0;36435;18905;0;5.6;2.9;0.0
30;2021-02-28;7;9;0;36442;18914;0;5.6;2.9;0.0
30;2021-03-01;1203;860;0;37645;19774;0;5.8;3.0;0.0
30;2021-03-02;1553;949;0;39198;20723;0;6.0;3.2;0.0
30;2021-03-03;2040;858;0;41238;21581;0;6.3;3.3;0.0
30;2021-03-04;2402;953;0;43640;22534;0;6.7;3.5;0.0
30;2021-03-05;2528;701;0;46168;23235;0;7.1;3.6;0.0
30;2021-03-06;2694;367;0;48862;23602;0;7.5;3.6;0.0
30;2021-03-07;1698;45;0;50560;23647;0;7.8;3.6;0.0
30;2021-03-08;1474;795;0;52034;24442;0;8.0;3.8;0.0
30;2021-03-09;2162;929;0;54196;25371;0;8.3;3.9;0.0
30;2021-03-10;2317;720;0;56513;26091;0;8.7;4.0;0.0
30;2021-03-11;2921;747;0;59434;26838;0;9.1;4.1;0.0
30;2021-03-12;3028;481;0;62462;27319;0;9.6;4.2;0.0
30;2021-03-13;2138;298;0;64600;27617;0;9.9;4.3;0.0
30;2021-03-14;102;7;0;64702;27624;0;10.0;4.3;0.0
30;2021-03-15;1547;594;0;66249;28218;0;10.2;4.3;0.0
30;2021-03-16;1287;1053;0;67536;29271;0;10.4;4.5;0.0
30;2021-03-17;1394;675;0;68930;29946;0;10.6;4.6;0.0
30;2021-03-18;1626;712;0;70556;30658;0;10.9;4.7;0.0
30;2021-03-19;2249;550;0;72805;31208;0;11.2;4.8;0.0
30;2021-03-20;1321;137;0;74126;31345;0;11.4;4.8;0.0
30;2021-03-21;95;6;0;74221;31351;0;11.4;4.8;0.0
30;2021-03-22;2346;710;0;76567;32061;0;11.8;4.9;0.0
30;2021-03-23;3426;806;0;79993;32867;0;12.3;5.1;0.0
30;2021-03-24;3474;805;0;83467;33672;0;12.8;5.2;0.0
30;2021-03-25;4322;817;0;87789;34489;0;13.5;5.3;0.0
30;2021-03-26;4353;633;0;92142;35122;0;14.2;5.4;0.0
30;2021-03-27;1869;339;0;94011;35461;0;14.5;5.5;0.0
30;2021-03-28;66;5;0;94077;35466;0;14.5;5.5;0.0
30;2021-03-29;2775;1426;0;96852;36892;0;14.9;5.7;0.0
30;2021-03-30;3847;1640;0;100699;38532;0;15.5;5.9;0.0
30;2021-03-31;3435;1439;0;104134;39971;0;16.0;6.2;0.0
30;2021-04-01;4022;1344;0;108156;41315;0;16.7;6.4;0.0
30;2021-04-02;3536;1136;0;111692;42451;0;17.2;6.5;0.0
30;2021-04-03;992;1054;0;112684;43505;0;17.3;6.7;0.0
30;2021-04-04;44;196;0;112728;43701;0;17.4;6.7;0.0
30;2021-04-05;703;266;0;113431;43967;0;17.5;6.8;0.0
30;2021-04-06;2842;1482;0;116273;45449;0;17.9;7.0;0.0
30;2021-04-07;2611;1495;0;118884;46944;0;18.3;7.2;0.0
30;2021-04-08;3827;1451;0;122711;48395;0;18.9;7.5;0.0
30;2021-04-09;4728;1445;0;127439;49840;0;19.6;7.7;0.0
30;2021-04-10;2253;1047;0;129692;50887;0;20.0;7.8;0.0
30;2021-04-11;799;61;0;130491;50948;0;20.1;7.8;0.0
30;2021-04-12;2972;1430;0;133463;52378;0;20.5;8.1;0.0
30;2021-04-13;3815;1827;0;137278;54205;0;21.1;8.3;0.0
30;2021-04-14;3365;1520;0;140643;55725;0;21.7;8.6;0.0
30;2021-04-15;3766;1523;0;144409;57248;0;22.2;8.8;0.0
30;2021-04-16;3618;1540;0;148027;58788;0;22.8;9.1;0.0
30;2021-04-17;1477;867;0;149504;59655;0;23.0;9.2;0.0
30;2021-04-18;788;90;0;150292;59745;0;23.1;9.2;0.0
30;2021-04-19;2424;2245;0;152716;61990;0;23.5;9.5;0.0
30;2021-04-20;2778;2749;0;155494;64739;0;23.9;10.0;0.0
30;2021-04-21;2607;2455;0;158101;67194;0;24.3;10.3;0.0
30;2021-04-22;3563;2353;0;161664;69547;0;24.9;10.7;0.0
30;2021-04-23;3556;2338;0;165220;71885;0;25.4;11.1;0.0
30;2021-04-24;1378;1137;0;166598;73022;0;25.6;11.2;0.0
30;2021-04-25;666;107;0;167264;73129;0;25.8;11.3;0.0
30;2021-04-26;2029;2319;0;169293;75448;0;26.1;11.6;0.0
30;2021-04-27;3006;2608;0;172299;78056;0;26.5;12.0;0.0
30;2021-04-28;2978;2450;0;175277;80506;0;27.0;12.4;0.0
30;2021-04-29;3744;2358;0;179021;82864;0;27.6;12.8;0.0
30;2021-04-30;3560;2082;0;182581;84946;0;28.1;13.1;0.0
30;2021-05-01;1675;550;0;184256;85496;0;28.4;13.2;0.0
30;2021-05-02;641;242;0;184897;85738;0;28.5;13.2;0.0
30;2021-05-03;3831;2402;0;188728;88140;0;29.1;13.6;0.0
30;2021-05-04;4108;3351;0;192836;91491;0;29.7;14.1;0.0
30;2021-05-05;4115;2991;0;196951;94482;0;30.3;14.5;0.0
30;2021-05-06;4354;3221;0;201305;97703;0;31.0;15.0;0.0
30;2021-05-07;4184;3088;0;205489;100791;0;31.6;15.5;0.0
30;2021-05-08;1659;706;0;207148;101497;0;31.9;15.6;0.0
30;2021-05-09;372;522;0;207520;102019;0;31.9;15.7;0.0
30;2021-05-10;3092;2996;0;210612;105015;0;32.4;16.2;0.0
30;2021-05-11;5478;3624;0;216090;108639;0;33.3;16.7;0.0
30;2021-05-12;5317;3083;0;221407;111722;0;34.1;17.2;0.0
30;2021-05-13;3425;983;0;224832;112705;0;34.6;17.4;0.0
30;2021-05-14;5042;2304;0;229874;115009;0;35.4;17.7;0.0
30;2021-05-15;3504;1169;0;233378;116178;0;35.9;17.9;0.0
30;2021-05-16;738;323;0;234116;116501;0;36.0;17.9;0.0
30;2021-05-17;3999;2919;0;238115;119420;0;36.7;18.4;0.0
30;2021-05-18;4871;2919;0;242986;122339;0;37.4;18.8;0.0
30;2021-05-19;5078;2475;0;248064;124814;0;38.2;19.2;0.0
30;2021-05-20;5207;2542;0;253271;127356;0;39.0;19.6;0.0
30;2021-05-21;5076;2455;0;258347;129811;0;39.8;20.0;0.0
30;2021-05-22;3113;1231;0;261460;131042;0;40.3;20.2;0.0
30;2021-05-23;440;303;0;261900;131345;0;40.3;20.2;0.0
30;2021-05-24;1046;749;0;262946;132094;0;40.5;20.3;0.0
30;2021-05-25;3238;3140;0;266184;135234;0;41.0;20.8;0.0
30;2021-05-26;3368;2609;0;269552;137843;0;41.5;21.2;0.0
30;2021-05-27;4247;2733;0;273799;140576;0;42.2;21.6;0.0
30;2021-05-28;3682;3321;0;277481;143897;0;42.7;22.2;0.0
30;2021-05-29;1832;1837;0;279313;145734;0;43.0;22.4;0.0
30;2021-05-30;379;541;0;279692;146275;0;43.1;22.5;0.0
30;2021-05-31;3052;2460;0;282744;148735;0;43.5;22.9;0.0
30;2021-06-01;4099;2966;0;286843;151701;0;44.2;23.4;0.0
30;2021-06-02;3725;2714;0;290568;154415;0;44.7;23.8;0.0
30;2021-06-03;4535;3416;0;295103;157831;0;45.4;24.3;0.0
30;2021-06-04;4150;3503;0;299253;161334;0;46.1;24.8;0.0
30;2021-06-05;2038;1432;0;301291;162766;0;46.4;25.1;0.0
30;2021-06-06;769;281;0;302060;163047;0;46.5;25.1;0.0
30;2021-06-07;4705;2733;0;306765;165780;0;47.2;25.5;0.0
30;2021-06-08;4781;3502;0;311546;169282;0;48.0;26.1;0.0
30;2021-06-09;4223;3201;0;315769;172483;0;48.6;26.6;0.0
30;2021-06-10;4651;3447;0;320420;175930;0;49.3;27.1;0.0
30;2021-06-11;4628;4037;0;325048;179967;0;50.0;27.7;0.0
30;2021-06-12;2539;1744;0;327587;181711;0;50.4;28.0;0.0
30;2021-06-13;582;375;0;328169;182086;0;50.5;28.0;0.0
30;2021-06-14;2475;4791;0;330644;186877;0;50.9;28.8;0.0
30;2021-06-15;3271;5444;0;333915;192321;0;51.4;29.6;0.0
30;2021-06-16;3148;4794;0;337063;197115;0;51.9;30.3;0.0
30;2021-06-17;3842;4403;0;340905;201518;0;52.5;31.0;0.0
30;2021-06-18;3710;4834;0;344615;206352;0;53.1;31.8;0.0
30;2021-06-19;1428;2059;0;346043;208411;0;53.3;32.1;0.0
30;2021-06-20;409;554;0;346452;208965;0;53.3;32.2;0.0
30;2021-06-21;2237;5007;0;348689;213972;0;53.7;32.9;0.0
30;2021-06-22;2311;5920;0;351000;219892;0;54.0;33.9;0.0
30;2021-06-23;2487;5473;0;353487;225365;0;54.4;34.7;0.0
30;2021-06-24;2293;4921;0;355780;230286;0;54.8;35.5;0.0
30;2021-06-25;2539;5809;0;358319;236095;0;55.2;36.3;0.0
30;2021-06-26;904;2938;0;359223;239033;0;55.3;36.8;0.0
30;2021-06-27;241;628;0;359464;239661;0;55.3;36.9;0.0
30;2021-06-28;1592;6206;0;361056;245867;0;55.6;37.9;0.0
30;2021-06-29;1833;6210;0;362889;252077;0;55.9;38.8;0.0
30;2021-06-30;2002;5591;0;364891;257668;0;56.2;39.7;0.0
30;2021-07-01;3022;4917;0;367913;262585;0;56.6;40.4;0.0
30;2021-07-02;2850;4771;0;370763;267356;0;57.1;41.2;0.0
30;2021-07-03;1140;3123;0;371903;270479;0;57.3;41.6;0.0
30;2021-07-04;154;512;0;372057;270991;0;57.3;41.7;0.0
30;2021-07-05;1959;4154;0;374016;275145;0;57.6;42.4;0.0
30;2021-07-06;2530;5337;0;376546;280482;0;58.0;43.2;0.0
30;2021-07-07;2395;4413;0;378941;284895;0;58.3;43.9;0.0
30;2021-07-08;1993;3730;0;380934;288625;0;58.6;44.4;0.0
30;2021-07-09;2285;5441;0;383219;294066;0;59.0;45.3;0.0
30;2021-07-10;1346;2146;0;384565;296212;0;59.2;45.6;0.0
30;2021-07-11;101;502;0;384666;296714;0;59.2;45.7;0.0
30;2021-07-12;2270;5182;0;386936;301896;0;59.6;46.5;0.0
30;2021-07-13;3065;6139;0;390001;308035;0;60.0;47.4;0.0
30;2021-07-14;618;672;0;390619;308707;0;60.1;47.5;0.0
30;2021-07-15;3800;5655;0;394419;314362;0;60.7;48.4;0.0
30;2021-07-16;4351;5745;0;398770;320107;0;61.4;49.3;0.0
30;2021-07-17;1678;2490;0;400448;322597;0;61.6;49.7;0.0
30;2021-07-18;236;651;0;400684;323248;0;61.7;49.8;0.0
30;2021-07-19;3199;6098;0;403883;329346;0;62.2;50.7;0.0
30;2021-07-20;4277;6300;0;408160;335646;0;62.8;51.7;0.0
30;2021-07-21;3867;5341;0;412027;340987;0;63.4;52.5;0.0
30;2021-07-22;4595;5573;0;416622;346560;0;64.1;53.4;0.0
30;2021-07-23;4794;5847;0;421416;352407;0;64.9;54.3;0.0
30;2021-07-24;2132;3194;0;423548;355601;0;65.2;54.7;0.0
30;2021-07-25;331;383;0;423879;355984;0;65.3;54.8;0.0
30;2021-07-26;4141;4002;0;428020;359986;0;65.9;55.4;0.0
30;2021-07-27;4720;4513;0;432740;364499;0;66.6;56.1;0.0
30;2021-07-28;4745;3838;0;437485;368337;0;67.4;56.7;0.0
30;2021-07-29;5866;3925;0;443351;372262;0;68.3;57.3;0.0
30;2021-07-30;5326;4163;0;448677;376425;0;69.1;58.0;0.0
30;2021-07-31;2535;1825;0;451212;378250;0;69.5;58.2;0.0
30;2021-08-01;758;319;0;451970;378569;0;69.6;58.3;0.0
30;2021-08-02;3763;3740;0;455733;382309;0;70.2;58.9;0.0
30;2021-08-03;4778;3552;0;460511;385861;0;70.9;59.4;0.0
30;2021-08-04;5202;2811;0;465713;388672;0;71.7;59.8;0.0
30;2021-08-05;4527;3435;0;470240;392107;0;72.4;60.4;0.0
30;2021-08-06;4128;3644;0;474368;395751;0;73.0;60.9;0.0
30;2021-08-07;1797;1856;0;476165;397607;0;73.3;61.2;0.0
30;2021-08-08;569;296;0;476734;397903;0;73.4;61.3;0.0
30;2021-08-09;3296;3438;0;480030;401341;0;73.9;61.8;0.0
30;2021-08-10;3899;3924;0;483929;405265;0;74.5;62.4;0.0
30;2021-08-11;3293;3265;0;487222;408530;0;75.0;62.9;0.0
30;2021-08-12;3562;3739;0;490784;412269;0;75.6;63.5;0.0
30;2021-08-13;3068;3059;0;493852;415328;0;76.0;63.9;0.0
30;2021-08-14;1028;1868;0;494880;417196;0;76.2;64.2;0.0
30;2021-08-15;251;159;0;495131;417355;0;76.2;64.3;0.0
30;2021-08-16;2078;4459;0;497209;421814;0;76.5;64.9;0.0
30;2021-08-17;2562;3913;0;499771;425727;0;76.9;65.5;0.0
30;2021-08-18;2620;3661;0;502391;429388;0;77.3;66.1;0.0
30;2021-08-19;2632;4064;0;505023;433452;0;77.7;66.7;0.0
30;2021-08-20;2406;4330;0;507429;437782;0;78.1;67.4;0.0
30;2021-08-21;918;2654;0;508347;440436;0;78.3;67.8;0.0
30;2021-08-22;204;515;0;508551;440951;0;78.3;67.9;0.0
30;2021-08-23;1571;4217;0;510122;445168;0;78.5;68.5;0.0
30;2021-08-24;1864;4404;0;511986;449572;0;78.8;69.2;0.0
30;2021-08-25;1614;4361;0;513600;453933;0;79.1;69.9;0.0
30;2021-08-26;1789;4262;0;515389;458195;0;79.3;70.5;0.0
30;2021-08-27;1655;4324;0;517044;462519;0;79.6;71.2;0.0
30;2021-08-28;665;2339;0;517709;464858;0;79.7;71.6;0.0
30;2021-08-29;182;607;0;517891;465465;0;79.7;71.7;0.0
30;2021-08-30;1334;4221;58;519225;469686;58;79.9;72.3;0.0
30;2021-08-31;1327;4117;121;520552;473803;179;80.1;72.9;0.0
30;2021-09-01;1343;3477;178;521895;477280;357;80.3;73.5;0.1
30;2021-09-02;1334;3236;276;523229;480516;633;80.6;74.0;0.1
30;2021-09-03;1465;3542;421;524694;484058;1054;80.8;74.5;0.2
30;2021-09-04;656;1802;154;525350;485860;1208;80.9;74.8;0.2
30;2021-09-05;131;468;41;525481;486328;1249;80.9;74.9;0.2
30;2021-09-06;830;2291;457;526311;488619;1706;81.0;75.2;0.3
30;2021-09-07;813;2162;532;527124;490781;2238;81.2;75.6;0.3
30;2021-09-08;936;2543;318;528060;493324;2556;81.3;75.9;0.4
30;2021-09-09;917;2130;371;528977;495454;2927;81.4;76.3;0.5
30;2021-09-10;984;2535;475;529961;497989;3402;81.6;76.7;0.5
30;2021-09-11;538;1497;136;530499;499486;3538;81.7;76.9;0.5
30;2021-09-12;94;240;35;530593;499726;3573;81.7;76.9;0.6
30;2021-09-13;780;1568;460;531373;501294;4033;81.8;77.2;0.6
30;2021-09-14;685;1512;605;532058;502806;4638;81.9;77.4;0.7
30;2021-09-15;819;1860;494;532877;504666;5132;82.0;77.7;0.8
30;2021-09-16;761;1436;750;533638;506102;5882;82.2;77.9;0.9
30;2021-09-17;807;1858;764;534445;507960;6646;82.3;78.2;1.0
30;2021-09-18;410;1005;155;534855;508965;6801;82.3;78.4;1.0
30;2021-09-19;66;156;27;534921;509121;6828;82.4;78.4;1.1
30;2021-09-20;430;1170;588;535351;510291;7416;82.4;78.6;1.1
30;2021-09-21;452;1161;921;535803;511452;8337;82.5;78.7;1.3
30;2021-09-22;501;1407;536;536304;512859;8873;82.6;79.0;1.4
30;2021-09-23;640;1128;806;536944;513987;9679;82.7;79.1;1.5
30;2021-09-24;546;1561;613;537490;515548;10292;82.7;79.4;1.6
30;2021-09-25;339;870;119;537829;516418;10411;82.8;79.5;1.6
30;2021-09-26;54;135;24;537883;516553;10435;82.8;79.5;1.6
30;2021-09-27;395;887;617;538278;517440;11052;82.9;79.7;1.7
30;2021-09-28;530;936;830;538808;518376;11882;82.9;79.8;1.8
30;2021-09-29;466;1106;497;539274;519482;12379;83.0;80.0;1.9
30;2021-09-30;411;916;676;539685;520398;13055;83.1;80.1;2.0
30;2021-10-01;682;1001;836;540367;521399;13891;83.2;80.3;2.1
30;2021-10-02;300;541;228;540667;521940;14119;83.2;80.4;2.2
30;2021-10-03;21;52;4;540688;521992;14123;83.2;80.4;2.2
30;2021-10-04;436;796;846;541124;522788;14969;83.3;80.5;2.3
30;2021-10-05;373;723;907;541497;523511;15876;83.4;80.6;2.4
30;2021-10-06;493;865;940;541990;524376;16816;83.4;80.7;2.6
30;2021-10-07;401;853;847;542391;525229;17663;83.5;80.9;2.7
30;2021-10-08;498;1066;974;542889;526295;18637;83.6;81.0;2.9
30;2021-10-09;314;549;309;543203;526844;18946;83.6;81.1;2.9
30;2021-10-10;11;28;12;543214;526872;18958;83.6;81.1;2.9
30;2021-10-11;288;560;797;543502;527432;19755;83.7;81.2;3.0
30;2021-10-12;386;686;1058;543888;528118;20813;83.7;81.3;3.2
30;2021-10-13;354;678;782;544242;528796;21595;83.8;81.4;3.3
30;2021-10-14;383;674;1090;544625;529470;22685;83.8;81.5;3.5
30;2021-10-15;457;702;1042;545082;530172;23727;83.9;81.6;3.7
30;2021-10-16;216;417;285;545298;530589;24012;83.9;81.7;3.7
30;2021-10-17;12;31;6;545310;530620;24018;84.0;81.7;3.7
30;2021-10-18;305;496;828;545615;531116;24846;84.0;81.8;3.8
30;2021-10-19;307;553;1363;545922;531669;26209;84.0;81.9;4.0
30;2021-10-20;312;446;1079;546234;532115;27288;84.1;81.9;4.2
30;2021-10-21;340;532;1666;546574;532647;28954;84.1;82.0;4.5
30;2021-10-22;368;631;1222;546942;533278;30176;84.2;82.1;4.6
30;2021-10-23;158;294;674;547100;533572;30850;84.2;82.1;4.7
30;2021-10-24;10;21;3;547110;533593;30853;84.2;82.1;4.7
30;2021-10-25;289;404;920;547399;533997;31773;84.3;82.2;4.9
30;2021-10-26;288;355;1299;547687;534352;33072;84.3;82.3;5.1
30;2021-10-27;338;425;1118;548025;534777;34190;84.4;82.3;5.3
30;2021-10-28;308;328;1371;548333;535105;35561;84.4;82.4;5.5
30;2021-10-29;379;482;1462;548712;535587;37023;84.5;82.5;5.7
30;2021-10-30;144;285;511;548856;535872;37534;84.5;82.5;5.8
30;2021-10-31;7;17;6;548863;535889;37540;84.5;82.5;5.8
30;2021-11-01;46;38;21;548909;535927;37561;84.5;82.5;5.8
30;2021-11-02;230;403;1018;549139;536330;38579;84.5;82.6;5.9
30;2021-11-03;366;447;1755;549505;536777;40334;84.6;82.6;6.2
30;2021-11-04;249;341;1514;549754;537118;41848;84.6;82.7;6.4
30;2021-11-05;357;524;1964;550111;537642;43812;84.7;82.8;6.7
30;2021-11-06;168;236;435;550279;537878;44247;84.7;82.8;6.8
30;2021-11-07;16;37;30;550295;537915;44277;84.7;82.8;6.8
30;2021-11-08;176;310;1569;550471;538225;45846;84.7;82.9;7.1
30;2021-11-09;248;394;2209;550719;538619;48055;84.8;82.9;7.4
30;2021-11-10;324;423;2433;551043;539042;50488;84.8;83.0;7.8
30;2021-11-11;30;51;119;551073;539093;50607;84.8;83.0;7.8
30;2021-11-12;267;357;2086;551340;539450;52693;84.9;83.0;8.1
30;2021-11-13;123;200;660;551463;539650;53353;84.9;83.1;8.2
30;2021-11-14;14;28;31;551477;539678;53384;84.9;83.1;8.2
30;2021-11-15;187;332;1992;551664;540010;55376;84.9;83.1;8.5
30;2021-11-16;227;289;2774;551891;540299;58150;85.0;83.2;9.0
30;2021-11-17;300;400;2985;552191;540699;61135;85.0;83.2;9.4
30;2021-11-18;236;368;2668;552427;541067;63803;85.0;83.3;9.8
30;2021-11-19;424;458;3422;552851;541525;67225;85.1;83.4;10.3
30;2021-11-20;136;236;730;552987;541761;67955;85.1;83.4;10.5
30;2021-11-21;6;17;29;552993;541778;67984;85.1;83.4;10.5
30;2021-11-22;223;274;2456;553216;542052;70440;85.2;83.4;10.8
30;2021-11-23;289;245;3010;553505;542297;73450;85.2;83.5;11.3
30;2021-11-24;306;406;3037;553811;542703;76487;85.3;83.5;11.8
30;2021-11-25;327;344;3524;554138;543047;80011;85.3;83.6;12.3
30;2021-11-26;454;481;5434;554592;543528;85445;85.4;83.7;13.2
30;2021-11-27;168;237;1705;554760;543765;87150;85.4;83.7;13.4
30;2021-11-28;28;49;323;554788;543814;87473;85.4;83.7;13.5
30;2021-11-29;199;247;4040;554987;544061;91513;85.4;83.8;14.1
30;2021-11-30;277;327;5724;555264;544388;97237;85.5;83.8;15.0
30;2021-12-01;267;384;5436;555531;544772;102673;85.5;83.9;15.8
30;2021-12-02;265;245;5871;555796;545017;108544;85.6;83.9;16.7
30;2021-12-03;292;350;7312;556088;545367;115856;85.6;84.0;17.8
30;2021-12-04;147;186;2527;556235;545553;118383;85.6;84.0;18.2
30;2021-12-05;28;62;423;556263;545615;118806;85.6;84.0;18.3
30;2021-12-06;218;335;6425;556481;545950;125231;85.7;84.0;19.3
30;2021-12-07;343;352;9228;556824;546302;134459;85.7;84.1;20.7
30;2021-12-08;278;356;8178;557102;546658;142637;85.8;84.2;22.0
30;2021-12-09;326;286;8761;557428;546944;151398;85.8;84.2;23.3
30;2021-12-10;361;398;9650;557789;547342;161048;85.9;84.3;24.8
30;2021-12-11;189;200;3978;557978;547542;165026;85.9;84.3;25.4
30;2021-12-12;16;53;464;557994;547595;165490;85.9;84.3;25.5
30;2021-12-13;257;304;7583;558251;547899;173073;85.9;84.3;26.6
30;2021-12-14;354;371;10851;558605;548270;183924;86.0;84.4;28.3
30;2021-12-15;319;381;8782;558924;548651;192706;86.0;84.5;29.7
30;2021-12-16;365;401;9046;559289;549052;201752;86.1;84.5;31.1
30;2021-12-17;435;588;10287;559724;549640;212039;86.2;84.6;32.6
30;2021-12-18;222;232;3927;559946;549872;215966;86.2;84.7;33.2
30;2021-12-19;54;51;800;560000;549923;216766;86.2;84.7;33.4
31;2020-12-27;1;0;0;1;0;0;0.0;0.0;0.0
31;2020-12-28;1;0;0;2;0;0;0.0;0.0;0.0
31;2020-12-29;0;0;0;2;0;0;0.0;0.0;0.0
31;2020-12-30;0;0;0;2;0;0;0.0;0.0;0.0
31;2020-12-31;1;0;0;3;0;0;0.0;0.0;0.0
31;2021-01-01;4;0;0;7;0;0;0.0;0.0;0.0
31;2021-01-02;0;0;0;7;0;0;0.0;0.0;0.0
31;2021-01-03;2;0;0;9;0;0;0.0;0.0;0.0
31;2021-01-04;3;1;0;12;1;0;0.0;0.0;0.0
31;2021-01-05;55;0;0;67;1;0;0.0;0.0;0.0
31;2021-01-06;203;1;0;270;2;0;0.0;0.0;0.0
31;2021-01-07;321;1;0;591;3;0;0.0;0.0;0.0
31;2021-01-08;556;0;0;1147;3;0;0.1;0.0;0.0
31;2021-01-09;288;0;0;1435;3;0;0.1;0.0;0.0
31;2021-01-10;278;0;0;1713;3;0;0.1;0.0;0.0
31;2021-01-11;972;4;0;2685;7;0;0.2;0.0;0.0
31;2021-01-12;1157;1;0;3842;8;0;0.3;0.0;0.0
31;2021-01-13;1141;5;0;4983;13;0;0.4;0.0;0.0
31;2021-01-14;1249;19;0;6232;32;0;0.5;0.0;0.0
31;2021-01-15;1061;5;0;7293;37;0;0.6;0.0;0.0
31;2021-01-16;273;2;0;7566;39;0;0.6;0.0;0.0
31;2021-01-17;200;0;0;7766;39;0;0.6;0.0;0.0
31;2021-01-18;1693;7;0;9459;46;0;0.8;0.0;0.0
31;2021-01-19;2916;12;0;12375;58;0;1.0;0.0;0.0
31;2021-01-20;3596;12;0;15971;70;0;1.3;0.0;0.0
31;2021-01-21;3031;10;0;19002;80;0;1.6;0.0;0.0
31;2021-01-22;2301;6;0;21303;86;0;1.8;0.0;0.0
31;2021-01-23;723;2;0;22026;88;0;1.8;0.0;0.0
31;2021-01-24;223;1;0;22249;89;0;1.8;0.0;0.0
31;2021-01-25;1762;13;0;24011;102;0;2.0;0.0;0.0
31;2021-01-26;1995;59;0;26006;161;0;2.2;0.0;0.0
31;2021-01-27;1699;153;0;27705;314;0;2.3;0.0;0.0
31;2021-01-28;1511;288;0;29216;602;0;2.4;0.0;0.0
31;2021-01-29;1399;373;0;30615;975;0;2.5;0.1;0.0
31;2021-01-30;457;180;0;31072;1155;0;2.6;0.1;0.0
31;2021-01-31;77;200;0;31149;1355;0;2.6;0.1;0.0
31;2021-02-01;1249;740;0;32398;2095;0;2.7;0.2;0.0
31;2021-02-02;2997;800;0;35395;2895;0;2.9;0.2;0.0
31;2021-02-03;1875;718;0;37270;3613;0;3.1;0.3;0.0
31;2021-02-04;1882;931;0;39152;4544;0;3.2;0.4;0.0
31;2021-02-05;1393;636;0;40545;5180;0;3.4;0.4;0.0
31;2021-02-06;437;71;0;40982;5251;0;3.4;0.4;0.0
31;2021-02-07;56;59;0;41038;5310;0;3.4;0.4;0.0
31;2021-02-08;1105;680;0;42143;5990;0;3.5;0.5;0.0
31;2021-02-09;1641;1547;0;43784;7537;0;3.6;0.6;0.0
31;2021-02-10;1915;2391;0;45699;9928;0;3.8;0.8;0.0
31;2021-02-11;1795;1792;0;47494;11720;0;3.9;1.0;0.0
31;2021-02-12;1635;863;0;49129;12583;0;4.1;1.0;0.0
31;2021-02-13;513;247;0;49642;12830;0;4.1;1.1;0.0
31;2021-02-14;58;218;0;49700;13048;0;4.1;1.1;0.0
31;2021-02-15;435;1409;0;50135;14457;0;4.2;1.2;0.0
31;2021-02-16;502;1619;0;50637;16076;0;4.2;1.3;0.0
31;2021-02-17;470;1681;0;51107;17757;0;4.2;1.5;0.0
31;2021-02-18;525;1835;0;51632;19592;0;4.3;1.6;0.0
31;2021-02-19;463;1611;0;52095;21203;0;4.3;1.8;0.0
31;2021-02-20;96;537;0;52191;21740;0;4.3;1.8;0.0
31;2021-02-21;73;168;0;52264;21908;0;4.3;1.8;0.0
31;2021-02-22;441;1795;0;52705;23703;0;4.4;2.0;0.0
31;2021-02-23;877;2886;0;53582;26589;0;4.4;2.2;0.0
31;2021-02-24;626;2072;0;54208;28661;0;4.5;2.4;0.0
31;2021-02-25;1436;1889;0;55644;30550;0;4.6;2.5;0.0
31;2021-02-26;1721;1308;0;57365;31858;0;4.8;2.6;0.0
31;2021-02-27;654;416;0;58019;32274;0;4.8;2.7;0.0
31;2021-02-28;92;59;0;58111;32333;0;4.8;2.7;0.0
31;2021-03-01;894;1141;0;59005;33474;0;4.9;2.8;0.0
31;2021-03-02;1283;1657;0;60288;35131;0;5.0;2.9;0.0
31;2021-03-03;1382;1764;0;61670;36895;0;5.1;3.1;0.0
31;2021-03-04;2447;1477;0;64117;38372;0;5.3;3.2;0.0
31;2021-03-05;3057;1576;0;67174;39948;0;5.6;3.3;0.0
31;2021-03-06;2874;421;0;70048;40369;0;5.8;3.4;0.0
31;2021-03-07;5208;114;0;75256;40483;0;6.2;3.4;0.0
31;2021-03-08;1671;1087;0;76927;41570;0;6.4;3.5;0.0
31;2021-03-09;2776;1207;0;79703;42777;0;6.6;3.6;0.0
31;2021-03-10;2592;1083;0;82295;43860;0;6.8;3.6;0.0
31;2021-03-11;4415;1186;0;86710;45046;0;7.2;3.7;0.0
31;2021-03-12;5307;1216;0;92017;46262;0;7.6;3.8;0.0
31;2021-03-13;2860;524;0;94877;46786;0;7.9;3.9;0.0
31;2021-03-14;261;53;0;95138;46839;0;7.9;3.9;0.0
31;2021-03-15;2587;432;0;97725;47271;0;8.1;3.9;0.0
31;2021-03-16;1775;807;0;99500;48078;0;8.3;4.0;0.0
31;2021-03-17;1743;570;0;101243;48648;0;8.4;4.0;0.0
31;2021-03-18;2073;744;0;103316;49392;0;8.6;4.1;0.0
31;2021-03-19;3272;562;0;106588;49954;0;8.8;4.1;0.0
31;2021-03-20;1870;160;0;108458;50114;0;9.0;4.2;0.0
31;2021-03-21;268;33;0;108726;50147;0;9.0;4.2;0.0
31;2021-03-22;2687;397;0;111413;50544;0;9.2;4.2;0.0
31;2021-03-23;4138;364;0;115551;50908;0;9.6;4.2;0.0
31;2021-03-24;4390;307;0;119941;51215;0;10.0;4.3;0.0
31;2021-03-25;6070;543;0;126011;51758;0;10.5;4.3;0.0
31;2021-03-26;5599;554;0;131610;52312;0;10.9;4.3;0.0
31;2021-03-27;4477;220;0;136087;52532;0;11.3;4.4;0.0
31;2021-03-28;2259;50;0;138346;52582;0;11.5;4.4;0.0
31;2021-03-29;4415;493;0;142761;53075;0;11.8;4.4;0.0
31;2021-03-30;6562;580;0;149323;53655;0;12.4;4.5;0.0
31;2021-03-31;5821;434;0;155144;54089;0;12.9;4.5;0.0
31;2021-04-01;7101;626;0;162245;54715;0;13.5;4.5;0.0
31;2021-04-02;6246;645;0;168491;55360;0;14.0;4.6;0.0
31;2021-04-03;4111;214;0;172602;55574;0;14.3;4.6;0.0
31;2021-04-04;2048;116;0;174650;55690;0;14.5;4.6;0.0
31;2021-04-05;613;80;0;175263;55770;0;14.5;4.6;0.0
31;2021-04-06;4352;1200;0;179615;56970;0;14.9;4.7;0.0
31;2021-04-07;6403;1070;0;186018;58040;0;15.4;4.8;0.0
31;2021-04-08;7725;1118;0;193743;59158;0;16.1;4.9;0.0
31;2021-04-09;8492;1341;0;202235;60499;0;16.8;5.0;0.0
31;2021-04-10;5184;612;0;207419;61111;0;17.2;5.1;0.0
31;2021-04-11;2111;148;0;209530;61259;0;17.4;5.1;0.0
31;2021-04-12;6062;1868;0;215592;63127;0;17.9;5.2;0.0
31;2021-04-13;8024;2112;0;223616;65239;0;18.6;5.4;0.0
31;2021-04-14;6748;2046;0;230364;67285;0;19.1;5.6;0.0
31;2021-04-15;7841;2290;0;238205;69575;0;19.8;5.8;0.0
31;2021-04-16;7330;2162;0;245535;71737;0;20.4;6.0;0.0
31;2021-04-17;4603;1003;0;250138;72740;0;20.8;6.0;0.0
31;2021-04-18;2485;398;0;252623;73138;0;21.0;6.1;0.0
31;2021-04-19;5306;2188;0;257929;75326;0;21.4;6.3;0.0
31;2021-04-20;6119;2932;0;264048;78258;0;21.9;6.5;0.0
31;2021-04-21;6053;2916;0;270101;81174;0;22.4;6.7;0.0
31;2021-04-22;6470;3274;0;276571;84448;0;23.0;7.0;0.0
31;2021-04-23;6351;2768;0;282922;87216;0;23.5;7.2;0.0
31;2021-04-24;2027;3355;0;284949;90571;0;23.6;7.5;0.0
31;2021-04-25;807;2095;0;285756;92666;0;23.7;7.7;0.0
31;2021-04-26;3958;3631;0;289714;96297;0;24.0;8.0;0.0
31;2021-04-27;4728;4069;0;294442;100366;0;24.4;8.3;0.0
31;2021-04-28;4724;3792;0;299166;104158;0;24.8;8.6;0.0
31;2021-04-29;5459;4222;0;304625;108380;0;25.3;9.0;0.0
31;2021-04-30;5261;4392;0;309886;112772;0;25.7;9.4;0.0
31;2021-05-01;1953;3206;0;311839;115978;0;25.9;9.6;0.0
31;2021-05-02;1482;1984;0;313321;117962;0;26.0;9.8;0.0
31;2021-05-03;5664;2827;0;318985;120789;0;26.5;10.0;0.0
31;2021-05-04;5034;5040;0;324019;125829;0;26.9;10.4;0.0
31;2021-05-05;3563;6018;0;327582;131847;0;27.2;10.9;0.0
31;2021-05-06;4041;7446;0;331623;139293;0;27.5;11.6;0.0
31;2021-05-07;5871;7241;0;337494;146534;0;28.0;12.2;0.0
31;2021-05-08;4032;3114;0;341526;149648;0;28.3;12.4;0.0
31;2021-05-09;3845;2358;0;345371;152006;0;28.7;12.6;0.0
31;2021-05-10;6448;5749;0;351819;157755;0;29.2;13.1;0.0
31;2021-05-11;6987;6849;0;358806;164604;0;29.8;13.7;0.0
31;2021-05-12;7538;6158;0;366344;170762;0;30.4;14.2;0.0
31;2021-05-13;5691;2165;0;372035;172927;0;30.9;14.4;0.0
31;2021-05-14;8604;4247;0;380639;177174;0;31.6;14.7;0.0
31;2021-05-15;6552;2111;0;387191;179285;0;32.1;14.9;0.0
31;2021-05-16;3843;657;0;391034;179942;0;32.5;14.9;0.0
31;2021-05-17;5990;4258;0;397024;184200;0;33.0;15.3;0.0
31;2021-05-18;6739;4321;0;403763;188521;0;33.5;15.6;0.0
31;2021-05-19;7326;3834;0;411089;192355;0;34.1;16.0;0.0
31;2021-05-20;8274;4889;0;419363;197244;0;34.8;16.4;0.0
31;2021-05-21;8332;4961;0;427695;202205;0;35.5;16.8;0.0
31;2021-05-22;6157;1877;0;433852;204082;0;36.0;16.9;0.0
31;2021-05-23;4410;370;0;438262;204452;0;36.4;17.0;0.0
31;2021-05-24;4776;805;0;443038;205257;0;36.8;17.0;0.0
31;2021-05-25;7377;3870;0;450415;209127;0;37.4;17.4;0.0
31;2021-05-26;7485;4769;0;457900;213896;0;38.0;17.8;0.0
31;2021-05-27;7078;6230;0;464978;220126;0;38.6;18.3;0.0
31;2021-05-28;6560;6507;0;471538;226633;0;39.1;18.8;0.0
31;2021-05-29;4078;4258;0;475616;230891;0;39.5;19.2;0.0
31;2021-05-30;1385;2342;0;477001;233233;0;39.6;19.4;0.0
31;2021-05-31;5941;5250;0;482942;238483;0;40.1;19.8;0.0
31;2021-06-01;7138;6714;0;490080;245197;0;40.7;20.3;0.0
31;2021-06-02;7317;6497;0;497397;251694;0;41.3;20.9;0.0
31;2021-06-03;8252;8244;0;505649;259938;0;42.0;21.6;0.0
31;2021-06-04;9246;7434;0;514895;267372;0;42.7;22.2;0.0
31;2021-06-05;10593;3240;0;525488;270612;0;43.6;22.5;0.0
31;2021-06-06;7907;1565;0;533395;272177;0;44.3;22.6;0.0
31;2021-06-07;8503;5727;0;541898;277904;0;45.0;23.1;0.0
31;2021-06-08;9509;6363;0;551407;284267;0;45.8;23.6;0.0
31;2021-06-09;9889;5812;0;561296;290079;0;46.6;24.1;0.0
31;2021-06-10;10051;6536;0;571347;296615;0;47.4;24.6;0.0
31;2021-06-11;10743;7020;0;582090;303635;0;48.3;25.2;0.0
31;2021-06-12;9662;3772;0;591752;307407;0;49.1;25.5;0.0
31;2021-06-13;7935;1986;0;599687;309393;0;49.8;25.7;0.0
31;2021-06-14;8377;7028;0;608064;316421;0;50.5;26.3;0.0
31;2021-06-15;9865;7733;0;617929;324154;0;51.3;26.9;0.0
31;2021-06-16;8900;5962;0;626829;330116;0;52.0;27.4;0.0
31;2021-06-17;8405;6954;0;635234;337070;0;52.7;28.0;0.0
31;2021-06-18;8806;8542;0;644040;345612;0;53.5;28.7;0.0
31;2021-06-19;7916;6305;0;651956;351917;0;54.1;29.2;0.0
31;2021-06-20;5273;3841;0;657229;355758;0;54.5;29.5;0.0
31;2021-06-21;5349;7881;0;662578;363639;0;55.0;30.2;0.0
31;2021-06-22;5041;8812;0;667619;372451;0;55.4;30.9;0.0
31;2021-06-23;5176;8430;0;672795;380881;0;55.8;31.6;0.0
31;2021-06-24;4526;8847;0;677321;389728;0;56.2;32.3;0.0
31;2021-06-25;5055;10970;0;682376;400698;0;56.6;33.3;0.0
31;2021-06-26;4424;7747;0;686800;408445;0;57.0;33.9;0.0
31;2021-06-27;3329;4572;0;690129;413017;0;57.3;34.3;0.0
31;2021-06-28;3994;7693;0;694123;420710;0;57.6;34.9;0.0
31;2021-06-29;3854;8660;0;697977;429370;0;57.9;35.6;0.0
31;2021-06-30;4342;9357;0;702319;438727;0;58.3;36.4;0.0
31;2021-07-01;4167;9627;0;706486;448354;0;58.6;37.2;0.0
31;2021-07-02;4252;10893;0;710738;459247;0;59.0;38.1;0.0
31;2021-07-03;3995;8186;0;714733;467433;0;59.3;38.8;0.0
31;2021-07-04;2952;5044;0;717685;472477;0;59.6;39.2;0.0
31;2021-07-05;3921;7926;0;721606;480403;0;59.9;39.9;0.0
31;2021-07-06;3826;9424;5;725432;489827;5;60.2;40.7;0.0
31;2021-07-07;4023;9459;0;729455;499286;5;60.5;41.4;0.0
31;2021-07-08;3957;9403;3;733412;508689;8;60.9;42.2;0.0
31;2021-07-09;4510;10500;0;737922;519189;8;61.2;43.1;0.0
31;2021-07-10;3861;7064;0;741783;526253;8;61.6;43.7;0.0
31;2021-07-11;2851;4307;0;744634;530560;8;61.8;44.0;0.0
31;2021-07-12;3752;9850;0;748386;540410;8;62.1;44.9;0.0
31;2021-07-13;6760;10557;0;755146;550967;8;62.7;45.7;0.0
31;2021-07-14;5770;4189;0;760916;555156;8;63.2;46.1;0.0
31;2021-07-15;8261;10130;0;769177;565286;8;63.8;46.9;0.0
31;2021-07-16;7819;11107;0;776996;576393;8;64.5;47.8;0.0
31;2021-07-17;7855;11427;0;784851;587820;8;65.1;48.8;0.0
31;2021-07-18;5761;8913;0;790612;596733;8;65.6;49.5;0.0
31;2021-07-19;5124;11323;0;795736;608056;8;66.0;50.5;0.0
31;2021-07-20;7199;11761;0;802935;619817;8;66.6;51.4;0.0
31;2021-07-21;7215;11893;0;810150;631710;8;67.2;52.4;0.0
31;2021-07-22;7814;11590;0;817964;643300;8;67.9;53.4;0.0
31;2021-07-23;7229;12329;0;825193;655629;8;68.5;54.4;0.0
31;2021-07-24;8978;10368;0;834171;665997;8;69.2;55.3;0.0
31;2021-07-25;6457;8099;0;840628;674096;8;69.8;55.9;0.0
31;2021-07-26;5655;9786;0;846283;683882;8;70.2;56.8;0.0
31;2021-07-27;7901;9477;0;854184;693359;8;70.9;57.5;0.0
31;2021-07-28;8255;8489;0;862439;701848;8;71.6;58.2;0.0
31;2021-07-29;8528;8247;0;870967;710095;8;72.3;58.9;0.0
31;2021-07-30;7472;8251;0;878439;718346;8;72.9;59.6;0.0
31;2021-07-31;5704;7006;0;884143;725352;8;73.4;60.2;0.0
31;2021-08-01;3989;3988;0;888132;729340;8;73.7;60.5;0.0
31;2021-08-02;5621;5541;0;893753;734881;8;74.2;61.0;0.0
31;2021-08-03;5989;5456;0;899742;740337;8;74.7;61.4;0.0
31;2021-08-04;6040;4961;1;905782;745298;9;75.2;61.9;0.0
31;2021-08-05;5574;7224;0;911356;752522;9;75.6;62.5;0.0
31;2021-08-06;5445;7324;0;916801;759846;9;76.1;63.1;0.0
31;2021-08-07;4383;6426;0;921184;766272;9;76.5;63.6;0.0
31;2021-08-08;2983;4892;0;924167;771164;9;76.7;64.0;0.0
31;2021-08-09;4379;7018;0;928546;778182;9;77.1;64.6;0.0
31;2021-08-10;4706;6473;0;933252;784655;9;77.5;65.1;0.0
31;2021-08-11;4515;5951;0;937767;790606;9;77.8;65.6;0.0
31;2021-08-12;4431;6722;0;942198;797328;9;78.2;66.2;0.0
31;2021-08-13;3938;6084;0;946136;803412;9;78.5;66.7;0.0
31;2021-08-14;2861;6113;0;948997;809525;9;78.8;67.2;0.0
31;2021-08-15;1099;3642;0;950096;813167;9;78.9;67.5;0.0
31;2021-08-16;3199;7992;0;953295;821159;9;79.1;68.2;0.0
31;2021-08-17;3453;7176;0;956748;828335;9;79.4;68.7;0.0
31;2021-08-18;3249;6892;2;959997;835227;11;79.7;69.3;0.0
31;2021-08-19;2942;6971;0;962939;842198;11;79.9;69.9;0.0
31;2021-08-20;2889;7211;0;965828;849409;11;80.2;70.5;0.0
31;2021-08-21;1888;6497;0;967716;855906;11;80.3;71.0;0.0
31;2021-08-22;1270;4864;1;968986;860770;12;80.4;71.4;0.0
31;2021-08-23;2250;7448;0;971236;868218;12;80.6;72.1;0.0
31;2021-08-24;2403;6274;0;973639;874492;12;80.8;72.6;0.0
31;2021-08-25;2290;5718;0;975929;880210;12;81.0;73.1;0.0
31;2021-08-26;2190;5858;0;978119;886068;12;81.2;73.5;0.0
31;2021-08-27;2326;6679;0;980445;892747;12;81.4;74.1;0.0
31;2021-08-28;1711;6347;0;982156;899094;12;81.5;74.6;0.0
31;2021-08-29;1120;4454;0;983276;903548;12;81.6;75.0;0.0
31;2021-08-30;2004;6431;51;985280;909979;63;81.8;75.5;0.0
31;2021-08-31;2113;5361;138;987393;915340;201;81.9;76.0;0.0
31;2021-09-01;1908;4575;457;989301;919915;658;82.1;76.3;0.1
31;2021-09-02;1710;4036;518;991011;923951;1176;82.2;76.7;0.1
31;2021-09-03;1765;4578;533;992776;928529;1709;82.4;77.1;0.1
31;2021-09-04;1927;5272;280;994703;933801;1989;82.6;77.5;0.2
31;2021-09-05;940;1899;246;995643;935700;2235;82.6;77.7;0.2
31;2021-09-06;1351;2898;634;996994;938598;2869;82.7;77.9;0.2
31;2021-09-07;1186;2846;582;998180;941444;3451;82.8;78.1;0.3
31;2021-09-08;1342;3461;616;999522;944905;4067;83.0;78.4;0.3
31;2021-09-09;1004;2465;617;1000526;947370;4684;83.0;78.6;0.4
31;2021-09-10;1507;3144;615;1002033;950514;5299;83.2;78.9;0.4
31;2021-09-11;1245;3450;263;1003278;953964;5562;83.3;79.2;0.5
31;2021-09-12;475;1466;132;1003753;955430;5694;83.3;79.3;0.5
31;2021-09-13;1005;1972;754;1004758;957402;6448;83.4;79.5;0.5
31;2021-09-14;1190;1930;976;1005948;959332;7424;83.5;79.6;0.6
31;2021-09-15;1057;2547;859;1007005;961879;8283;83.6;79.8;0.7
31;2021-09-16;907;1640;1132;1007912;963519;9415;83.7;80.0;0.8
31;2021-09-17;1066;2441;864;1008978;965960;10279;83.7;80.2;0.9
31;2021-09-18;832;2669;252;1009810;968629;10531;83.8;80.4;0.9
31;2021-09-19;279;1070;129;1010089;969699;10660;83.8;80.5;0.9
31;2021-09-20;591;1462;726;1010680;971161;11386;83.9;80.6;0.9
31;2021-09-21;792;1565;1253;1011472;972726;12639;83.9;80.7;1.0
31;2021-09-22;805;2045;990;1012277;974771;13629;84.0;80.9;1.1
31;2021-09-23;720;1454;1232;1012997;976225;14861;84.1;81.0;1.2
31;2021-09-24;802;1981;989;1013799;978206;15850;84.1;81.2;1.3
31;2021-09-25;634;2407;229;1014433;980613;16079;84.2;81.4;1.3
31;2021-09-26;228;937;107;1014661;981550;16186;84.2;81.5;1.3
31;2021-09-27;627;1405;744;1015288;982955;16930;84.3;81.6;1.4
31;2021-09-28;706;1262;948;1015994;984217;17878;84.3;81.7;1.5
31;2021-09-29;721;1551;881;1016715;985768;18759;84.4;81.8;1.6
31;2021-09-30;675;1080;1101;1017390;986848;19860;84.4;81.9;1.6
31;2021-10-01;995;1768;916;1018385;988616;20776;84.5;82.0;1.7
31;2021-10-02;749;1642;310;1019134;990258;21086;84.6;82.2;1.8
31;2021-10-03;96;295;26;1019230;990553;21112;84.6;82.2;1.8
31;2021-10-04;450;674;609;1019680;991227;21721;84.6;82.3;1.8
31;2021-10-05;556;1200;1170;1020236;992427;22891;84.7;82.4;1.9
31;2021-10-06;657;1115;848;1020893;993542;23739;84.7;82.5;2.0
31;2021-10-07;620;1307;1187;1021513;994849;24926;84.8;82.6;2.1
31;2021-10-08;827;1169;1149;1022340;996018;26075;84.8;82.7;2.2
31;2021-10-09;493;1185;375;1022833;997203;26450;84.9;82.8;2.2
31;2021-10-10;26;63;28;1022859;997266;26478;84.9;82.8;2.2
31;2021-10-11;418;529;566;1023277;997795;27044;84.9;82.8;2.2
31;2021-10-12;563;1001;1220;1023840;998796;28264;85.0;82.9;2.3
31;2021-10-13;565;1050;952;1024405;999846;29216;85.0;83.0;2.4
31;2021-10-14;614;1049;1226;1025019;1000895;30442;85.1;83.1;2.5
31;2021-10-15;734;1042;1340;1025753;1001937;31782;85.1;83.2;2.6
31;2021-10-16;465;949;587;1026218;1002886;32369;85.2;83.2;2.7
31;2021-10-17;17;38;14;1026235;1002924;32383;85.2;83.2;2.7
31;2021-10-18;331;498;731;1026566;1003422;33114;85.2;83.3;2.7
31;2021-10-19;496;891;1245;1027062;1004313;34359;85.2;83.4;2.9
31;2021-10-20;555;829;1355;1027617;1005142;35714;85.3;83.4;3.0
31;2021-10-21;550;949;1651;1028167;1006091;37365;85.3;83.5;3.1
31;2021-10-22;607;965;1561;1028774;1007056;38926;85.4;83.6;3.2
31;2021-10-23;403;1034;690;1029177;1008090;39616;85.4;83.7;3.3
31;2021-10-24;19;47;18;1029196;1008137;39634;85.4;83.7;3.3
31;2021-10-25;318;384;1111;1029514;1008521;40745;85.4;83.7;3.4
31;2021-10-26;443;538;1521;1029957;1009059;42266;85.5;83.7;3.5
31;2021-10-27;491;704;1975;1030448;1009763;44241;85.5;83.8;3.7
31;2021-10-28;441;564;1814;1030889;1010327;46055;85.6;83.9;3.8
31;2021-10-29;529;765;2002;1031418;1011092;48057;85.6;83.9;4.0
31;2021-10-30;306;502;656;1031724;1011594;48713;85.6;84.0;4.0
31;2021-10-31;26;34;19;1031750;1011628;48732;85.6;84.0;4.0
31;2021-11-01;61;37;36;1031811;1011665;48768;85.6;84.0;4.0
31;2021-11-02;477;620;1768;1032288;1012285;50536;85.7;84.0;4.2
31;2021-11-03;437;654;1962;1032725;1012939;52498;85.7;84.1;4.4
31;2021-11-04;402;556;2155;1033127;1013495;54653;85.7;84.1;4.5
31;2021-11-05;542;764;2648;1033669;1014259;57301;85.8;84.2;4.8
31;2021-11-06;315;444;882;1033984;1014703;58183;85.8;84.2;4.8
31;2021-11-07;28;44;70;1034012;1014747;58253;85.8;84.2;4.8
31;2021-11-08;286;436;1781;1034298;1015183;60034;85.8;84.3;5.0
31;2021-11-09;477;621;3827;1034775;1015804;63861;85.9;84.3;5.3
31;2021-11-10;496;746;3756;1035271;1016550;67617;85.9;84.4;5.6
31;2021-11-11;24;62;96;1035295;1016612;67713;85.9;84.4;5.6
31;2021-11-12;512;729;3717;1035807;1017341;71430;86.0;84.4;5.9
31;2021-11-13;315;430;1218;1036122;1017771;72648;86.0;84.5;6.0
31;2021-11-14;14;22;52;1036136;1017793;72700;86.0;84.5;6.0
31;2021-11-15;305;395;2476;1036441;1018188;75176;86.0;84.5;6.2
31;2021-11-16;488;654;4739;1036929;1018842;79915;86.1;84.6;6.6
31;2021-11-17;497;564;4010;1037426;1019406;83925;86.1;84.6;7.0
31;2021-11-18;445;504;4269;1037871;1019910;88194;86.1;84.6;7.3
31;2021-11-19;578;676;4997;1038449;1020586;93191;86.2;84.7;7.7
31;2021-11-20;468;459;1836;1038917;1021045;95027;86.2;84.7;7.9
31;2021-11-21;31;50;72;1038948;1021095;95099;86.2;84.7;7.9
31;2021-11-22;326;293;3031;1039274;1021388;98130;86.3;84.8;8.1
31;2021-11-23;479;514;5499;1039753;1021902;103629;86.3;84.8;8.6
31;2021-11-24;495;495;4557;1040248;1022397;108186;86.3;84.9;9.0
31;2021-11-25;438;470;5989;1040686;1022867;114175;86.4;84.9;9.5
31;2021-11-26;538;600;8313;1041224;1023467;122488;86.4;84.9;10.2
31;2021-11-27;369;485;4794;1041593;1023952;127282;86.4;85.0;10.6
31;2021-11-28;30;86;874;1041623;1024038;128156;86.4;85.0;10.6
31;2021-11-29;282;331;5837;1041905;1024369;133993;86.5;85.0;11.1
31;2021-11-30;419;554;9688;1042324;1024923;143681;86.5;85.1;11.9
31;2021-12-01;393;495;9088;1042717;1025418;152769;86.5;85.1;12.7
31;2021-12-02;383;360;11393;1043100;1025778;164162;86.6;85.1;13.6
31;2021-12-03;394;537;12055;1043494;1026315;176217;86.6;85.2;14.6
31;2021-12-04;251;474;6122;1043745;1026789;182339;86.6;85.2;15.1
31;2021-12-05;72;96;1988;1043817;1026885;184327;86.6;85.2;15.3
31;2021-12-06;261;380;9471;1044078;1027265;193798;86.7;85.3;16.1
31;2021-12-07;443;544;12929;1044521;1027809;206727;86.7;85.3;17.2
31;2021-12-08;406;622;11634;1044927;1028431;218361;86.7;85.4;18.1
31;2021-12-09;463;571;15256;1045390;1029002;233617;86.8;85.4;19.4
31;2021-12-10;519;638;16007;1045909;1029640;249624;86.8;85.5;20.7
31;2021-12-11;351;490;9884;1046260;1030130;259508;86.8;85.5;21.5
31;2021-12-12;154;115;4623;1046414;1030245;264131;86.8;85.5;21.9
31;2021-12-13;373;452;12820;1046787;1030697;276951;86.9;85.5;23.0
31;2021-12-14;548;647;17222;1047335;1031344;294173;86.9;85.6;24.4
31;2021-12-15;559;666;15022;1047894;1032010;309195;87.0;85.7;25.7
31;2021-12-16;474;647;16558;1048368;1032657;325753;87.0;85.7;27.0
31;2021-12-17;556;676;17254;1048924;1033333;343007;87.1;85.8;28.5
31;2021-12-18;472;480;10497;1049396;1033813;353504;87.1;85.8;29.3
31;2021-12-19;186;160;5304;1049582;1033973;358808;87.1;85.8;29.8
32;2020-12-27;0;0;0;0;0;0;0.0;0.0;0.0
32;2020-12-28;0;0;0;0;0;0;0.0;0.0;0.0
32;2020-12-29;1;0;0;1;0;0;0.0;0.0;0.0
32;2020-12-30;0;0;0;1;0;0;0.0;0.0;0.0
32;2020-12-31;0;0;0;1;0;0;0.0;0.0;0.0
32;2021-01-01;1;0;0;2;0;0;0.0;0.0;0.0
32;2021-01-02;0;0;0;2;0;0;0.0;0.0;0.0
32;2021-01-03;0;0;0;2;0;0;0.0;0.0;0.0
32;2021-01-04;2;0;0;4;0;0;0.0;0.0;0.0
32;2021-01-05;4;0;0;8;0;0;0.0;0.0;0.0
32;2021-01-06;6;0;0;14;0;0;0.0;0.0;0.0
32;2021-01-07;148;0;0;162;0;0;0.1;0.0;0.0
32;2021-01-08;78;0;0;240;0;0;0.1;0.0;0.0
32;2021-01-09;7;0;0;247;0;0;0.1;0.0;0.0
32;2021-01-10;2;0;0;249;0;0;0.1;0.0;0.0
32;2021-01-11;35;1;0;284;1;0;0.2;0.0;0.0
32;2021-01-12;94;0;0;378;1;0;0.2;0.0;0.0
32;2021-01-13;296;1;0;674;2;0;0.4;0.0;0.0
32;2021-01-14;347;3;0;1021;5;0;0.6;0.0;0.0
32;2021-01-15;415;2;0;1436;7;0;0.9;0.0;0.0
32;2021-01-16;26;1;0;1462;8;0;0.9;0.0;0.0
32;2021-01-17;2;0;0;1464;8;0;0.9;0.0;0.0
32;2021-01-18;312;2;0;1776;10;0;1.1;0.0;0.0
32;2021-01-19;433;0;0;2209;10;0;1.3;0.0;0.0
32;2021-01-20;392;0;0;2601;10;0;1.5;0.0;0.0
32;2021-01-21;605;1;0;3206;11;0;1.9;0.0;0.0
32;2021-01-22;382;1;0;3588;12;0;2.1;0.0;0.0
32;2021-01-23;178;0;0;3766;12;0;2.2;0.0;0.0
32;2021-01-24;6;0;0;3772;12;0;2.2;0.0;0.0
32;2021-01-25;485;1;0;4257;13;0;2.5;0.0;0.0
32;2021-01-26;621;3;0;4878;16;0;2.9;0.0;0.0
32;2021-01-27;673;8;0;5551;24;0;3.3;0.0;0.0
32;2021-01-28;618;24;0;6169;48;0;3.7;0.0;0.0
32;2021-01-29;451;46;0;6620;94;0;3.9;0.1;0.0
32;2021-01-30;270;2;0;6890;96;0;4.1;0.1;0.0
32;2021-01-31;3;6;0;6893;102;0;4.1;0.1;0.0
32;2021-02-01;315;73;0;7208;175;0;4.3;0.1;0.0
32;2021-02-02;643;126;0;7851;301;0;4.7;0.2;0.0
32;2021-02-03;373;175;0;8224;476;0;4.9;0.3;0.0
32;2021-02-04;432;262;0;8656;738;0;5.1;0.4;0.0
32;2021-02-05;345;321;0;9001;1059;0;5.3;0.6;0.0
32;2021-02-06;147;5;0;9148;1064;0;5.4;0.6;0.0
32;2021-02-07;0;32;0;9148;1096;0;5.4;0.7;0.0
32;2021-02-08;305;124;0;9453;1220;0;5.6;0.7;0.0
32;2021-02-09;341;233;0;9794;1453;0;5.8;0.9;0.0
32;2021-02-10;309;260;0;10103;1713;0;6.0;1.0;0.0
32;2021-02-11;366;324;0;10469;2037;0;6.2;1.2;0.0
32;2021-02-12;313;268;0;10782;2305;0;6.4;1.4;0.0
32;2021-02-13;261;1;0;11043;2306;0;6.6;1.4;0.0
32;2021-02-14;0;28;0;11043;2334;0;6.6;1.4;0.0
32;2021-02-15;39;239;0;11082;2573;0;6.6;1.5;0.0
32;2021-02-16;407;384;0;11489;2957;0;6.8;1.8;0.0
32;2021-02-17;199;466;0;11688;3423;0;6.9;2.0;0.0
32;2021-02-18;321;484;0;12009;3907;0;7.1;2.3;0.0
32;2021-02-19;182;293;0;12191;4200;0;7.2;2.5;0.0
32;2021-02-20;9;148;0;12200;4348;0;7.2;2.6;0.0
32;2021-02-21;0;5;0;12200;4353;0;7.2;2.6;0.0
32;2021-02-22;163;421;0;12363;4774;0;7.3;2.8;0.0
32;2021-02-23;434;590;0;12797;5364;0;7.6;3.2;0.0
32;2021-02-24;295;383;0;13092;5747;0;7.8;3.4;0.0
32;2021-02-25;487;521;0;13579;6268;0;8.1;3.7;0.0
32;2021-02-26;456;358;0;14035;6626;0;8.3;3.9;0.0
32;2021-02-27;169;254;0;14204;6880;0;8.4;4.1;0.0
32;2021-02-28;6;1;0;14210;6881;0;8.4;4.1;0.0
32;2021-03-01;74;325;0;14284;7206;0;8.5;4.3;0.0
32;2021-03-02;419;453;0;14703;7659;0;8.7;4.5;0.0
32;2021-03-03;301;332;0;15004;7991;0;8.9;4.7;0.0
32;2021-03-04;550;355;0;15554;8346;0;9.2;5.0;0.0
32;2021-03-05;472;274;0;16026;8620;0;9.5;5.1;0.0
32;2021-03-06;566;174;0;16592;8794;0;9.8;5.2;0.0
32;2021-03-07;65;5;0;16657;8799;0;9.9;5.2;0.0
32;2021-03-08;265;305;0;16922;9104;0;10.0;5.4;0.0
32;2021-03-09;700;375;0;17622;9479;0;10.5;5.6;0.0
32;2021-03-10;515;353;0;18137;9832;0;10.8;5.8;0.0
32;2021-03-11;899;310;0;19036;10142;0;11.3;6.0;0.0
32;2021-03-12;934;355;0;19970;10497;0;11.9;6.2;0.0
32;2021-03-13;500;250;0;20470;10747;0;12.2;6.4;0.0
32;2021-03-14;3;0;0;20473;10747;0;12.2;6.4;0.0
32;2021-03-15;346;43;0;20819;10790;0;12.4;6.4;0.0
32;2021-03-16;323;318;0;21142;11108;0;12.5;6.6;0.0
32;2021-03-17;202;158;0;21344;11266;0;12.7;6.7;0.0
32;2021-03-18;436;306;0;21780;11572;0;12.9;6.9;0.0
32;2021-03-19;456;176;0;22236;11748;0;13.2;7.0;0.0
32;2021-03-20;182;32;0;22418;11780;0;13.3;7.0;0.0
32;2021-03-21;17;0;0;22435;11780;0;13.3;7.0;0.0
32;2021-03-22;398;174;0;22833;11954;0;13.6;7.1;0.0
32;2021-03-23;655;400;0;23488;12354;0;13.9;7.3;0.0
32;2021-03-24;717;277;0;24205;12631;0;14.4;7.5;0.0
32;2021-03-25;990;419;0;25195;13050;0;15.0;7.7;0.0
32;2021-03-26;730;301;0;25925;13351;0;15.4;7.9;0.0
32;2021-03-27;225;8;0;26150;13359;0;15.5;7.9;0.0
32;2021-03-28;13;2;0;26163;13361;0;15.5;7.9;0.0
32;2021-03-29;434;70;0;26597;13431;0;15.8;8.0;0.0
32;2021-03-30;884;294;0;27481;13725;0;16.3;8.1;0.0
32;2021-03-31;727;186;0;28208;13911;0;16.7;8.3;0.0
32;2021-04-01;1344;339;0;29552;14250;0;17.5;8.5;0.0
32;2021-04-02;682;190;0;30234;14440;0;17.9;8.6;0.0
32;2021-04-03;182;7;0;30416;14447;0;18.1;8.6;0.0
32;2021-04-04;18;3;0;30434;14450;0;18.1;8.6;0.0
32;2021-04-05;46;3;0;30480;14453;0;18.1;8.6;0.0
32;2021-04-06;2635;365;0;33115;14818;0;19.7;8.8;0.0
32;2021-04-07;1304;235;0;34419;15053;0;20.4;8.9;0.0
32;2021-04-08;1856;421;0;36275;15474;0;21.5;9.2;0.0
32;2021-04-09;976;236;0;37251;15710;0;22.1;9.3;0.0
32;2021-04-10;904;45;0;38155;15755;0;22.6;9.4;0.0
32;2021-04-11;43;3;0;38198;15758;0;22.7;9.4;0.0
32;2021-04-12;589;65;0;38787;15823;0;23.0;9.4;0.0
32;2021-04-13;2560;405;0;41347;16228;0;24.5;9.6;0.0
32;2021-04-14;1332;295;0;42679;16523;0;25.3;9.8;0.0
32;2021-04-15;1803;456;0;44482;16979;0;26.4;10.1;0.0
32;2021-04-16;732;341;0;45214;17320;0;26.8;10.3;0.0
32;2021-04-17;838;61;0;46052;17381;0;27.3;10.3;0.0
32;2021-04-18;31;6;0;46083;17387;0;27.4;10.3;0.0
32;2021-04-19;537;117;0;46620;17504;0;27.7;10.4;0.0
32;2021-04-20;2378;484;0;48998;17988;0;29.1;10.7;0.0
32;2021-04-21;1004;398;0;50002;18386;0;29.7;10.9;0.0
32;2021-04-22;1650;429;0;51652;18815;0;30.7;11.2;0.0
32;2021-04-23;558;229;0;52210;19044;0;31.0;11.3;0.0
32;2021-04-24;1345;104;0;53555;19148;0;31.8;11.4;0.0
32;2021-04-25;13;18;0;53568;19166;0;31.8;11.4;0.0
32;2021-04-26;360;440;0;53928;19606;0;32.0;11.6;0.0
32;2021-04-27;2297;675;0;56225;20281;0;33.4;12.0;0.0
32;2021-04-28;913;452;0;57138;20733;0;33.9;12.3;0.0
32;2021-04-29;1017;982;0;58155;21715;0;34.5;12.9;0.0
32;2021-04-30;507;436;0;58662;22151;0;34.8;13.1;0.0
32;2021-05-01;2406;119;0;61068;22270;0;36.2;13.2;0.0
32;2021-05-02;16;10;0;61084;22280;0;36.3;13.2;0.0
32;2021-05-03;271;488;0;61355;22768;0;36.4;13.5;0.0
32;2021-05-04;813;2530;0;62168;25298;0;36.9;15.0;0.0
32;2021-05-05;2103;1198;0;64271;26496;0;38.1;15.7;0.0
32;2021-05-06;613;1765;0;64884;28261;0;38.5;16.8;0.0
32;2021-05-07;2003;670;0;66887;28931;0;39.7;17.2;0.0
32;2021-05-08;141;478;0;67028;29409;0;39.8;17.5;0.0
32;2021-05-09;40;201;0;67068;29610;0;39.8;17.6;0.0
32;2021-05-10;1572;625;0;68640;30235;0;40.7;17.9;0.0
32;2021-05-11;771;2308;0;69411;32543;0;41.2;19.3;0.0
32;2021-05-12;1879;1131;0;71290;33674;0;42.3;20.0;0.0
32;2021-05-13;395;1376;0;71685;35050;0;42.6;20.8;0.0
32;2021-05-14;1648;371;0;73333;35421;0;43.5;21.0;0.0
32;2021-05-15;251;730;0;73584;36151;0;43.7;21.5;0.0
32;2021-05-16;49;5;0;73633;36156;0;43.7;21.5;0.0
32;2021-05-17;360;263;0;73993;36419;0;43.9;21.6;0.0
32;2021-05-18;1453;336;0;75446;36755;0;44.8;21.8;0.0
32;2021-05-19;2065;305;0;77511;37060;0;46.0;22.0;0.0
32;2021-05-20;2039;460;0;79550;37520;0;47.2;22.3;0.0
32;2021-05-21;1450;490;0;81000;38010;0;48.1;22.6;0.0
32;2021-05-22;421;137;0;81421;38147;0;48.3;22.6;0.0
32;2021-05-23;36;18;0;81457;38165;0;48.4;22.7;0.0
32;2021-05-24;105;14;0;81562;38179;0;48.4;22.7;0.0
32;2021-05-25;1533;436;0;83095;38615;0;49.3;22.9;0.0
32;2021-05-26;1868;593;0;84963;39208;0;50.4;23.3;0.0
32;2021-05-27;1828;693;0;86791;39901;0;51.5;23.7;0.0
32;2021-05-28;1250;828;0;88041;40729;0;52.3;24.2;0.0
32;2021-05-29;411;370;0;88452;41099;0;52.5;24.4;0.0
32;2021-05-30;12;13;0;88464;41112;0;52.5;24.4;0.0
32;2021-05-31;883;645;0;89347;41757;0;53.0;24.8;0.0
32;2021-06-01;671;2746;0;90018;44503;0;53.4;26.4;0.0
32;2021-06-02;1155;1264;0;91173;45767;0;54.1;27.2;0.0
32;2021-06-03;570;2020;0;91743;47787;0;54.5;28.4;0.0
32;2021-06-04;1323;871;0;93066;48658;0;55.2;28.9;0.0
32;2021-06-05;295;1603;0;93361;50261;0;55.4;29.8;0.0
32;2021-06-06;56;29;0;93417;50290;0;55.4;29.9;0.0
32;2021-06-07;265;460;0;93682;50750;0;55.6;30.1;0.0
32;2021-06-08;732;2336;0;94414;53086;0;56.0;31.5;0.0
32;2021-06-09;1052;980;0;95466;54066;0;56.7;32.1;0.0
32;2021-06-10;731;1143;0;96197;55209;0;57.1;32.8;0.0
32;2021-06-11;881;684;0;97078;55893;0;57.6;33.2;0.0
32;2021-06-12;258;2484;0;97336;58377;0;57.8;34.7;0.0
32;2021-06-13;76;14;0;97412;58391;0;57.8;34.7;0.0
32;2021-06-14;505;376;0;97917;58767;0;58.1;34.9;0.0
32;2021-06-15;1547;1056;0;99464;59823;0;59.0;35.5;0.0
32;2021-06-16;870;2534;0;100334;62357;0;59.6;37.0;0.0
32;2021-06-17;750;881;0;101084;63238;0;60.0;37.5;0.0
32;2021-06-18;310;2420;0;101394;65658;0;60.2;39.0;0.0
32;2021-06-19;948;508;0;102342;66166;0;60.7;39.3;0.0
32;2021-06-20;52;36;0;102394;66202;0;60.8;39.3;0.0
32;2021-06-21;158;1659;0;102552;67861;0;60.9;40.3;0.0
32;2021-06-22;979;1050;0;103531;68911;0;61.5;40.9;0.0
32;2021-06-23;550;1824;0;104081;70735;0;61.8;42.0;0.0
32;2021-06-24;606;642;0;104687;71377;0;62.1;42.4;0.0
32;2021-06-25;501;1838;0;105188;73215;0;62.4;43.5;0.0
32;2021-06-26;175;308;0;105363;73523;0;62.5;43.6;0.0
32;2021-06-27;46;62;0;105409;73585;0;62.6;43.7;0.0
32;2021-06-28;630;599;0;106039;74184;0;62.9;44.0;0.0
32;2021-06-29;796;1794;0;106835;75978;0;63.4;45.1;0.0
32;2021-06-30;774;2325;0;107609;78303;0;63.9;46.5;0.0
32;2021-07-01;577;2130;0;108186;80433;0;64.2;47.7;0.0
32;2021-07-02;654;1756;0;108840;82189;0;64.6;48.8;0.0
32;2021-07-03;505;594;0;109345;82783;0;64.9;49.1;0.0
32;2021-07-04;37;48;0;109382;82831;0;64.9;49.2;0.0
32;2021-07-05;191;419;0;109573;83250;0;65.0;49.4;0.0
32;2021-07-06;833;1867;0;110406;85117;0;65.5;50.5;0.0
32;2021-07-07;802;2196;0;111208;87313;0;66.0;51.8;0.0
32;2021-07-08;517;1828;0;111725;89141;0;66.3;52.9;0.0
32;2021-07-09;639;1624;0;112364;90765;0;66.7;53.9;0.0
32;2021-07-10;533;598;0;112897;91363;0;67.0;54.2;0.0
32;2021-07-11;24;37;0;112921;91400;0;67.0;54.3;0.0
32;2021-07-12;505;1114;0;113426;92514;0;67.3;54.9;0.0
32;2021-07-13;1499;1684;0;114925;94198;0;68.2;55.9;0.0
32;2021-07-14;547;103;0;115472;94301;0;68.5;56.0;0.0
32;2021-07-15;1641;941;0;117113;95242;0;69.5;56.5;0.0
32;2021-07-16;1046;1686;0;118159;96928;0;70.1;57.5;0.0
32;2021-07-17;200;313;0;118359;97241;0;70.3;57.7;0.0
32;2021-07-18;75;80;0;118434;97321;0;70.3;57.8;0.0
32;2021-07-19;1549;372;0;119983;97693;0;71.2;58.0;0.0
32;2021-07-20;1621;1300;0;121604;98993;0;72.2;58.8;0.0
32;2021-07-21;1342;1578;0;122946;100571;0;73.0;59.7;0.0
32;2021-07-22;1613;648;1;124559;101219;1;73.9;60.1;0.0
32;2021-07-23;1121;1630;0;125680;102849;1;74.6;61.0;0.0
32;2021-07-24;263;298;0;125943;103147;1;74.8;61.2;0.0
32;2021-07-25;133;65;0;126076;103212;1;74.8;61.3;0.0
32;2021-07-26;909;1052;0;126985;104264;1;75.4;61.9;0.0
32;2021-07-27;1392;1868;0;128377;106132;1;76.2;63.0;0.0
32;2021-07-28;731;996;0;129108;107128;1;76.6;63.6;0.0
32;2021-07-29;1465;1343;0;130573;108471;1;77.5;64.4;0.0
32;2021-07-30;510;484;0;131083;108955;1;77.8;64.7;0.0
32;2021-07-31;316;450;0;131399;109405;1;78.0;64.9;0.0
32;2021-08-01;60;35;0;131459;109440;1;78.0;65.0;0.0
32;2021-08-02;258;201;0;131717;109641;1;78.2;65.1;0.0
32;2021-08-03;1088;1663;0;132805;111304;1;78.8;66.1;0.0
32;2021-08-04;664;670;0;133469;111974;1;79.2;66.5;0.0
32;2021-08-05;1072;1768;0;134541;113742;1;79.9;67.5;0.0
32;2021-08-06;617;587;0;135158;114329;1;80.2;67.9;0.0
32;2021-08-07;250;225;0;135408;114554;1;80.4;68.0;0.0
32;2021-08-08;45;55;0;135453;114609;1;80.4;68.0;0.0
32;2021-08-09;346;1620;0;135799;116229;1;80.6;69.0;0.0
32;2021-08-10;616;1849;0;136415;118078;1;81.0;70.1;0.0
32;2021-08-11;609;548;0;137024;118626;1;81.3;70.4;0.0
32;2021-08-12;892;1863;0;137916;120489;1;81.9;71.5;0.0
32;2021-08-13;280;386;0;138196;120875;1;82.0;71.7;0.0
32;2021-08-14;225;267;0;138421;121142;1;82.2;71.9;0.0
32;2021-08-15;16;74;0;138437;121216;1;82.2;72.0;0.0
32;2021-08-16;171;240;0;138608;121456;1;82.3;72.1;0.0
32;2021-08-17;513;2097;0;139121;123553;1;82.6;73.3;0.0
32;2021-08-18;373;595;0;139494;124148;1;82.8;73.7;0.0
32;2021-08-19;900;1267;0;140394;125415;1;83.3;74.4;0.0
32;2021-08-20;234;362;0;140628;125777;1;83.5;74.7;0.0
32;2021-08-21;192;334;0;140820;126111;1;83.6;74.9;0.0
32;2021-08-22;23;76;0;140843;126187;1;83.6;74.9;0.0
32;2021-08-23;102;318;0;140945;126505;1;83.7;75.1;0.0
32;2021-08-24;570;1393;0;141515;127898;1;84.0;75.9;0.0
32;2021-08-25;148;357;0;141663;128255;1;84.1;76.1;0.0
32;2021-08-26;341;1982;0;142004;130237;1;84.3;77.3;0.0
32;2021-08-27;312;632;0;142316;130869;1;84.5;77.7;0.0
32;2021-08-28;127;240;0;142443;131109;1;84.5;77.8;0.0
32;2021-08-29;17;57;0;142460;131166;1;84.6;77.9;0.0
32;2021-08-30;67;250;2;142527;131416;3;84.6;78.0;0.0
32;2021-08-31;231;1472;23;142758;132888;26;84.7;78.9;0.0
32;2021-09-01;612;785;48;143370;133673;74;85.1;79.3;0.0
32;2021-09-02;304;1397;150;143674;135070;224;85.3;80.2;0.1
32;2021-09-03;210;434;28;143884;135504;252;85.4;80.4;0.1
32;2021-09-04;77;284;17;143961;135788;269;85.5;80.6;0.2
32;2021-09-05;32;32;0;143993;135820;269;85.5;80.6;0.2
32;2021-09-06;87;176;44;144080;135996;313;85.5;80.7;0.2
32;2021-09-07;425;722;112;144505;136718;425;85.8;81.2;0.3
32;2021-09-08;267;541;79;144772;137259;504;85.9;81.5;0.3
32;2021-09-09;199;840;191;144971;138099;695;86.1;82.0;0.4
32;2021-09-10;210;270;55;145181;138369;750;86.2;82.1;0.4
32;2021-09-11;110;257;30;145291;138626;780;86.2;82.3;0.5
32;2021-09-12;6;20;1;145297;138646;781;86.2;82.3;0.5
32;2021-09-13;35;72;22;145332;138718;803;86.3;82.3;0.5
32;2021-09-14;306;544;304;145638;139262;1107;86.4;82.7;0.7
32;2021-09-15;221;239;140;145859;139501;1247;86.6;82.8;0.7
32;2021-09-16;176;241;177;146035;139742;1424;86.7;82.9;0.8
32;2021-09-17;196;376;220;146231;140118;1644;86.8;83.2;1.0
32;2021-09-18;62;142;24;146293;140260;1668;86.8;83.3;1.0
32;2021-09-19;4;21;0;146297;140281;1668;86.8;83.3;1.0
32;2021-09-20;20;51;61;146317;140332;1729;86.8;83.3;1.0
32;2021-09-21;233;385;338;146550;140717;2067;87.0;83.5;1.2
32;2021-09-22;208;541;197;146758;141258;2264;87.1;83.8;1.3
32;2021-09-23;127;213;207;146885;141471;2471;87.2;84.0;1.5
32;2021-09-24;102;296;224;146987;141767;2695;87.2;84.1;1.6
32;2021-09-25;63;125;28;147050;141892;2723;87.3;84.2;1.6
32;2021-09-26;5;23;3;147055;141915;2726;87.3;84.2;1.6
32;2021-09-27;33;75;136;147088;141990;2862;87.3;84.3;1.7
32;2021-09-28;102;457;599;147190;142447;3461;87.4;84.6;2.1
32;2021-09-29;91;357;467;147281;142804;3928;87.4;84.8;2.3
32;2021-09-30;122;178;260;147403;142982;4188;87.5;84.9;2.5
32;2021-10-01;124;261;197;147527;143243;4385;87.6;85.0;2.6
32;2021-10-02;41;130;46;147568;143373;4431;87.6;85.1;2.6
32;2021-10-03;2;8;7;147570;143381;4438;87.6;85.1;2.6
32;2021-10-04;24;35;58;147594;143416;4496;87.6;85.1;2.7
32;2021-10-05;72;266;437;147666;143682;4933;87.7;85.3;2.9
32;2021-10-06;65;272;306;147731;143954;5239;87.7;85.4;3.1
32;2021-10-07;55;189;319;147786;144143;5558;87.7;85.6;3.3
32;2021-10-08;71;249;245;147857;144392;5803;87.8;85.7;3.4
32;2021-10-09;43;88;56;147900;144480;5859;87.8;85.8;3.5
32;2021-10-10;0;0;0;147900;144480;5859;87.8;85.8;3.5
32;2021-10-11;21;31;41;147921;144511;5900;87.8;85.8;3.5
32;2021-10-12;65;155;305;147986;144666;6205;87.8;85.9;3.7
32;2021-10-13;74;177;219;148060;144843;6424;87.9;86.0;3.8
32;2021-10-14;95;256;439;148155;145099;6863;87.9;86.1;4.1
32;2021-10-15;81;160;286;148236;145259;7149;88.0;86.2;4.2
32;2021-10-16;44;71;61;148280;145330;7210;88.0;86.3;4.3
32;2021-10-17;2;2;0;148282;145332;7210;88.0;86.3;4.3
32;2021-10-18;19;33;67;148301;145365;7277;88.0;86.3;4.3
32;2021-10-19;81;125;406;148382;145490;7683;88.1;86.4;4.6
32;2021-10-20;44;68;334;148426;145558;8017;88.1;86.4;4.8
32;2021-10-21;48;191;444;148474;145749;8461;88.1;86.5;5.0
32;2021-10-22;55;121;288;148529;145870;8749;88.2;86.6;5.2
32;2021-10-23;40;48;89;148569;145918;8838;88.2;86.6;5.2
32;2021-10-24;3;2;1;148572;145920;8839;88.2;86.6;5.2
32;2021-10-25;17;31;56;148589;145951;8895;88.2;86.6;5.3
32;2021-10-26;59;72;469;148648;146023;9364;88.2;86.7;5.6
32;2021-10-27;36;59;212;148684;146082;9576;88.3;86.7;5.7
32;2021-10-28;53;62;374;148737;146144;9950;88.3;86.7;5.9
32;2021-10-29;59;77;236;148796;146221;10186;88.3;86.8;6.0
32;2021-10-30;33;40;51;148829;146261;10237;88.3;86.8;6.1
32;2021-10-31;0;1;3;148829;146262;10240;88.3;86.8;6.1
32;2021-11-01;4;1;2;148833;146263;10242;88.3;86.8;6.1
32;2021-11-02;53;67;368;148886;146330;10610;88.4;86.9;6.3
32;2021-11-03;40;52;254;148926;146382;10864;88.4;86.9;6.4
32;2021-11-04;40;63;461;148966;146445;11325;88.4;86.9;6.7
32;2021-11-05;44;73;401;149010;146518;11726;88.4;87.0;7.0
32;2021-11-06;28;54;96;149038;146572;11822;88.5;87.0;7.0
32;2021-11-07;3;11;14;149041;146583;11836;88.5;87.0;7.0
32;2021-11-08;34;46;239;149075;146629;12075;88.5;87.0;7.2
32;2021-11-09;68;97;884;149143;146726;12959;88.5;87.1;7.7
32;2021-11-10;53;77;563;149196;146803;13522;88.6;87.1;8.0
32;2021-11-11;10;10;20;149206;146813;13542;88.6;87.1;8.0
32;2021-11-12;57;80;662;149263;146893;14204;88.6;87.2;8.4
32;2021-11-13;25;32;124;149288;146925;14328;88.6;87.2;8.5
32;2021-11-14;0;3;1;149288;146928;14329;88.6;87.2;8.5
32;2021-11-15;32;25;520;149320;146953;14849;88.6;87.2;8.8
32;2021-11-16;79;95;1272;149399;147048;16121;88.7;87.3;9.6
32;2021-11-17;66;63;774;149465;147111;16895;88.7;87.3;10.0
32;2021-11-18;50;65;1107;149515;147176;18002;88.7;87.4;10.7
32;2021-11-19;78;96;928;149593;147272;18930;88.8;87.4;11.2
32;2021-11-20;43;59;281;149636;147331;19211;88.8;87.5;11.4
32;2021-11-21;3;5;2;149639;147336;19213;88.8;87.5;11.4
32;2021-11-22;27;33;454;149666;147369;19667;88.8;87.5;11.7
32;2021-11-23;73;55;1307;149739;147424;20974;88.9;87.5;12.4
32;2021-11-24;55;53;776;149794;147477;21750;88.9;87.5;12.9
32;2021-11-25;68;59;1371;149862;147536;23121;89.0;87.6;13.7
32;2021-11-26;93;70;1633;149955;147606;24754;89.0;87.6;14.7
32;2021-11-27;58;39;746;150013;147645;25500;89.0;87.6;15.1
32;2021-11-28;1;5;15;150014;147650;25515;89.0;87.6;15.1
32;2021-11-29;45;42;1099;150059;147692;26614;89.1;87.7;15.8
32;2021-11-30;93;69;2541;150152;147761;29155;89.1;87.7;17.3
32;2021-12-01;59;63;1912;150211;147824;31067;89.2;87.7;18.4
32;2021-12-02;53;42;2618;150264;147866;33685;89.2;87.8;20.0
32;2021-12-03;48;62;1873;150312;147928;35558;89.2;87.8;21.1
32;2021-12-04;28;33;562;150340;147961;36120;89.2;87.8;21.4
32;2021-12-05;6;5;102;150346;147966;36222;89.2;87.8;21.5
32;2021-12-06;44;35;1684;150390;148001;37906;89.3;87.8;22.5
32;2021-12-07;86;88;3696;150476;148089;41602;89.3;87.9;24.7
32;2021-12-08;95;87;3039;150571;148176;44641;89.4;88.0;26.5
32;2021-12-09;70;50;2830;150641;148226;47471;89.4;88.0;28.2
32;2021-12-10;66;79;2639;150707;148305;50110;89.5;88.0;29.7
32;2021-12-11;31;43;730;150738;148348;50840;89.5;88.1;30.2
32;2021-12-12;2;5;119;150740;148353;50959;89.5;88.1;30.2
32;2021-12-13;65;39;2061;150805;148392;53020;89.5;88.1;31.5
32;2021-12-14;100;91;3625;150905;148483;56645;89.6;88.1;33.6
32;2021-12-15;80;74;2725;150985;148557;59370;89.6;88.2;35.2
32;2021-12-16;78;84;3203;151063;148641;62573;89.7;88.2;37.1
32;2021-12-17;90;98;2333;151153;148739;64906;89.7;88.3;38.5
32;2021-12-18;51;62;865;151204;148801;65771;89.8;88.3;39.0
32;2021-12-19;7;5;137;151211;148806;65908;89.8;88.3;39.1
33;2020-12-27;2;0;0;2;0;0;0.0;0.0;0.0
33;2020-12-28;2;0;0;4;0;0;0.0;0.0;0.0
33;2020-12-29;0;0;0;4;0;0;0.0;0.0;0.0
33;2020-12-30;3;0;0;7;0;0;0.0;0.0;0.0
33;2020-12-31;1;0;0;8;0;0;0.0;0.0;0.0
33;2021-01-01;1;0;0;9;0;0;0.0;0.0;0.0
33;2021-01-02;1;1;0;10;1;0;0.0;0.0;0.0
33;2021-01-03;1;0;0;11;1;0;0.0;0.0;0.0
33;2021-01-04;2;0;0;13;1;0;0.0;0.0;0.0
33;2021-01-05;3;0;0;16;1;0;0.0;0.0;0.0
33;2021-01-06;149;1;0;165;2;0;0.0;0.0;0.0
33;2021-01-07;1344;4;0;1509;6;0;0.1;0.0;0.0
33;2021-01-08;1204;3;0;2713;9;0;0.2;0.0;0.0
33;2021-01-09;296;1;0;3009;10;0;0.2;0.0;0.0
33;2021-01-10;225;0;0;3234;10;0;0.2;0.0;0.0
33;2021-01-11;650;0;0;3884;10;0;0.3;0.0;0.0
33;2021-01-12;1437;2;0;5321;12;0;0.4;0.0;0.0
33;2021-01-13;1376;9;0;6697;21;0;0.5;0.0;0.0
33;2021-01-14;1341;16;0;8038;37;0;0.6;0.0;0.0
33;2021-01-15;1597;16;0;9635;53;0;0.7;0.0;0.0
33;2021-01-16;567;9;0;10202;62;0;0.7;0.0;0.0
33;2021-01-17;403;4;0;10605;66;0;0.7;0.0;0.0
33;2021-01-18;1224;13;0;11829;79;0;0.8;0.0;0.0
33;2021-01-19;2961;11;0;14790;90;0;1.0;0.0;0.0
33;2021-01-20;3343;16;0;18133;106;0;1.3;0.0;0.0
33;2021-01-21;2856;5;0;20989;111;0;1.5;0.0;0.0
33;2021-01-22;2305;8;0;23294;119;0;1.6;0.0;0.0
33;2021-01-23;846;3;0;24140;122;0;1.7;0.0;0.0
33;2021-01-24;508;2;0;24648;124;0;1.7;0.0;0.0
33;2021-01-25;2139;62;0;26787;186;0;1.9;0.0;0.0
33;2021-01-26;2287;166;0;29074;352;0;2.1;0.0;0.0
33;2021-01-27;2330;213;0;31404;565;0;2.2;0.0;0.0
33;2021-01-28;2212;481;0;33616;1046;0;2.4;0.1;0.0
33;2021-01-29;1778;706;0;35394;1752;0;2.5;0.1;0.0
33;2021-01-30;710;171;0;36104;1923;0;2.6;0.1;0.0
33;2021-01-31;370;155;0;36474;2078;0;2.6;0.1;0.0
33;2021-02-01;1353;659;0;37827;2737;0;2.7;0.2;0.0
33;2021-02-02;2562;1113;0;40389;3850;0;2.9;0.3;0.0
33;2021-02-03;2782;885;0;43171;4735;0;3.1;0.3;0.0
33;2021-02-04;3906;1346;0;47077;6081;0;3.3;0.4;0.0
33;2021-02-05;2139;1163;0;49216;7244;0;3.5;0.5;0.0
33;2021-02-06;650;204;0;49866;7448;0;3.5;0.5;0.0
33;2021-02-07;224;229;0;50090;7677;0;3.5;0.5;0.0
33;2021-02-08;1224;758;0;51314;8435;0;3.6;0.6;0.0
33;2021-02-09;1346;1660;0;52660;10095;0;3.7;0.7;0.0
33;2021-02-10;1286;1696;0;53946;11791;0;3.8;0.8;0.0
33;2021-02-11;1312;1518;0;55258;13309;0;3.9;0.9;0.0
33;2021-02-12;1172;1277;0;56430;14586;0;4.0;1.0;0.0
33;2021-02-13;223;300;0;56653;14886;0;4.0;1.1;0.0
33;2021-02-14;32;238;0;56685;15124;0;4.0;1.1;0.0
33;2021-02-15;684;1700;0;57369;16824;0;4.1;1.2;0.0
33;2021-02-16;836;2053;0;58205;18877;0;4.1;1.3;0.0
33;2021-02-17;727;2081;0;58932;20958;0;4.2;1.5;0.0
33;2021-02-18;930;2225;0;59862;23183;0;4.2;1.6;0.0
33;2021-02-19;923;1987;0;60785;25170;0;4.3;1.8;0.0
33;2021-02-20;83;656;0;60868;25826;0;4.3;1.8;0.0
33;2021-02-21;36;449;0;60904;26275;0;4.3;1.9;0.0
33;2021-02-22;685;1886;0;61589;28161;0;4.4;2.0;0.0
33;2021-02-23;1191;2725;0;62780;30886;0;4.4;2.2;0.0
33;2021-02-24;1321;2502;0;64101;33388;0;4.5;2.4;0.0
33;2021-02-25;2765;3692;0;66866;37080;0;4.7;2.6;0.0
33;2021-02-26;3954;2313;0;70820;39393;0;5.0;2.8;0.0
33;2021-02-27;1338;721;0;72158;40114;0;5.1;2.8;0.0
33;2021-02-28;116;488;0;72274;40602;0;5.1;2.9;0.0
33;2021-03-01;1487;1789;0;73761;42391;0;5.2;3.0;0.0
33;2021-03-02;2276;1753;0;76037;44144;0;5.4;3.1;0.0
33;2021-03-03;2269;1748;0;78306;45892;0;5.5;3.2;0.0
33;2021-03-04;3866;1663;0;82172;47555;0;5.8;3.4;0.0
33;2021-03-05;5683;1776;0;87855;49331;0;6.2;3.5;0.0
33;2021-03-06;3425;561;0;91280;49892;0;6.4;3.5;0.0
33;2021-03-07;786;158;0;92066;50050;0;6.5;3.5;0.0
33;2021-03-08;2606;1140;0;94672;51190;0;6.7;3.6;0.0
33;2021-03-09;4378;1342;0;99050;52532;0;7.0;3.7;0.0
33;2021-03-10;5051;1278;0;104101;53810;0;7.4;3.8;0.0
33;2021-03-11;7372;1264;0;111473;55074;0;7.9;3.9;0.0
33;2021-03-12;9839;1196;0;121312;56270;0;8.6;4.0;0.0
33;2021-03-13;5075;233;0;126387;56503;0;8.9;4.0;0.0
33;2021-03-14;698;27;0;127085;56530;0;9.0;4.0;0.0
33;2021-03-15;4235;674;0;131320;57204;0;9.3;4.0;0.0
33;2021-03-16;3462;873;0;134782;58077;0;9.5;4.1;0.0
33;2021-03-17;3593;948;0;138375;59025;0;9.8;4.2;0.0
33;2021-03-18;3924;1416;0;142299;60441;0;10.1;4.3;0.0
33;2021-03-19;6096;1044;0;148395;61485;0;10.5;4.3;0.0
33;2021-03-20;3293;118;0;151688;61603;0;10.7;4.4;0.0
33;2021-03-21;460;29;0;152148;61632;0;10.7;4.4;0.0
33;2021-03-22;4674;456;0;156822;62088;0;11.1;4.4;0.0
33;2021-03-23;6017;596;0;162839;62684;0;11.5;4.4;0.0
33;2021-03-24;6926;545;0;169765;63229;0;12.0;4.5;0.0
33;2021-03-25;8667;643;0;178432;63872;0;12.6;4.5;0.0
33;2021-03-26;9821;848;0;188253;64720;0;13.3;4.6;0.0
33;2021-03-27;3558;88;0;191811;64808;0;13.6;4.6;0.0
33;2021-03-28;580;31;0;192391;64839;0;13.6;4.6;0.0
33;2021-03-29;6560;688;0;198951;65527;0;14.1;4.6;0.0
33;2021-03-30;7842;1021;0;206793;66548;0;14.6;4.7;0.0
33;2021-03-31;7385;1070;0;214178;67618;0;15.1;4.8;0.0
33;2021-04-01;8594;1168;0;222772;68786;0;15.7;4.9;0.0
33;2021-04-02;8158;1526;0;230930;70312;0;16.3;5.0;0.0
33;2021-04-03;2796;550;0;233726;70862;0;16.5;5.0;0.0
33;2021-04-04;232;165;0;233958;71027;0;16.5;5.0;0.0
33;2021-04-05;762;117;0;234720;71144;0;16.6;5.0;0.0
33;2021-04-06;5852;2606;0;240572;73750;0;17.0;5.2;0.0
33;2021-04-07;7188;2543;0;247760;76293;0;17.5;5.4;0.0
33;2021-04-08;10013;2708;0;257773;79001;0;18.2;5.6;0.0
33;2021-04-09;12352;3010;0;270125;82011;0;19.1;5.8;0.0
33;2021-04-10;5214;1370;0;275339;83381;0;19.5;5.9;0.0
33;2021-04-11;993;343;0;276332;83724;0;19.5;5.9;0.0
33;2021-04-12;7238;3127;0;283570;86851;0;20.0;6.1;0.0
33;2021-04-13;9079;3378;0;292649;90229;0;20.7;6.4;0.0
33;2021-04-14;8795;3610;0;301444;93839;0;21.3;6.6;0.0
33;2021-04-15;9898;3769;0;311342;97608;0;22.0;6.9;0.0
33;2021-04-16;9471;4073;0;320813;101681;0;22.7;7.2;0.0
33;2021-04-17;4537;1607;0;325350;103288;0;23.0;7.3;0.0
33;2021-04-18;932;410;0;326282;103698;0;23.1;7.3;0.0
33;2021-04-19;5399;3629;0;331681;107327;0;23.4;7.6;0.0
33;2021-04-20;7092;4111;0;338773;111438;0;23.9;7.9;0.0
33;2021-04-21;6374;4224;0;345147;115662;0;24.4;8.2;0.0
33;2021-04-22;7120;4323;0;352267;119985;0;24.9;8.5;0.0
33;2021-04-23;7483;4636;0;359750;124621;0;25.4;8.8;0.0
33;2021-04-24;4421;1748;0;364171;126369;0;25.7;8.9;0.0
33;2021-04-25;1603;424;0;365774;126793;0;25.8;9.0;0.0
33;2021-04-26;4999;4921;0;370773;131714;0;26.2;9.3;0.0
33;2021-04-27;6378;5500;0;377151;137214;0;26.6;9.7;0.0
33;2021-04-28;6538;5366;0;383689;142580;0;27.1;10.1;0.0
33;2021-04-29;8126;6077;0;391815;148657;0;27.7;10.5;0.0
33;2021-04-30;8485;6003;0;400300;154660;0;28.3;10.9;0.0
33;2021-05-01;2844;575;0;403144;155235;0;28.5;11.0;0.0
33;2021-05-02;1802;346;0;404946;155581;0;28.6;11.0;0.0
33;2021-05-03;6811;5067;0;411757;160648;0;29.1;11.3;0.0
33;2021-05-04;6638;6444;0;418395;167092;0;29.6;11.8;0.0
33;2021-05-05;7076;7348;0;425471;174440;0;30.1;12.3;0.0
33;2021-05-06;8384;8072;0;433855;182512;0;30.7;12.9;0.0
33;2021-05-07;8430;8687;0;442285;191199;0;31.2;13.5;0.0
33;2021-05-08;3540;1600;0;445825;192799;0;31.5;13.6;0.0
33;2021-05-09;1139;976;0;446964;193775;0;31.6;13.7;0.0
33;2021-05-10;6597;7101;0;453561;200876;0;32.0;14.2;0.0
33;2021-05-11;8447;7661;0;462008;208537;0;32.6;14.7;0.0
33;2021-05-12;9027;6501;0;471035;215038;0;33.3;15.2;0.0
33;2021-05-13;5330;2063;0;476365;217101;0;33.7;15.3;0.0
33;2021-05-14;8253;5221;0;484618;222322;0;34.2;15.7;0.0
33;2021-05-15;5316;2846;0;489934;225168;0;34.6;15.9;0.0
33;2021-05-16;1938;791;0;491872;225959;0;34.8;16.0;0.0
33;2021-05-17;8762;4927;0;500634;230886;0;35.4;16.3;0.0
33;2021-05-18;10633;4727;0;511267;235613;0;36.1;16.6;0.0
33;2021-05-19;10893;4691;0;522160;240304;0;36.9;17.0;0.0
33;2021-05-20;11080;5451;0;533240;245755;0;37.7;17.4;0.0
33;2021-05-21;11040;6135;0;544280;251890;0;38.5;17.8;0.0
33;2021-05-22;5573;2724;0;549853;254614;0;38.8;18.0;0.0
33;2021-05-23;2058;402;0;551911;255016;0;39.0;18.0;0.0
33;2021-05-24;5851;1008;0;557762;256024;0;39.4;18.1;0.0
33;2021-05-25;9812;5636;0;567574;261660;0;40.1;18.5;0.0
33;2021-05-26;9921;5919;0;577495;267579;0;40.8;18.9;0.0
33;2021-05-27;11103;7629;0;588598;275208;0;41.6;19.4;0.0
33;2021-05-28;10185;9402;0;598783;284610;0;42.3;20.1;0.0
33;2021-05-29;5507;4087;0;604290;288697;0;42.7;20.4;0.0
33;2021-05-30;1997;678;0;606287;289375;0;42.8;20.4;0.0
33;2021-05-31;8570;6270;0;614857;295645;0;43.4;20.9;0.0
33;2021-06-01;11782;8525;0;626639;304170;0;44.3;21.5;0.0
33;2021-06-02;11767;8012;0;638406;312182;0;45.1;22.1;0.0
33;2021-06-03;12780;9059;0;651186;321241;0;46.0;22.7;0.0
33;2021-06-04;13056;10671;0;664242;331912;0;46.9;23.4;0.0
33;2021-06-05;5761;5013;0;670003;336925;0;47.3;23.8;0.0
33;2021-06-06;2616;1188;0;672619;338113;0;47.5;23.9;0.0
33;2021-06-07;9655;8185;0;682274;346298;0;48.2;24.5;0.0
33;2021-06-08;11671;9138;0;693945;355436;0;49.0;25.1;0.0
33;2021-06-09;11611;8352;0;705556;363788;0;49.8;25.7;0.0
33;2021-06-10;12815;8232;0;718371;372020;0;50.8;26.3;0.0
33;2021-06-11;12430;10842;0;730801;382862;0;51.6;27.0;0.0
33;2021-06-12;6496;4444;0;737297;387306;0;52.1;27.4;0.0
33;2021-06-13;2739;1316;0;740036;388622;0;52.3;27.5;0.0
33;2021-06-14;8340;9858;0;748376;398480;0;52.9;28.2;0.0
33;2021-06-15;11612;9996;1;759988;408476;1;53.7;28.9;0.0
33;2021-06-16;11617;8743;0;771605;417219;1;54.5;29.5;0.0
33;2021-06-17;12722;9387;0;784327;426606;1;55.4;30.1;0.0
33;2021-06-18;11434;11167;0;795761;437773;1;56.2;30.9;0.0
33;2021-06-19;5693;4877;0;801454;442650;1;56.6;31.3;0.0
33;2021-06-20;2873;1494;0;804327;444144;1;56.8;31.4;0.0
33;2021-06-21;7648;9868;0;811975;454012;1;57.4;32.1;0.0
33;2021-06-22;8629;10946;0;820604;464958;1;58.0;32.8;0.0
33;2021-06-23;8352;10671;0;828956;475629;1;58.6;33.6;0.0
33;2021-06-24;9295;9828;0;838251;485457;1;59.2;34.3;0.0
33;2021-06-25;7626;13504;0;845877;498961;1;59.8;35.3;0.0
33;2021-06-26;4239;6128;0;850116;505089;1;60.1;35.7;0.0
33;2021-06-27;2362;2071;0;852478;507160;1;60.2;35.8;0.0
33;2021-06-28;4626;12673;0;857104;519833;1;60.6;36.7;0.0
33;2021-06-29;6164;13428;0;863268;533261;1;61.0;37.7;0.0
33;2021-06-30;6427;13196;0;869695;546457;1;61.4;38.6;0.0
33;2021-07-01;7799;11736;0;877494;558193;1;62.0;39.4;0.0
33;2021-07-02;6674;15075;0;884168;573268;1;62.5;40.5;0.0
33;2021-07-03;3198;7221;0;887366;580489;1;62.7;41.0;0.0
33;2021-07-04;1969;2501;0;889335;582990;1;62.8;41.2;0.0
33;2021-07-05;4209;12784;0;893544;595774;1;63.1;42.1;0.0
33;2021-07-06;5812;14434;0;899356;610208;1;63.5;43.1;0.0
33;2021-07-07;6460;12948;0;905816;623156;1;64.0;44.0;0.0
33;2021-07-08;7554;12717;0;913370;635873;1;64.5;44.9;0.0
33;2021-07-09;6153;14970;0;919523;650843;1;65.0;46.0;0.0
33;2021-07-10;3114;7459;0;922637;658302;1;65.2;46.5;0.0
33;2021-07-11;1777;2384;0;924414;660686;1;65.3;46.7;0.0
33;2021-07-12;3815;14568;3;928229;675254;4;65.6;47.7;0.0
33;2021-07-13;6944;15896;1;935173;691150;5;66.1;48.8;0.0
33;2021-07-14;3889;5403;0;939062;696553;5;66.3;49.2;0.0
33;2021-07-15;7445;15738;0;946507;712291;5;66.9;50.3;0.0
33;2021-07-16;8286;14992;0;954793;727283;5;67.5;51.4;0.0
33;2021-07-17;3531;6764;0;958324;734047;5;67.7;51.9;0.0
33;2021-07-18;1757;3217;0;960081;737264;5;67.8;52.1;0.0
33;2021-07-19;5807;14859;0;965888;752123;5;68.2;53.1;0.0
33;2021-07-20;7452;15802;0;973340;767925;5;68.8;54.3;0.0
33;2021-07-21;8283;14293;0;981623;782218;5;69.4;55.3;0.0
33;2021-07-22;9229;14762;0;990852;796980;5;70.0;56.3;0.0
33;2021-07-23;9468;16104;0;1000320;813084;5;70.7;57.4;0.0
33;2021-07-24;4139;7678;0;1004459;820762;5;71.0;58.0;0.0
33;2021-07-25;2170;2682;0;1006629;823444;5;71.1;58.2;0.0
33;2021-07-26;6907;13088;0;1013536;836532;5;71.6;59.1;0.0
33;2021-07-27;9767;12983;0;1023303;849515;5;72.3;60.0;0.0
33;2021-07-28;10640;11595;0;1033943;861110;5;73.0;60.8;0.0
33;2021-07-29;11420;11558;0;1045363;872668;5;73.9;61.7;0.0
33;2021-07-30;11028;11849;0;1056391;884517;5;74.6;62.5;0.0
33;2021-07-31;4838;5778;0;1061229;890295;5;75.0;62.9;0.0
33;2021-08-01;2521;1936;0;1063750;892231;5;75.2;63.0;0.0
33;2021-08-02;8320;9536;0;1072070;901767;5;75.7;63.7;0.0
33;2021-08-03;11100;8667;0;1083170;910434;5;76.5;64.3;0.0
33;2021-08-04;11228;7067;0;1094398;917501;5;77.3;64.8;0.0
33;2021-08-05;11344;7681;0;1105742;925182;5;78.1;65.4;0.0
33;2021-08-06;10522;8572;0;1116264;933754;5;78.9;66.0;0.0
33;2021-08-07;5739;4434;0;1122003;938188;5;79.3;66.3;0.0
33;2021-08-08;2943;1698;0;1124946;939886;5;79.5;66.4;0.0
33;2021-08-09;8166;8318;0;1133112;948204;5;80.1;67.0;0.0
33;2021-08-10;8806;7981;1;1141918;956185;6;80.7;67.6;0.0
33;2021-08-11;7511;7093;1;1149429;963278;7;81.2;68.1;0.0
33;2021-08-12;7477;7585;0;1156906;970863;7;81.7;68.6;0.0
33;2021-08-13;7217;7228;0;1164123;978091;7;82.2;69.1;0.0
33;2021-08-14;3347;4224;0;1167470;982315;7;82.5;69.4;0.0
33;2021-08-15;1035;1517;0;1168505;983832;7;82.6;69.5;0.0
33;2021-08-16;5946;8118;0;1174451;991950;7;83.0;70.1;0.0
33;2021-08-17;6069;8654;1;1180520;1000604;8;83.4;70.7;0.0
33;2021-08-18;5091;8346;0;1185611;1008950;8;83.8;71.3;0.0
33;2021-08-19;5165;8828;0;1190776;1017778;8;84.1;71.9;0.0
33;2021-08-20;4619;9319;0;1195395;1027097;8;84.5;72.6;0.0
33;2021-08-21;2020;4898;0;1197415;1031995;8;84.6;72.9;0.0
33;2021-08-22;544;2256;0;1197959;1034251;8;84.6;73.1;0.0
33;2021-08-23;3569;9772;0;1201528;1044023;8;84.9;73.8;0.0
33;2021-08-24;3862;10534;0;1205390;1054557;8;85.2;74.5;0.0
33;2021-08-25;3423;9922;0;1208813;1064479;8;85.4;75.2;0.0
33;2021-08-26;3345;10573;0;1212158;1075052;8;85.6;76.0;0.0
33;2021-08-27;3503;11908;0;1215661;1086960;8;85.9;76.8;0.0
33;2021-08-28;1506;6436;0;1217167;1093396;8;86.0;77.2;0.0
33;2021-08-29;401;2279;0;1217568;1095675;8;86.0;77.4;0.0
33;2021-08-30;2200;10002;69;1219768;1105677;77;86.2;78.1;0.0
33;2021-08-31;2976;10246;217;1222744;1115923;294;86.4;78.8;0.0
33;2021-09-01;2861;7926;609;1225605;1123849;903;86.6;79.4;0.1
33;2021-09-02;2561;7339;633;1228166;1131188;1536;86.8;79.9;0.1
33;2021-09-03;2887;8785;805;1231053;1139973;2341;87.0;80.5;0.2
33;2021-09-04;1577;5598;276;1232630;1145571;2617;87.1;80.9;0.2
33;2021-09-05;379;1294;61;1233009;1146865;2678;87.1;81.0;0.2
33;2021-09-06;1547;6014;757;1234556;1152879;3435;87.2;81.5;0.2
33;2021-09-07;1919;5292;889;1236475;1158171;4324;87.4;81.8;0.3
33;2021-09-08;1702;5558;695;1238177;1163729;5019;87.5;82.2;0.4
33;2021-09-09;1702;5171;1148;1239879;1168900;6167;87.6;82.6;0.4
33;2021-09-10;1960;5682;1089;1241839;1174582;7256;87.7;83.0;0.5
33;2021-09-11;986;3908;269;1242825;1178490;7525;87.8;83.3;0.5
33;2021-09-12;125;471;52;1242950;1178961;7577;87.8;83.3;0.5
33;2021-09-13;1361;3294;1269;1244311;1182255;8846;87.9;83.5;0.6
33;2021-09-14;1408;3228;1936;1245719;1185483;10782;88.0;83.8;0.8
33;2021-09-15;1460;4171;1436;1247179;1189654;12218;88.1;84.1;0.9
33;2021-09-16;1371;3071;1957;1248550;1192725;14175;88.2;84.3;1.0
33;2021-09-17;1659;4207;1564;1250209;1196932;15739;88.3;84.6;1.1
33;2021-09-18;622;2924;342;1250831;1199856;16081;88.4;84.8;1.1
33;2021-09-19;109;355;26;1250940;1200211;16107;88.4;84.8;1.1
33;2021-09-20;959;1992;1363;1251899;1202203;17470;88.4;84.9;1.2
33;2021-09-21;894;2286;1749;1252793;1204489;19219;88.5;85.1;1.4
33;2021-09-22;900;3270;1418;1253693;1207759;20637;88.6;85.3;1.5
33;2021-09-23;838;2170;1491;1254531;1209929;22128;88.6;85.5;1.6
33;2021-09-24;1188;3478;1663;1255719;1213407;23791;88.7;85.7;1.7
33;2021-09-25;529;2285;382;1256248;1215692;24173;88.8;85.9;1.7
33;2021-09-26;70;312;34;1256318;1216004;24207;88.8;85.9;1.7
33;2021-09-27;595;1850;1106;1256913;1217854;25313;88.8;86.0;1.8
33;2021-09-28;761;1942;1542;1257674;1219796;26855;88.9;86.2;1.9
33;2021-09-29;840;2089;1084;1258514;1221885;27939;88.9;86.3;2.0
33;2021-09-30;649;1537;1398;1259163;1223422;29337;89.0;86.4;2.1
33;2021-10-01;1185;2475;1322;1260348;1225897;30659;89.0;86.6;2.2
33;2021-10-02;577;1328;447;1260925;1227225;31106;89.1;86.7;2.2
33;2021-10-03;14;51;4;1260939;1227276;31110;89.1;86.7;2.2
33;2021-10-04;658;1273;1379;1261597;1228549;32489;89.1;86.8;2.3
33;2021-10-05;583;1336;1342;1262180;1229885;33831;89.2;86.9;2.4
33;2021-10-06;749;1605;1310;1262929;1231490;35141;89.2;87.0;2.5
33;2021-10-07;552;1363;1543;1263481;1232853;36684;89.3;87.1;2.6
33;2021-10-08;850;1976;1685;1264331;1234829;38369;89.3;87.2;2.7
33;2021-10-09;514;964;582;1264845;1235793;38951;89.4;87.3;2.8
33;2021-10-10;15;45;14;1264860;1235838;38965;89.4;87.3;2.8
33;2021-10-11;491;1027;1636;1265351;1236865;40601;89.4;87.4;2.9
33;2021-10-12;558;1113;1734;1265909;1237978;42335;89.4;87.5;3.0
33;2021-10-13;729;1275;1640;1266638;1239253;43975;89.5;87.6;3.1
33;2021-10-14;521;1048;1875;1267159;1240301;45850;89.5;87.6;3.2
33;2021-10-15;873;1483;2533;1268032;1241784;48383;89.6;87.7;3.4
33;2021-10-16;443;683;667;1268475;1242467;49050;89.6;87.8;3.5
33;2021-10-17;27;35;20;1268502;1242502;49070;89.6;87.8;3.5
33;2021-10-18;537;644;1788;1269039;1243146;50858;89.7;87.8;3.6
33;2021-10-19;574;929;1844;1269613;1244075;52702;89.7;87.9;3.7
33;2021-10-20;600;1009;2118;1270213;1245084;54820;89.7;88.0;3.9
33;2021-10-21;499;726;1975;1270712;1245810;56795;89.8;88.0;4.0
33;2021-10-22;727;1252;2631;1271439;1247062;59426;89.8;88.1;4.2
33;2021-10-23;379;656;726;1271818;1247718;60152;89.9;88.2;4.2
33;2021-10-24;19;27;8;1271837;1247745;60160;89.9;88.2;4.3
33;2021-10-25;503;673;2146;1272340;1248418;62306;89.9;88.2;4.4
33;2021-10-26;465;588;2240;1272805;1249006;64546;89.9;88.2;4.6
33;2021-10-27;584;857;2698;1273389;1249863;67244;90.0;88.3;4.8
33;2021-10-28;452;554;2381;1273841;1250417;69625;90.0;88.3;4.9
33;2021-10-29;604;850;3238;1274445;1251267;72863;90.0;88.4;5.1
33;2021-10-30;298;422;895;1274743;1251689;73758;90.1;88.4;5.2
33;2021-10-31;12;25;22;1274755;1251714;73780;90.1;88.4;5.2
33;2021-11-01;99;65;81;1274854;1251779;73861;90.1;88.4;5.2
33;2021-11-02;484;710;2387;1275338;1252489;76248;90.1;88.5;5.4
33;2021-11-03;518;686;2593;1275856;1253175;78841;90.1;88.5;5.6
33;2021-11-04;428;568;3167;1276284;1253743;82008;90.2;88.6;5.8
33;2021-11-05;580;825;3838;1276864;1254568;85846;90.2;88.6;6.1
33;2021-11-06;266;414;1020;1277130;1254982;86866;90.2;88.7;6.1
33;2021-11-07;14;34;37;1277144;1255016;86903;90.2;88.7;6.1
33;2021-11-08;390;702;3370;1277534;1255718;90273;90.3;88.7;6.4
33;2021-11-09;513;724;4470;1278047;1256442;94743;90.3;88.8;6.7
33;2021-11-10;488;700;4629;1278535;1257142;99372;90.3;88.8;7.0
33;2021-11-11;115;100;392;1278650;1257242;99764;90.3;88.8;7.0
33;2021-11-12;552;761;4599;1279202;1258003;104363;90.4;88.9;7.4
33;2021-11-13;371;387;1481;1279573;1258390;105844;90.4;88.9;7.5
33;2021-11-14;27;48;99;1279600;1258438;105943;90.4;88.9;7.5
33;2021-11-15;445;557;4371;1280045;1258995;110314;90.4;88.9;7.8
33;2021-11-16;514;683;5469;1280559;1259678;115783;90.5;89.0;8.2
33;2021-11-17;490;613;4996;1281049;1260291;120779;90.5;89.0;8.5
33;2021-11-18;521;543;5728;1281570;1260834;126507;90.5;89.1;8.9
33;2021-11-19;720;873;6974;1282290;1261707;133481;90.6;89.1;9.4
33;2021-11-20;367;414;2010;1282657;1262121;135491;90.6;89.2;9.6
33;2021-11-21;19;41;162;1282676;1262162;135653;90.6;89.2;9.6
33;2021-11-22;500;444;4819;1283176;1262606;140472;90.7;89.2;9.9
33;2021-11-23;544;549;6774;1283720;1263155;147246;90.7;89.2;10.4
33;2021-11-24;550;560;5784;1284270;1263715;153030;90.7;89.3;10.8
33;2021-11-25;537;455;7444;1284807;1264170;160474;90.8;89.3;11.3
33;2021-11-26;695;790;10622;1285502;1264960;171096;90.8;89.4;12.1
33;2021-11-27;388;434;4568;1285890;1265394;175664;90.8;89.4;12.4
33;2021-11-28;33;70;1033;1285923;1265464;176697;90.9;89.4;12.5
33;2021-11-29;462;550;9402;1286385;1266014;186099;90.9;89.4;13.1
33;2021-11-30;560;656;12388;1286945;1266670;198487;90.9;89.5;14.0
33;2021-12-01;512;571;11595;1287457;1267241;210082;91.0;89.5;14.8
33;2021-12-02;424;411;14779;1287881;1267652;224861;91.0;89.6;15.9
33;2021-12-03;489;731;16161;1288370;1268383;241022;91.0;89.6;17.0
33;2021-12-04;289;429;7240;1288659;1268812;248262;91.0;89.6;17.5
33;2021-12-05;70;80;2222;1288729;1268892;250484;91.0;89.6;17.7
33;2021-12-06;343;495;12947;1289072;1269387;263431;91.1;89.7;18.6
33;2021-12-07;421;582;16733;1289493;1269969;280164;91.1;89.7;19.8
33;2021-12-08;433;524;15747;1289926;1270493;295911;91.1;89.8;20.9
33;2021-12-09;467;667;18224;1290393;1271160;314135;91.2;89.8;22.2
33;2021-12-10;515;740;19869;1290908;1271900;334004;91.2;89.9;23.6
33;2021-12-11;404;477;10993;1291312;1272377;344997;91.2;89.9;24.4
33;2021-12-12;71;77;2910;1291383;1272454;347907;91.2;89.9;24.6
33;2021-12-13;451;620;17022;1291834;1273074;364929;91.3;89.9;25.8
33;2021-12-14;500;665;21888;1292334;1273739;386817;91.3;90.0;27.3
33;2021-12-15;593;706;20738;1292927;1274445;407555;91.3;90.0;28.8
33;2021-12-16;597;724;22752;1293524;1275169;430307;91.4;90.1;30.4
33;2021-12-17;640;885;24008;1294164;1276054;454315;91.4;90.2;32.1
33;2021-12-18;429;452;11477;1294593;1276506;465792;91.5;90.2;32.9
33;2021-12-19;110;100;3503;1294703;1276606;469295;91.5;90.2;33.2
34;2020-12-27;0;0;0;0;0;0;0.0;0.0;0.0
34;2020-12-28;1;0;0;1;0;0;0.0;0.0;0.0
34;2020-12-29;1;0;0;2;0;0;0.0;0.0;0.0
34;2020-12-30;0;0;0;2;0;0;0.0;0.0;0.0
34;2020-12-31;0;0;0;2;0;0;0.0;0.0;0.0
34;2021-01-01;4;0;0;6;0;0;0.0;0.0;0.0
34;2021-01-02;0;0;0;6;0;0;0.0;0.0;0.0
34;2021-01-03;0;0;0;6;0;0;0.0;0.0;0.0
34;2021-01-04;22;0;0;28;0;0;0.0;0.0;0.0
34;2021-01-05;112;2;0;140;2;0;0.0;0.0;0.0
34;2021-01-06;186;5;0;326;7;0;0.0;0.0;0.0
34;2021-01-07;390;0;0;716;7;0;0.1;0.0;0.0
34;2021-01-08;626;0;0;1342;7;0;0.1;0.0;0.0
34;2021-01-09;254;1;0;1596;8;0;0.2;0.0;0.0
34;2021-01-10;92;1;0;1688;9;0;0.2;0.0;0.0
34;2021-01-11;589;2;0;2277;11;0;0.2;0.0;0.0
34;2021-01-12;1045;1;0;3322;12;0;0.3;0.0;0.0
34;2021-01-13;1094;7;0;4416;19;0;0.4;0.0;0.0
34;2021-01-14;1934;13;0;6350;32;0;0.6;0.0;0.0
34;2021-01-15;1506;6;0;7856;38;0;0.8;0.0;0.0
34;2021-01-16;329;6;0;8185;44;0;0.8;0.0;0.0
34;2021-01-17;226;1;0;8411;45;0;0.8;0.0;0.0
34;2021-01-18;1138;4;0;9549;49;0;0.9;0.0;0.0
34;2021-01-19;1669;8;0;11218;57;0;1.1;0.0;0.0
34;2021-01-20;2064;24;0;13282;81;0;1.3;0.0;0.0
34;2021-01-21;4032;19;0;17314;100;0;1.7;0.0;0.0
34;2021-01-22;2482;11;0;19796;111;0;1.9;0.0;0.0
34;2021-01-23;567;2;0;20363;113;0;2.0;0.0;0.0
34;2021-01-24;13;0;0;20376;113;0;2.0;0.0;0.0
34;2021-01-25;1236;11;0;21612;124;0;2.1;0.0;0.0
34;2021-01-26;1415;26;0;23027;150;0;2.3;0.0;0.0
34;2021-01-27;1411;38;0;24438;188;0;2.4;0.0;0.0
34;2021-01-28;1377;131;0;25815;319;0;2.5;0.0;0.0
34;2021-01-29;1253;175;0;27068;494;0;2.6;0.0;0.0
34;2021-01-30;478;15;0;27546;509;0;2.7;0.0;0.0
34;2021-01-31;5;0;0;27551;509;0;2.7;0.0;0.0
34;2021-02-01;993;272;0;28544;781;0;2.8;0.1;0.0
34;2021-02-02;1461;498;0;30005;1279;0;2.9;0.1;0.0
34;2021-02-03;2490;557;0;32495;1836;0;3.2;0.2;0.0
34;2021-02-04;2252;898;0;34747;2734;0;3.4;0.3;0.0
34;2021-02-05;1856;1195;0;36603;3929;0;3.6;0.4;0.0
34;2021-02-06;501;239;0;37104;4168;0;3.6;0.4;0.0
34;2021-02-07;35;108;0;37139;4276;0;3.6;0.4;0.0
34;2021-02-08;853;1067;0;37992;5343;0;3.7;0.5;0.0
34;2021-02-09;1038;1306;0;39030;6649;0;3.8;0.7;0.0
34;2021-02-10;1298;1499;0;40328;8148;0;3.9;0.8;0.0
34;2021-02-11;1779;2646;0;42107;10794;0;4.1;1.1;0.0
34;2021-02-12;1834;1640;0;43941;12434;0;4.3;1.2;0.0
34;2021-02-13;361;498;0;44302;12932;0;4.3;1.3;0.0
34;2021-02-14;27;283;0;44329;13215;0;4.3;1.3;0.0
34;2021-02-15;682;1176;0;45011;14391;0;4.4;1.4;0.0
34;2021-02-16;672;1513;0;45683;15904;0;4.5;1.6;0.0
34;2021-02-17;718;1491;0;46401;17395;0;4.5;1.7;0.0
34;2021-02-18;877;1479;0;47278;18874;0;4.6;1.8;0.0
34;2021-02-19;829;1232;0;48107;20106;0;4.7;2.0;0.0
34;2021-02-20;314;478;0;48421;20584;0;4.7;2.0;0.0
34;2021-02-21;66;22;0;48487;20606;0;4.7;2.0;0.0
34;2021-02-22;652;1281;0;49139;21887;0;4.8;2.1;0.0
34;2021-02-23;584;1475;0;49723;23362;0;4.9;2.3;0.0
34;2021-02-24;915;2287;0;50638;25649;0;5.0;2.5;0.0
34;2021-02-25;1606;2184;0;52244;27833;0;5.1;2.7;0.0
34;2021-02-26;1873;1602;0;54117;29435;0;5.3;2.9;0.0
34;2021-02-27;730;440;0;54847;29875;0;5.4;2.9;0.0
34;2021-02-28;88;61;0;54935;29936;0;5.4;2.9;0.0
34;2021-03-01;1008;1169;0;55943;31105;0;5.5;3.0;0.0
34;2021-03-02;1725;1279;0;57668;32384;0;5.6;3.2;0.0
34;2021-03-03;1965;1397;0;59633;33781;0;5.8;3.3;0.0
34;2021-03-04;2932;1650;0;62565;35431;0;6.1;3.5;0.0
34;2021-03-05;3814;1529;0;66379;36960;0;6.5;3.6;0.0
34;2021-03-06;2766;240;0;69145;37200;0;6.8;3.6;0.0
34;2021-03-07;1273;80;0;70418;37280;0;6.9;3.6;0.0
34;2021-03-08;2743;998;0;73161;38278;0;7.2;3.7;0.0
34;2021-03-09;4015;1410;0;77176;39688;0;7.6;3.9;0.0
34;2021-03-10;3973;1336;0;81149;41024;0;7.9;4.0;0.0
34;2021-03-11;5424;1302;0;86573;42326;0;8.5;4.1;0.0
34;2021-03-12;6504;942;0;93077;43268;0;9.1;4.2;0.0
34;2021-03-13;3266;193;0;96343;43461;0;9.4;4.3;0.0
34;2021-03-14;985;51;0;97328;43512;0;9.5;4.3;0.0
34;2021-03-15;3291;583;0;100619;44095;0;9.8;4.3;0.0
34;2021-03-16;2928;684;0;103547;44779;0;10.1;4.4;0.0
34;2021-03-17;3299;710;0;106846;45489;0;10.5;4.5;0.0
34;2021-03-18;3434;962;0;110280;46451;0;10.8;4.5;0.0
34;2021-03-19;4654;807;0;114934;47258;0;11.3;4.6;0.0
34;2021-03-20;3160;86;0;118094;47344;0;11.6;4.6;0.0
34;2021-03-21;1904;49;0;119998;47393;0;11.7;4.6;0.0
34;2021-03-22;3682;502;0;123680;47895;0;12.1;4.7;0.0
34;2021-03-23;4922;560;0;128602;48455;0;12.6;4.7;0.0
34;2021-03-24;5237;683;0;133839;49138;0;13.1;4.8;0.0
34;2021-03-25;7212;767;0;141051;49905;0;13.8;4.9;0.0
34;2021-03-26;7129;576;0;148180;50481;0;14.5;4.9;0.0
34;2021-03-27;2438;116;0;150618;50597;0;14.7;5.0;0.0
34;2021-03-28;686;26;0;151304;50623;0;14.8;5.0;0.0
34;2021-03-29;4175;900;0;155479;51523;0;15.2;5.0;0.0
34;2021-03-30;5244;1112;0;160723;52635;0;15.7;5.2;0.0
34;2021-03-31;5092;1349;0;165815;53984;0;16.2;5.3;0.0
34;2021-04-01;7036;1185;0;172851;55169;0;16.9;5.4;0.0
34;2021-04-02;5861;1302;0;178712;56471;0;17.5;5.5;0.0
34;2021-04-03;1219;254;0;179931;56725;0;17.6;5.6;0.0
34;2021-04-04;178;9;0;180109;56734;0;17.6;5.6;0.0
34;2021-04-05;583;63;0;180692;56797;0;17.7;5.6;0.0
34;2021-04-06;3371;2512;0;184063;59309;0;18.0;5.8;0.0
34;2021-04-07;3545;2671;0;187608;61980;0;18.4;6.1;0.0
34;2021-04-08;5389;2864;0;192997;64844;0;18.9;6.3;0.0
34;2021-04-09;8138;2550;0;201135;67394;0;19.7;6.6;0.0
34;2021-04-10;3302;1447;0;204437;68841;0;20.0;6.7;0.0
34;2021-04-11;1755;779;0;206192;69620;0;20.2;6.8;0.0
34;2021-04-12;4614;2553;0;210806;72173;0;20.6;7.1;0.0
34;2021-04-13;5401;3181;0;216207;75354;0;21.2;7.4;0.0
34;2021-04-14;5698;3300;0;221905;78654;0;21.7;7.7;0.0
34;2021-04-15;7058;3195;0;228963;81849;0;22.4;8.0;0.0
34;2021-04-16;6623;3154;0;235586;85003;0;23.1;8.3;0.0
34;2021-04-17;2622;2106;0;238208;87109;0;23.3;8.5;0.0
34;2021-04-18;1086;1657;0;239294;88766;0;23.4;8.7;0.0
34;2021-04-19;3553;3136;0;242847;91902;0;23.8;9.0;0.0
34;2021-04-20;3949;3679;0;246796;95581;0;24.2;9.4;0.0
34;2021-04-21;4452;3766;0;251248;99347;0;24.6;9.7;0.0
34;2021-04-22;4647;4641;0;255895;103988;0;25.0;10.2;0.0
34;2021-04-23;5560;3525;0;261455;107513;0;25.6;10.5;0.0
34;2021-04-24;3271;1662;0;264726;109175;0;25.9;10.7;0.0
34;2021-04-25;1882;624;0;266608;109799;0;26.1;10.7;0.0
34;2021-04-26;4257;3504;0;270865;113303;0;26.5;11.1;0.0
34;2021-04-27;5157;4086;0;276022;117389;0;27.0;11.5;0.0
34;2021-04-28;5760;3619;0;281782;121008;0;27.6;11.8;0.0
34;2021-04-29;6505;3981;0;288287;124989;0;28.2;12.2;0.0
34;2021-04-30;7845;3411;0;296132;128400;0;29.0;12.6;0.0
34;2021-05-01;2596;572;0;298728;128972;0;29.2;12.6;0.0
34;2021-05-02;3203;345;0;301931;129317;0;29.6;12.7;0.0
34;2021-05-03;6507;3080;0;308438;132397;0;30.2;13.0;0.0
34;2021-05-04;6981;4031;0;315419;136428;0;30.9;13.4;0.0
34;2021-05-05;6380;4647;0;321799;141075;0;31.5;13.8;0.0
34;2021-05-06;6943;5338;0;328742;146413;0;32.2;14.3;0.0
34;2021-05-07;6819;5770;0;335561;152183;0;32.8;14.9;0.0
34;2021-05-08;3658;1244;0;339219;153427;0;33.2;15.0;0.0
34;2021-05-09;2108;1276;0;341327;154703;0;33.4;15.1;0.0
34;2021-05-10;5680;4930;0;347007;159633;0;34.0;15.6;0.0
34;2021-05-11;7132;5456;0;354139;165089;0;34.7;16.2;0.0
34;2021-05-12;7569;4670;0;361708;169759;0;35.4;16.6;0.0
34;2021-05-13;6106;889;0;367814;170648;0;36.0;16.7;0.0
34;2021-05-14;7384;3896;0;375198;174544;0;36.7;17.1;0.0
34;2021-05-15;4820;1861;0;380018;176405;0;37.2;17.3;0.0
34;2021-05-16;4596;511;0;384614;176916;0;37.7;17.3;0.0
34;2021-05-17;8091;2187;0;392705;179103;0;38.4;17.5;0.0
34;2021-05-18;8629;2217;0;401334;181320;0;39.3;17.7;0.0
34;2021-05-19;8170;2052;0;409504;183372;0;40.1;18.0;0.0
34;2021-05-20;8384;2615;0;417888;185987;0;40.9;18.2;0.0
34;2021-05-21;8211;3286;0;426099;189273;0;41.7;18.5;0.0
34;2021-05-22;5537;1243;0;431636;190516;0;42.3;18.6;0.0
34;2021-05-23;3502;538;0;435138;191054;0;42.6;18.7;0.0
34;2021-05-24;1902;846;0;437040;191900;0;42.8;18.8;0.0
34;2021-05-25;6632;3789;0;443672;195689;0;43.4;19.2;0.0
34;2021-05-26;7770;3023;0;451442;198712;0;44.2;19.5;0.0
34;2021-05-27;7759;4243;0;459201;202955;0;45.0;19.9;0.0
34;2021-05-28;7499;5373;0;466700;208328;0;45.7;20.4;0.0
34;2021-05-29;3887;3123;0;470587;211451;0;46.1;20.7;0.0
34;2021-05-30;1798;1362;0;472385;212813;0;46.2;20.8;0.0
34;2021-05-31;5500;5094;0;477885;217907;0;46.8;21.3;0.0
34;2021-06-01;6598;5905;0;484483;223812;0;47.4;21.9;0.0
34;2021-06-02;5982;5665;0;490465;229477;0;48.0;22.5;0.0
34;2021-06-03;7318;6339;0;497783;235816;0;48.7;23.1;0.0
34;2021-06-04;7345;7577;0;505128;243393;0;49.4;23.8;0.0
34;2021-06-05;3936;3665;0;509064;247058;0;49.8;24.2;0.0
34;2021-06-06;3092;1792;0;512156;248850;0;50.1;24.4;0.0
34;2021-06-07;4263;6582;0;516419;255432;0;50.6;25.0;0.0
34;2021-06-08;5551;6603;0;521970;262035;0;51.1;25.7;0.0
34;2021-06-09;5542;6696;0;527512;268731;0;51.6;26.3;0.0
34;2021-06-10;5973;6750;0;533485;275481;0;52.2;27.0;0.0
34;2021-06-11;5311;9065;0;538796;284546;0;52.7;27.9;0.0
34;2021-06-12;3076;4633;0;541872;289179;0;53.0;28.3;0.0
34;2021-06-13;1052;1839;0;542924;291018;0;53.1;28.5;0.0
34;2021-06-14;3357;7662;0;546281;298680;0;53.5;29.2;0.0
34;2021-06-15;3891;8609;0;550172;307289;0;53.9;30.1;0.0
34;2021-06-16;4486;7789;0;554658;315078;0;54.3;30.8;0.0
34;2021-06-17;4088;7741;0;558746;322819;0;54.7;31.6;0.0
34;2021-06-18;4359;9077;0;563105;331896;0;55.1;32.5;0.0
34;2021-06-19;2651;4344;0;565756;336240;0;55.4;32.9;0.0
34;2021-06-20;865;2705;0;566621;338945;0;55.5;33.2;0.0
34;2021-06-21;2205;8349;0;568826;347294;0;55.7;34.0;0.0
34;2021-06-22;2838;9016;0;571664;356310;0;56.0;34.9;0.0
34;2021-06-23;3346;8689;0;575010;364999;0;56.3;35.7;0.0
34;2021-06-24;3346;8370;0;578356;373369;0;56.6;36.5;0.0
34;2021-06-25;3257;10189;0;581613;383558;0;56.9;37.5;0.0
34;2021-06-26;1588;6054;0;583201;389612;0;57.1;38.1;0.0
34;2021-06-27;326;3972;0;583527;393584;0;57.1;38.5;0.0
34;2021-06-28;2154;8959;0;585681;402543;0;57.3;39.4;0.0
34;2021-06-29;2588;9801;0;588269;412344;0;57.6;40.4;0.0
34;2021-06-30;3193;9097;0;591462;421441;0;57.9;41.3;0.0
34;2021-07-01;3492;8984;0;594954;430425;0;58.2;42.1;0.0
34;2021-07-02;3487;9228;0;598441;439653;0;58.6;43.0;0.0
34;2021-07-03;1649;5969;0;600090;445622;0;58.7;43.6;0.0
34;2021-07-04;341;2532;0;600431;448154;0;58.8;43.9;0.0
34;2021-07-05;3054;7654;0;603485;455808;0;59.1;44.6;0.0
34;2021-07-06;3296;8668;0;606781;464476;0;59.4;45.5;0.0
34;2021-07-07;3185;8228;0;609966;472704;0;59.7;46.3;0.0
34;2021-07-08;4044;8284;0;614010;480988;0;60.1;47.1;0.0
34;2021-07-09;3810;8987;0;617820;489975;0;60.5;48.0;0.0
34;2021-07-10;2133;5551;0;619953;495526;0;60.7;48.5;0.0
34;2021-07-11;859;2305;0;620812;497831;0;60.8;48.7;0.0
34;2021-07-12;2746;8516;0;623558;506347;0;61.0;49.6;0.0
34;2021-07-13;4502;9476;0;628060;515823;0;61.5;50.5;0.0
34;2021-07-14;891;575;0;628951;516398;0;61.6;50.6;0.0
34;2021-07-15;5711;9807;0;634662;526205;0;62.1;51.5;0.0
34;2021-07-16;5863;10128;0;640525;536333;0;62.7;52.5;0.0
34;2021-07-17;4423;4519;0;644948;540852;0;63.1;52.9;0.0
34;2021-07-18;394;345;0;645342;541197;0;63.2;53.0;0.0
34;2021-07-19;4979;7897;0;650321;549094;0;63.7;53.8;0.0
34;2021-07-20;6585;7858;0;656906;556952;0;64.3;54.5;0.0
34;2021-07-21;7238;7369;0;664144;564321;0;65.0;55.2;0.0
34;2021-07-22;7248;7541;0;671392;571862;0;65.7;56.0;0.0
34;2021-07-23;7688;7601;0;679080;579463;0;66.5;56.7;0.0
34;2021-07-24;5764;3162;0;684844;582625;0;67.0;57.0;0.0
34;2021-07-25;2795;556;0;687639;583181;0;67.3;57.1;0.0
34;2021-07-26;5957;6011;0;693596;589192;0;67.9;57.7;0.0
34;2021-07-27;7903;5541;0;701499;594733;0;68.7;58.2;0.0
34;2021-07-28;8600;5565;0;710099;600298;0;69.5;58.8;0.0
34;2021-07-29;10237;5575;0;720336;605873;0;70.5;59.3;0.0
34;2021-07-30;8996;6001;0;729332;611874;0;71.4;59.9;0.0
34;2021-07-31;5981;2245;0;735313;614119;0;72.0;60.1;0.0
34;2021-08-01;2910;623;0;738223;614742;0;72.3;60.2;0.0
34;2021-08-02;6755;4631;0;744978;619373;0;72.9;60.6;0.0
34;2021-08-03;7300;4942;0;752278;624315;0;73.6;61.1;0.0
34;2021-08-04;7282;3840;0;759560;628155;0;74.4;61.5;0.0
34;2021-08-05;6343;4390;0;765903;632545;0;75.0;61.9;0.0
34;2021-08-06;5452;4667;0;771355;637212;0;75.5;62.4;0.0
34;2021-08-07;3012;2351;0;774367;639563;0;75.8;62.6;0.0
34;2021-08-08;262;290;0;774629;639853;0;75.8;62.6;0.0
34;2021-08-09;4317;5519;0;778946;645372;0;76.3;63.2;0.0
34;2021-08-10;4646;5726;0;783592;651098;0;76.7;63.7;0.0
34;2021-08-11;4287;5669;0;787879;656767;0;77.1;64.3;0.0
34;2021-08-12;4053;5602;0;791932;662369;0;77.5;64.8;0.0
34;2021-08-13;3672;5237;0;795604;667606;0;77.9;65.4;0.0
34;2021-08-14;1802;2884;0;797406;670490;0;78.1;65.6;0.0
34;2021-08-15;243;291;0;797649;670781;0;78.1;65.7;0.0
34;2021-08-16;2603;6966;0;800252;677747;0;78.3;66.3;0.0
34;2021-08-17;3254;7536;0;803506;685283;0;78.7;67.1;0.0
34;2021-08-18;2901;6789;0;806407;692072;0;78.9;67.7;0.0
34;2021-08-19;2983;6909;0;809390;698981;0;79.2;68.4;0.0
34;2021-08-20;2572;7146;0;811962;706127;0;79.5;69.1;0.0
34;2021-08-21;1330;3599;0;813292;709726;0;79.6;69.5;0.0
34;2021-08-22;178;385;0;813470;710111;0;79.6;69.5;0.0
34;2021-08-23;2195;7877;0;815665;717988;0;79.8;70.3;0.0
34;2021-08-24;2474;8125;0;818139;726113;0;80.1;71.1;0.0
34;2021-08-25;2138;7774;0;820277;733887;0;80.3;71.8;0.0
34;2021-08-26;2359;7148;1;822636;741035;1;80.5;72.5;0.0
34;2021-08-27;2109;6913;1;824745;747948;2;80.7;73.2;0.0
34;2021-08-28;1085;3376;0;825830;751324;2;80.8;73.5;0.0
34;2021-08-29;299;1041;0;826129;752365;2;80.9;73.7;0.0
34;2021-08-30;1888;6295;113;828017;758660;115;81.1;74.3;0.0
34;2021-08-31;1942;6090;243;829959;764750;358;81.2;74.9;0.0
34;2021-09-01;2196;5336;541;832155;770086;899;81.5;75.4;0.1
34;2021-09-02;1633;3808;723;833788;773894;1622;81.6;75.8;0.2
34;2021-09-03;1741;4697;665;835529;778591;2287;81.8;76.2;0.2
34;2021-09-04;1320;3114;274;836849;781705;2561;81.9;76.5;0.3
34;2021-09-05;133;242;23;836982;781947;2584;81.9;76.5;0.3
34;2021-09-06;1152;2847;867;838134;784794;3451;82.0;76.8;0.3
34;2021-09-07;1206;2976;828;839340;787770;4279;82.2;77.1;0.4
34;2021-09-08;1499;3666;709;840839;791436;4988;82.3;77.5;0.5
34;2021-09-09;1107;2889;801;841946;794325;5789;82.4;77.8;0.6
34;2021-09-10;1496;3115;857;843442;797440;6646;82.6;78.1;0.7
34;2021-09-11;1210;1835;233;844652;799275;6879;82.7;78.2;0.7
34;2021-09-12;72;106;11;844724;799381;6890;82.7;78.3;0.7
34;2021-09-13;960;2285;808;845684;801666;7698;82.8;78.5;0.8
34;2021-09-14;1164;2078;1188;846848;803744;8886;82.9;78.7;0.9
34;2021-09-15;1397;2732;1075;848245;806476;9961;83.0;78.9;1.0
34;2021-09-16;870;1749;1028;849115;808225;10989;83.1;79.1;1.1
34;2021-09-17;1051;2305;1062;850166;810530;12051;83.2;79.3;1.2
34;2021-09-18;768;1703;267;850934;812233;12318;83.3;79.5;1.2
34;2021-09-19;49;67;33;850983;812300;12351;83.3;79.5;1.2
34;2021-09-20;611;1757;989;851594;814057;13340;83.4;79.7;1.3
34;2021-09-21;573;1572;985;852167;815629;14325;83.4;79.8;1.4
34;2021-09-22;768;2367;1066;852935;817996;15391;83.5;80.1;1.5
34;2021-09-23;626;1507;926;853561;819503;16317;83.6;80.2;1.6
34;2021-09-24;804;2079;1070;854365;821582;17387;83.6;80.4;1.7
34;2021-09-25;466;1469;225;854831;823051;17612;83.7;80.6;1.7
34;2021-09-26;38;150;18;854869;823201;17630;83.7;80.6;1.7
34;2021-09-27;568;1282;598;855437;824483;18228;83.7;80.7;1.8
34;2021-09-28;568;1014;607;856005;825497;18835;83.8;80.8;1.8
34;2021-09-29;808;1720;778;856813;827217;19613;83.9;81.0;1.9
34;2021-09-30;587;1241;991;857400;828458;20604;83.9;81.1;2.0
34;2021-10-01;1002;1405;1016;858402;829863;21620;84.0;81.2;2.1
34;2021-10-02;681;1361;371;859083;831224;21991;84.1;81.4;2.2
34;2021-10-03;58;150;20;859141;831374;22011;84.1;81.4;2.2
34;2021-10-04;658;969;873;859799;832343;22884;84.2;81.5;2.2
34;2021-10-05;515;911;957;860314;833254;23841;84.2;81.6;2.3
34;2021-10-06;864;1548;1355;861178;834802;25196;84.3;81.7;2.5
34;2021-10-07;550;962;1286;861728;835764;26482;84.4;81.8;2.6
34;2021-10-08;842;1325;1542;862570;837089;28024;84.4;81.9;2.7
34;2021-10-09;539;962;469;863109;838051;28493;84.5;82.0;2.8
34;2021-10-10;73;93;26;863182;838144;28519;84.5;82.0;2.8
34;2021-10-11;622;923;1466;863804;839067;29985;84.6;82.1;2.9
34;2021-10-12;477;666;1305;864281;839733;31290;84.6;82.2;3.1
34;2021-10-13;606;1010;1503;864887;840743;32793;84.7;82.3;3.2
34;2021-10-14;509;643;1205;865396;841386;33998;84.7;82.4;3.3
34;2021-10-15;809;1140;1832;866205;842526;35830;84.8;82.5;3.5
34;2021-10-16;455;657;592;866660;843183;36422;84.8;82.5;3.6
34;2021-10-17;69;59;33;866729;843242;36455;84.8;82.5;3.6
34;2021-10-18;579;733;1745;867308;843975;38200;84.9;82.6;3.7
34;2021-10-19;432;626;1537;867740;844601;39737;84.9;82.7;3.9
34;2021-10-20;541;813;2045;868281;845414;41782;85.0;82.8;4.1
34;2021-10-21;418;605;1913;868699;846019;43695;85.0;82.8;4.3
34;2021-10-22;662;953;2094;869361;846972;45789;85.1;82.9;4.5
34;2021-10-23;263;571;694;869624;847543;46483;85.1;83.0;4.6
34;2021-10-24;59;62;54;869683;847605;46537;85.1;83.0;4.6
34;2021-10-25;598;822;2222;870281;848427;48759;85.2;83.1;4.8
34;2021-10-26;360;516;1674;870641;848943;50433;85.2;83.1;4.9
34;2021-10-27;472;724;2186;871113;849667;52619;85.3;83.2;5.2
34;2021-10-28;370;516;1875;871483;850183;54494;85.3;83.2;5.3
34;2021-10-29;543;721;2130;872026;850904;56624;85.4;83.3;5.5
34;2021-10-30;278;561;937;872304;851465;57561;85.4;83.4;5.6
34;2021-10-31;62;35;81;872366;851500;57642;85.4;83.4;5.6
34;2021-11-01;79;50;61;872445;851550;57703;85.4;83.4;5.6
34;2021-11-02;433;748;2008;872878;852298;59711;85.4;83.4;5.8
34;2021-11-03;437;674;2382;873315;852972;62093;85.5;83.5;6.1
34;2021-11-04;337;489;2353;873652;853461;64446;85.5;83.5;6.3
34;2021-11-05;519;647;2785;874171;854108;67231;85.6;83.6;6.6
34;2021-11-06;338;569;1065;874509;854677;68296;85.6;83.7;6.7
34;2021-11-07;60;63;66;874569;854740;68362;85.6;83.7;6.7
34;2021-11-08;372;606;2634;874941;855346;70996;85.6;83.7;6.9
34;2021-11-09;341;535;2789;875282;855881;73785;85.7;83.8;7.2
34;2021-11-10;472;722;3824;875754;856603;77609;85.7;83.9;7.6
34;2021-11-11;54;82;276;875808;856685;77885;85.7;83.9;7.6
34;2021-11-12;449;614;3668;876257;857299;81553;85.8;83.9;8.0
34;2021-11-13;272;369;1456;876529;857668;83009;85.8;84.0;8.1
34;2021-11-14;65;38;111;876594;857706;83120;85.8;84.0;8.1
34;2021-11-15;390;544;3312;876984;858250;86432;85.8;84.0;8.5
34;2021-11-16;347;506;3460;877331;858756;89892;85.9;84.1;8.8
34;2021-11-17;471;617;3809;877802;859373;93701;85.9;84.1;9.2
34;2021-11-18;407;508;3709;878209;859881;97410;86.0;84.2;9.5
34;2021-11-19;574;732;4715;878783;860613;102125;86.0;84.2;10.0
34;2021-11-20;314;441;1537;879097;861054;103662;86.1;84.3;10.1
34;2021-11-21;16;97;124;879113;861151;103786;86.1;84.3;10.2
34;2021-11-22;445;398;3848;879558;861549;107634;86.1;84.3;10.5
34;2021-11-23;407;463;4049;879965;862012;111683;86.1;84.4;10.9
34;2021-11-24;498;576;4254;880463;862588;115937;86.2;84.4;11.3
34;2021-11-25;431;431;4964;880894;863019;120901;86.2;84.5;11.8
34;2021-11-26;642;640;7409;881536;863659;128310;86.3;84.5;12.6
34;2021-11-27;346;418;3313;881882;864077;131623;86.3;84.6;12.9
34;2021-11-28;48;113;627;881930;864190;132250;86.3;84.6;12.9
34;2021-11-29;370;484;6561;882300;864674;138811;86.4;84.6;13.6
34;2021-11-30;440;464;8751;882740;865138;147562;86.4;84.7;14.4
34;2021-12-01;336;512;8398;883076;865650;155960;86.4;84.7;15.3
34;2021-12-02;349;386;10524;883425;866036;166484;86.5;84.8;16.3
34;2021-12-03;349;506;10376;883774;866542;176860;86.5;84.8;17.3
34;2021-12-04;207;318;4620;883981;866860;181480;86.5;84.9;17.8
34;2021-12-05;40;96;817;884021;866956;182297;86.5;84.9;17.8
34;2021-12-06;368;537;9885;884389;867493;192182;86.6;84.9;18.8
34;2021-12-07;465;528;12656;884854;868021;204838;86.6;85.0;20.1
34;2021-12-08;452;650;11245;885306;868671;216083;86.7;85.0;21.2
34;2021-12-09;379;476;13147;885685;869147;229230;86.7;85.1;22.4
34;2021-12-10;462;602;14340;886147;869749;243570;86.7;85.1;23.8
34;2021-12-11;275;485;6766;886422;870234;250336;86.8;85.2;24.5
34;2021-12-12;46;56;1216;886468;870290;251552;86.8;85.2;24.6
34;2021-12-13;357;506;11703;886825;870796;263255;86.8;85.2;25.8
34;2021-12-14;470;599;16346;887295;871395;279601;86.9;85.3;27.4
34;2021-12-15;441;623;13988;887736;872018;293589;86.9;85.4;28.7
34;2021-12-16;494;611;15843;888230;872629;309432;87.0;85.4;30.3
34;2021-12-17;508;712;15879;888738;873341;325311;87.0;85.5;31.8
34;2021-12-18;299;413;7227;889037;873754;332538;87.0;85.5;32.6
34;2021-12-19;79;96;1381;889116;873850;333919;87.0;85.5;32.7
35;2020-12-27;1;0;0;1;0;0;0.0;0.0;0.0
35;2020-12-28;0;0;0;1;0;0;0.0;0.0;0.0
35;2020-12-29;1;0;0;2;0;0;0.0;0.0;0.0
35;2020-12-30;0;0;0;2;0;0;0.0;0.0;0.0
35;2020-12-31;0;0;0;2;0;0;0.0;0.0;0.0
35;2021-01-01;3;0;0;5;0;0;0.0;0.0;0.0
35;2021-01-02;0;0;0;5;0;0;0.0;0.0;0.0
35;2021-01-03;0;0;0;5;0;0;0.0;0.0;0.0
35;2021-01-04;10;0;0;15;0;0;0.0;0.0;0.0
35;2021-01-05;117;0;0;132;0;0;0.0;0.0;0.0
35;2021-01-06;174;0;0;306;0;0;0.0;0.0;0.0
35;2021-01-07;462;1;0;768;1;0;0.1;0.0;0.0
35;2021-01-08;492;1;0;1260;2;0;0.1;0.0;0.0
35;2021-01-09;39;0;0;1299;2;0;0.1;0.0;0.0
35;2021-01-10;4;0;0;1303;2;0;0.1;0.0;0.0
35;2021-01-11;537;0;0;1840;2;0;0.2;0.0;0.0
35;2021-01-12;865;3;0;2705;5;0;0.3;0.0;0.0
35;2021-01-13;922;4;0;3627;9;0;0.4;0.0;0.0
35;2021-01-14;1259;15;0;4886;24;0;0.5;0.0;0.0
35;2021-01-15;703;2;0;5589;26;0;0.6;0.0;0.0
35;2021-01-16;190;2;0;5779;28;0;0.6;0.0;0.0
35;2021-01-17;54;0;0;5833;28;0;0.6;0.0;0.0
35;2021-01-18;1154;2;0;6987;30;0;0.8;0.0;0.0
35;2021-01-19;5127;17;0;12114;47;0;1.3;0.0;0.0
35;2021-01-20;3163;10;0;15277;57;0;1.7;0.0;0.0
35;2021-01-21;3528;14;0;18805;71;0;2.0;0.0;0.0
35;2021-01-22;2024;7;0;20829;78;0;2.3;0.0;0.0
35;2021-01-23;412;1;0;21241;79;0;2.3;0.0;0.0
35;2021-01-24;50;0;0;21291;79;0;2.3;0.0;0.0
35;2021-01-25;874;17;0;22165;96;0;2.4;0.0;0.0
35;2021-01-26;1154;135;0;23319;231;0;2.5;0.0;0.0
35;2021-01-27;1175;130;0;24494;361;0;2.6;0.0;0.0
35;2021-01-28;956;318;0;25450;679;0;2.8;0.1;0.0
35;2021-01-29;751;297;0;26201;976;0;2.8;0.1;0.0
35;2021-01-30;155;21;0;26356;997;0;2.8;0.1;0.0
35;2021-01-31;1;1;0;26357;998;0;2.8;0.1;0.0
35;2021-02-01;646;331;0;27003;1329;0;2.9;0.1;0.0
35;2021-02-02;769;501;0;27772;1830;0;3.0;0.2;0.0
35;2021-02-03;662;519;0;28434;2349;0;3.1;0.3;0.0
35;2021-02-04;648;644;0;29082;2993;0;3.1;0.3;0.0
35;2021-02-05;691;525;0;29773;3518;0;3.2;0.4;0.0
35;2021-02-06;179;12;0;29952;3530;0;3.2;0.4;0.0
35;2021-02-07;4;8;0;29956;3538;0;3.2;0.4;0.0
35;2021-02-08;442;620;0;30398;4158;0;3.3;0.4;0.0
35;2021-02-09;1656;3402;0;32054;7560;0;3.5;0.8;0.0
35;2021-02-10;1279;2613;0;33333;10173;0;3.6;1.1;0.0
35;2021-02-11;1907;3100;0;35240;13273;0;3.8;1.4;0.0
35;2021-02-12;1611;1703;0;36851;14976;0;4.0;1.6;0.0
35;2021-02-13;76;270;0;36927;15246;0;4.0;1.6;0.0
35;2021-02-14;9;72;0;36936;15318;0;4.0;1.7;0.0
35;2021-02-15;743;1030;0;37679;16348;0;4.1;1.8;0.0
35;2021-02-16;928;1122;0;38607;17470;0;4.2;1.9;0.0
35;2021-02-17;890;1180;0;39497;18650;0;4.3;2.0;0.0
35;2021-02-18;1005;1046;0;40502;19696;0;4.4;2.1;0.0
35;2021-02-19;1027;1003;0;41529;20699;0;4.5;2.2;0.0
35;2021-02-20;165;58;0;41694;20757;0;4.5;2.2;0.0
35;2021-02-21;3;3;0;41697;20760;0;4.5;2.2;0.0
35;2021-02-22;713;818;0;42410;21578;0;4.6;2.3;0.0
35;2021-02-23;1377;941;0;43787;22519;0;4.7;2.4;0.0
35;2021-02-24;1295;878;0;45082;23397;0;4.9;2.5;0.0
35;2021-02-25;2148;859;0;47230;24256;0;5.1;2.6;0.0
35;2021-02-26;2500;759;0;49730;25015;0;5.4;2.7;0.0
35;2021-02-27;863;128;0;50593;25143;0;5.5;2.7;0.0
35;2021-02-28;10;2;0;50603;25145;0;5.5;2.7;0.0
35;2021-03-01;881;650;0;51484;25795;0;5.6;2.8;0.0
35;2021-03-02;1589;1886;0;53073;27681;0;5.7;3.0;0.0
35;2021-03-03;1845;942;0;54918;28623;0;5.9;3.1;0.0
35;2021-03-04;2747;1408;0;57665;30031;0;6.2;3.2;0.0
35;2021-03-05;3589;1349;0;61254;31380;0;6.6;3.4;0.0
35;2021-03-06;1351;104;0;62605;31484;0;6.8;3.4;0.0
35;2021-03-07;65;42;0;62670;31526;0;6.8;3.4;0.0
35;2021-03-08;1372;583;0;64042;32109;0;6.9;3.5;0.0
35;2021-03-09;3050;637;0;67092;32746;0;7.2;3.5;0.0
35;2021-03-10;2825;591;0;69917;33337;0;7.6;3.6;0.0
35;2021-03-11;4078;718;0;73995;34055;0;8.0;3.7;0.0
35;2021-03-12;5799;585;0;79794;34640;0;8.6;3.7;0.0
35;2021-03-13;2422;137;0;82216;34777;0;8.9;3.8;0.0
35;2021-03-14;60;27;0;82276;34804;0;8.9;3.8;0.0
35;2021-03-15;1849;627;0;84125;35431;0;9.1;3.8;0.0
35;2021-03-16;2384;676;0;86509;36107;0;9.3;3.9;0.0
35;2021-03-17;2307;584;0;88816;36691;0;9.6;4.0;0.0
35;2021-03-18;2238;586;0;91054;37277;0;9.8;4.0;0.0
35;2021-03-19;3434;515;0;94488;37792;0;10.2;4.1;0.0
35;2021-03-20;1549;124;0;96037;37916;0;10.4;4.1;0.0
35;2021-03-21;53;2;0;96090;37918;0;10.4;4.1;0.0
35;2021-03-22;1709;784;0;97799;38702;0;10.6;4.2;0.0
35;2021-03-23;3500;1188;0;101299;39890;0;10.9;4.3;0.0
35;2021-03-24;3646;931;0;104945;40821;0;11.3;4.4;0.0
35;2021-03-25;5169;945;0;110114;41766;0;11.9;4.5;0.0
35;2021-03-26;5666;764;0;115780;42530;0;12.5;4.6;0.0
35;2021-03-27;1431;224;0;117211;42754;0;12.7;4.6;0.0
35;2021-03-28;24;0;0;117235;42754;0;12.7;4.6;0.0
35;2021-03-29;2761;855;0;119996;43609;0;13.0;4.7;0.0
35;2021-03-30;4199;1241;0;124195;44850;0;13.4;4.8;0.0
35;2021-03-31;3521;1304;0;127716;46154;0;13.8;5.0;0.0
35;2021-04-01;4303;1209;0;132019;47363;0;14.3;5.1;0.0
35;2021-04-02;4927;1148;0;136946;48511;0;14.8;5.2;0.0
35;2021-04-03;839;236;0;137785;48747;0;14.9;5.3;0.0
35;2021-04-04;23;19;0;137808;48766;0;14.9;5.3;0.0
35;2021-04-05;66;3;0;137874;48769;0;14.9;5.3;0.0
35;2021-04-06;3200;1948;0;141074;50717;0;15.2;5.5;0.0
35;2021-04-07;3910;1782;0;144984;52499;0;15.7;5.7;0.0
35;2021-04-08;5682;1576;0;150666;54075;0;16.3;5.8;0.0
35;2021-04-09;7360;1383;0;158026;55458;0;17.1;6.0;0.0
35;2021-04-10;2110;290;0;160136;55748;0;17.3;6.0;0.0
35;2021-04-11;70;37;0;160206;55785;0;17.3;6.0;0.0
35;2021-04-12;5000;1467;0;165206;57252;0;17.9;6.2;0.0
35;2021-04-13;7284;2660;0;172490;59912;0;18.6;6.5;0.0
35;2021-04-14;6043;2216;0;178533;62128;0;19.3;6.7;0.0
35;2021-04-15;7243;2182;0;185776;64310;0;20.1;6.9;0.0
35;2021-04-16;7751;1725;0;193527;66035;0;20.9;7.1;0.0
35;2021-04-17;1778;280;0;195305;66315;0;21.1;7.2;0.0
35;2021-04-18;44;11;0;195349;66326;0;21.1;7.2;0.0
35;2021-04-19;4593;1595;0;199942;67921;0;21.6;7.3;0.0
35;2021-04-20;4920;2554;0;204862;70475;0;22.1;7.6;0.0
35;2021-04-21;4920;2166;0;209782;72641;0;22.7;7.8;0.0
35;2021-04-22;6081;2281;0;215863;74922;0;23.3;8.1;0.0
35;2021-04-23;6460;2265;0;222323;77187;0;24.0;8.3;0.0
35;2021-04-24;1270;389;0;223593;77576;0;24.2;8.4;0.0
35;2021-04-25;59;26;0;223652;77602;0;24.2;8.4;0.0
35;2021-04-26;4767;2176;0;228419;79778;0;24.7;8.6;0.0
35;2021-04-27;5710;3125;0;234129;82903;0;25.3;9.0;0.0
35;2021-04-28;5780;2607;1;239909;85510;1;25.9;9.2;0.0
35;2021-04-29;6780;2760;0;246689;88270;1;26.7;9.5;0.0
35;2021-04-30;7126;2664;0;253815;90934;1;27.4;9.8;0.0
35;2021-05-01;666;266;0;254481;91200;1;27.5;9.9;0.0
35;2021-05-02;49;46;0;254530;91246;1;27.5;9.9;0.0
35;2021-05-03;5077;2393;0;259607;93639;1;28.1;10.1;0.0
35;2021-05-04;4857;5182;0;264464;98821;1;28.6;10.7;0.0
35;2021-05-05;4701;4365;0;269165;103186;1;29.1;11.2;0.0
35;2021-05-06;5957;5123;0;275122;108309;1;29.7;11.7;0.0
35;2021-05-07;5411;5073;0;280533;113382;1;30.3;12.3;0.0
35;2021-05-08;1852;172;0;282385;113554;1;30.5;12.3;0.0
35;2021-05-09;732;114;0;283117;113668;1;30.6;12.3;0.0
35;2021-05-10;3809;4721;0;286926;118389;1;31.0;12.8;0.0
35;2021-05-11;5074;5550;0;292000;123939;1;31.6;13.4;0.0
35;2021-05-12;5671;5172;0;297671;129111;1;32.2;14.0;0.0
35;2021-05-13;2715;1391;0;300386;130502;1;32.5;14.1;0.0
35;2021-05-14;5952;4004;0;306338;134506;1;33.1;14.5;0.0
35;2021-05-15;3448;731;0;309786;135237;1;33.5;14.6;0.0
35;2021-05-16;1228;91;0;311014;135328;1;33.6;14.6;0.0
35;2021-05-17;4981;3654;0;315995;138982;1;34.1;15.0;0.0
35;2021-05-18;6282;4053;0;322277;143035;1;34.8;15.5;0.0
35;2021-05-19;6287;3384;0;328564;146419;1;35.5;15.8;0.0
35;2021-05-20;7085;3727;0;335649;150146;1;36.3;16.2;0.0
35;2021-05-21;6592;4505;0;342241;154651;1;37.0;16.7;0.0
35;2021-05-22;2765;794;0;345006;155445;1;37.3;16.8;0.0
35;2021-05-23;874;74;0;345880;155519;1;37.4;16.8;0.0
35;2021-05-24;3519;1232;0;349399;156751;1;37.8;16.9;0.0
35;2021-05-25;6200;4024;0;355599;160775;1;38.4;17.4;0.0
35;2021-05-26;6369;4058;0;361968;164833;1;39.1;17.8;0.0
35;2021-05-27;7133;4717;0;369101;169550;1;39.9;18.3;0.0
35;2021-05-28;6895;5505;0;375996;175055;1;40.6;18.9;0.0
35;2021-05-29;3610;1266;0;379606;176321;1;41.0;19.1;0.0
35;2021-05-30;946;66;0;380552;176387;1;41.1;19.1;0.0
35;2021-05-31;6864;4182;0;387416;180569;1;41.9;19.5;0.0
35;2021-06-01;8005;4927;0;395421;185496;1;42.7;20.0;0.0
35;2021-06-02;7859;3863;0;403280;189359;1;43.6;20.5;0.0
35;2021-06-03;8677;4912;0;411957;194271;1;44.5;21.0;0.0
35;2021-06-04;7663;7241;0;419620;201512;1;45.3;21.8;0.0
35;2021-06-05;4483;1647;0;424103;203159;1;45.8;22.0;0.0
35;2021-06-06;2756;187;0;426859;203346;1;46.1;22.0;0.0
35;2021-06-07;6321;5441;0;433180;208787;1;46.8;22.6;0.0
35;2021-06-08;7987;5712;0;441167;214499;1;47.7;23.2;0.0
35;2021-06-09;8645;4631;0;449812;219130;1;48.6;23.7;0.0
35;2021-06-10;9495;4671;0;459307;223801;1;49.6;24.2;0.0
35;2021-06-11;8904;7184;0;468211;230985;1;50.6;25.0;0.0
35;2021-06-12;5134;1385;0;473345;232370;1;51.1;25.1;0.0
35;2021-06-13;3163;245;0;476508;232615;1;51.5;25.1;0.0
35;2021-06-14;6287;6316;0;482795;238931;1;52.2;25.8;0.0
35;2021-06-15;7462;6694;0;490257;245625;1;53.0;26.5;0.0
35;2021-06-16;8208;5559;0;498465;251184;1;53.9;27.1;0.0
35;2021-06-17;8616;5752;0;507081;256936;1;54.8;27.8;0.0
35;2021-06-18;8586;7912;0;515667;264848;1;55.7;28.6;0.0
35;2021-06-19;1921;2832;0;517588;267680;1;55.9;28.9;0.0
35;2021-06-20;2568;920;0;520156;268600;1;56.2;29.0;0.0
35;2021-06-21;5703;6304;0;525859;274904;1;56.8;29.7;0.0
35;2021-06-22;6640;7577;0;532499;282481;1;57.5;30.5;0.0
35;2021-06-23;6894;6351;0;539393;288832;1;58.3;31.2;0.0
35;2021-06-24;7968;6042;0;547361;294874;1;59.1;31.9;0.0
35;2021-06-25;6470;8780;0;553831;303654;1;59.8;32.8;0.0
35;2021-06-26;1385;3602;0;555216;307256;1;60.0;33.2;0.0
35;2021-06-27;2274;1216;0;557490;308472;1;60.2;33.3;0.0
35;2021-06-28;4151;7965;0;561641;316437;1;60.7;34.2;0.0
35;2021-06-29;4871;8269;0;566512;324706;1;61.2;35.1;0.0
35;2021-06-30;5381;8092;0;571893;332798;1;61.8;36.0;0.0
35;2021-07-01;6187;7800;0;578080;340598;1;62.5;36.8;0.0
35;2021-07-02;5227;9922;0;583307;350520;1;63.0;37.9;0.0
35;2021-07-03;1129;3594;0;584436;354114;1;63.2;38.3;0.0
35;2021-07-04;1837;1641;0;586273;355755;1;63.4;38.4;0.0
35;2021-07-05;3751;8456;0;590024;364211;1;63.8;39.4;0.0
35;2021-07-06;4611;9722;0;594635;373933;1;64.3;40.4;0.0
35;2021-07-07;4973;8680;0;599608;382613;1;64.8;41.3;0.0
35;2021-07-08;5329;8848;0;604937;391461;1;65.4;42.3;0.0
35;2021-07-09;4052;11784;0;608989;403245;1;65.8;43.6;0.0
35;2021-07-10;1104;3788;0;610093;407033;1;65.9;44.0;0.0
35;2021-07-11;1180;2257;0;611273;409290;1;66.1;44.2;0.0
35;2021-07-12;3109;9535;0;614382;418825;1;66.4;45.3;0.0
35;2021-07-13;4157;11148;0;618539;429973;1;66.8;46.5;0.0
35;2021-07-14;2277;4359;0;620816;434332;1;67.1;46.9;0.0
35;2021-07-15;4784;10470;0;625600;444802;1;67.6;48.1;0.0
35;2021-07-16;5188;11289;0;630788;456091;1;68.2;49.3;0.0
35;2021-07-17;2549;4521;0;633337;460612;1;68.4;49.8;0.0
35;2021-07-18;989;2432;0;634326;463044;1;68.5;50.0;0.0
35;2021-07-19;3675;9406;0;638001;472450;1;68.9;51.1;0.0
35;2021-07-20;5182;11029;0;643183;483479;1;69.5;52.2;0.0
35;2021-07-21;4906;9683;0;648089;493162;1;70.0;53.3;0.0
35;2021-07-22;5269;9836;0;653358;502998;1;70.6;54.4;0.0
35;2021-07-23;5065;11229;0;658423;514227;1;71.1;55.6;0.0
35;2021-07-24;2295;4712;0;660718;518939;1;71.4;56.1;0.0
35;2021-07-25;863;2677;0;661581;521616;1;71.5;56.4;0.0
35;2021-07-26;4316;8750;0;665897;530366;1;72.0;57.3;0.0
35;2021-07-27;5974;9808;0;671871;540174;1;72.6;58.4;0.0
35;2021-07-28;5844;8781;0;677715;548955;1;73.2;59.3;0.0
35;2021-07-29;6761;8389;0;684476;557344;1;74.0;60.2;0.0
35;2021-07-30;6395;9142;0;690871;566486;1;74.7;61.2;0.0
35;2021-07-31;2864;3840;0;693735;570326;1;75.0;61.6;0.0
35;2021-08-01;1481;2263;0;695216;572589;1;75.1;61.9;0.0
35;2021-08-02;5284;6905;0;700500;579494;1;75.7;62.6;0.0
35;2021-08-03;7212;7521;0;707712;587015;1;76.5;63.4;0.0
35;2021-08-04;7259;6610;0;714971;593625;1;77.3;64.1;0.0
35;2021-08-05;7144;6900;0;722115;600525;1;78.0;64.9;0.0
35;2021-08-06;6513;7208;0;728628;607733;1;78.7;65.7;0.0
35;2021-08-07;2581;3270;0;731209;611003;1;79.0;66.0;0.0
35;2021-08-08;1583;2065;0;732792;613068;1;79.2;66.2;0.0
35;2021-08-09;4867;5555;0;737659;618623;1;79.7;66.8;0.0
35;2021-08-10;6519;6353;0;744178;624976;1;80.4;67.5;0.0
35;2021-08-11;6335;5756;0;750513;630732;1;81.1;68.2;0.0
35;2021-08-12;6567;5489;0;757080;636221;1;81.8;68.7;0.0
35;2021-08-13;6300;5073;0;763380;641294;1;82.5;69.3;0.0
35;2021-08-14;2890;2155;0;766270;643449;1;82.8;69.5;0.0
35;2021-08-15;1960;1154;0;768230;644603;1;83.0;69.7;0.0
35;2021-08-16;4428;5160;0;772658;649763;1;83.5;70.2;0.0
35;2021-08-17;5823;6077;0;778481;655840;1;84.1;70.9;0.0
35;2021-08-18;5880;5474;0;784361;661314;1;84.8;71.5;0.0
35;2021-08-19;5512;5766;0;789873;667080;1;85.4;72.1;0.0
35;2021-08-20;4676;6228;0;794549;673308;1;85.9;72.8;0.0
35;2021-08-21;2085;2808;0;796634;676116;1;86.1;73.1;0.0
35;2021-08-22;1464;1660;0;798098;677776;1;86.2;73.2;0.0
35;2021-08-23;2802;6012;0;800900;683788;1;86.5;73.9;0.0
35;2021-08-24;3125;7129;0;804025;690917;1;86.9;74.7;0.0
35;2021-08-25;2984;6551;0;807009;697468;1;87.2;75.4;0.0
35;2021-08-26;2428;6814;0;809437;704282;1;87.5;76.1;0.0
35;2021-08-27;2517;7110;0;811954;711392;1;87.7;76.9;0.0
35;2021-08-28;1074;3125;0;813028;714517;1;87.9;77.2;0.0
35;2021-08-29;442;1637;0;813470;716154;1;87.9;77.4;0.0
35;2021-08-30;1826;5292;100;815296;721446;101;88.1;78.0;0.0
35;2021-08-31;2173;6222;148;817469;727668;249;88.3;78.6;0.0
35;2021-09-01;1808;5617;309;819277;733285;558;88.5;79.2;0.1
35;2021-09-02;1745;5460;389;821022;738745;947;88.7;79.8;0.1
35;2021-09-03;1903;6359;386;822925;745104;1333;88.9;80.5;0.1
35;2021-09-04;1062;3800;86;823987;748904;1419;89.0;80.9;0.2
35;2021-09-05;407;1759;63;824394;750663;1482;89.1;81.1;0.2
35;2021-09-06;1060;4354;411;825454;755017;1893;89.2;81.6;0.2
35;2021-09-07;1222;4633;506;826676;759650;2399;89.3;82.1;0.3
35;2021-09-08;1262;5506;445;827938;765156;2844;89.5;82.7;0.3
35;2021-09-09;1191;4408;475;829129;769564;3319;89.6;83.2;0.4
35;2021-09-10;1463;5543;606;830592;775107;3925;89.8;83.8;0.4
35;2021-09-11;582;3612;113;831174;778719;4038;89.8;84.1;0.4
35;2021-09-12;217;1943;48;831391;780662;4086;89.8;84.4;0.4
35;2021-09-13;1162;3415;580;832553;784077;4666;90.0;84.7;0.5
35;2021-09-14;1242;3014;1228;833795;787091;5894;90.1;85.1;0.6
35;2021-09-15;1103;4206;857;834898;791297;6751;90.2;85.5;0.7
35;2021-09-16;959;2544;997;835857;793841;7748;90.3;85.8;0.8
35;2021-09-17;1173;3461;998;837030;797302;8746;90.4;86.2;0.9
35;2021-09-18;496;2662;165;837526;799964;8911;90.5;86.4;1.0
35;2021-09-19;104;761;28;837630;800725;8939;90.5;86.5;1.0
35;2021-09-20;1042;2283;814;838672;803008;9753;90.6;86.8;1.1
35;2021-09-21;638;1770;1066;839310;804778;10819;90.7;87.0;1.2
35;2021-09-22;751;3258;946;840061;808036;11765;90.8;87.3;1.3
35;2021-09-23;575;1488;1163;840636;809524;12928;90.8;87.5;1.4
35;2021-09-24;849;2697;1025;841485;812221;13953;90.9;87.8;1.5
35;2021-09-25;364;1677;166;841849;813898;14119;91.0;87.9;1.5
35;2021-09-26;8;116;11;841857;814014;14130;91.0;88.0;1.5
35;2021-09-27;485;1464;884;842342;815478;15014;91.0;88.1;1.6
35;2021-09-28;442;1118;1004;842784;816596;16018;91.1;88.2;1.7
35;2021-09-29;551;1824;904;843335;818420;16922;91.1;88.4;1.8
35;2021-09-30;357;854;835;843692;819274;17757;91.2;88.5;1.9
35;2021-10-01;795;2003;1120;844487;821277;18877;91.3;88.7;2.0
35;2021-10-02;332;1025;202;844819;822302;19079;91.3;88.9;2.1
35;2021-10-03;7;29;3;844826;822331;19082;91.3;88.9;2.1
35;2021-10-04;478;940;815;845304;823271;19897;91.3;89.0;2.2
35;2021-10-05;408;876;1061;845712;824147;20958;91.4;89.1;2.3
35;2021-10-06;529;1208;886;846241;825355;21844;91.4;89.2;2.4
35;2021-10-07;352;862;1048;846593;826217;22892;91.5;89.3;2.5
35;2021-10-08;620;1858;1259;847213;828075;24151;91.5;89.5;2.6
35;2021-10-09;349;868;355;847562;828943;24506;91.6;89.6;2.6
35;2021-10-10;6;6;2;847568;828949;24508;91.6;89.6;2.6
35;2021-10-11;391;768;841;847959;829717;25349;91.6;89.7;2.7
35;2021-10-12;366;644;930;848325;830361;26279;91.7;89.7;2.8
35;2021-10-13;460;734;871;848785;831095;27150;91.7;89.8;2.9
35;2021-10-14;297;645;826;849082;831740;27976;91.8;89.9;3.0
35;2021-10-15;597;1421;1636;849679;833161;29612;91.8;90.0;3.2
35;2021-10-16;359;596;462;850038;833757;30074;91.9;90.1;3.2
35;2021-10-17;5;11;0;850043;833768;30074;91.9;90.1;3.2
35;2021-10-18;347;674;857;850390;834442;30931;91.9;90.2;3.3
35;2021-10-19;324;651;943;850714;835093;31874;91.9;90.2;3.4
35;2021-10-20;443;789;1472;851157;835882;33346;92.0;90.3;3.6
35;2021-10-21;279;474;1179;851436;836356;34525;92.0;90.4;3.7
35;2021-10-22;456;882;1796;851892;837238;36321;92.1;90.5;3.9
35;2021-10-23;258;408;581;852150;837646;36902;92.1;90.5;4.0
35;2021-10-24;0;13;10;852150;837659;36912;92.1;90.5;4.0
35;2021-10-25;333;474;1186;852483;838133;38098;92.1;90.6;4.1
35;2021-10-26;282;397;1094;852765;838530;39192;92.1;90.6;4.2
35;2021-10-27;291;474;1312;853056;839004;40504;92.2;90.7;4.4
35;2021-10-28;315;453;1192;853371;839457;41696;92.2;90.7;4.5
35;2021-10-29;462;655;1906;853833;840112;43602;92.3;90.8;4.7
35;2021-10-30;177;283;415;854010;840395;44017;92.3;90.8;4.8
35;2021-10-31;5;10;5;854015;840405;44022;92.3;90.8;4.8
35;2021-11-01;25;14;9;854040;840419;44031;92.3;90.8;4.8
35;2021-11-02;347;557;1404;854387;840976;45435;92.3;90.9;4.9
35;2021-11-03;286;478;1759;854673;841454;47194;92.4;90.9;5.1
35;2021-11-04;254;337;1623;854927;841791;48817;92.4;91.0;5.3
35;2021-11-05;369;571;2481;855296;842362;51298;92.4;91.0;5.5
35;2021-11-06;153;308;596;855449;842670;51894;92.4;91.1;5.6
35;2021-11-07;3;7;3;855452;842677;51897;92.4;91.1;5.6
35;2021-11-08;251;421;2158;855703;843098;54055;92.5;91.1;5.8
35;2021-11-09;330;461;2617;856033;843559;56672;92.5;91.2;6.1
35;2021-11-10;413;530;3011;856446;844089;59683;92.5;91.2;6.4
35;2021-11-11;14;15;58;856460;844104;59741;92.5;91.2;6.5
35;2021-11-12;296;508;2990;856756;844612;62731;92.6;91.3;6.8
35;2021-11-13;169;276;852;856925;844888;63583;92.6;91.3;6.9
35;2021-11-14;6;6;20;856931;844894;63603;92.6;91.3;6.9
35;2021-11-15;241;386;3094;857172;845280;66697;92.6;91.3;7.2
35;2021-11-16;291;351;3495;857463;845631;70192;92.7;91.4;7.6
35;2021-11-17;433;437;3607;857896;846068;73799;92.7;91.4;8.0
35;2021-11-18;318;309;3340;858214;846377;77139;92.7;91.5;8.3
35;2021-11-19;461;550;4437;858675;846927;81576;92.8;91.5;8.8
35;2021-11-20;180;229;1122;858855;847156;82698;92.8;91.5;8.9
35;2021-11-21;4;12;18;858859;847168;82716;92.8;91.5;8.9
35;2021-11-22;303;209;3431;859162;847377;86147;92.8;91.6;9.3
35;2021-11-23;362;275;4141;859524;847652;90288;92.9;91.6;9.8
35;2021-11-24;450;414;3945;859974;848066;94233;92.9;91.6;10.2
35;2021-11-25;302;293;4287;860276;848359;98520;93.0;91.7;10.6
35;2021-11-26;381;432;6622;860657;848791;105142;93.0;91.7;11.4
35;2021-11-27;157;204;1801;860814;848995;106943;93.0;91.7;11.6
35;2021-11-28;8;16;155;860822;849011;107098;93.0;91.7;11.6
35;2021-11-29;197;296;5682;861019;849307;112780;93.0;91.8;12.2
35;2021-11-30;265;348;7404;861284;849655;120184;93.1;91.8;13.0
35;2021-12-01;250;379;7407;861534;850034;127591;93.1;91.9;13.8
35;2021-12-02;227;217;8245;861761;850251;135836;93.1;91.9;14.7
35;2021-12-03;230;368;10690;861991;850619;146526;93.1;91.9;15.8
35;2021-12-04;166;217;3929;862157;850836;150455;93.2;91.9;16.3
35;2021-12-05;36;30;1266;862193;850866;151721;93.2;91.9;16.4
35;2021-12-06;199;263;10295;862392;851129;162016;93.2;92.0;17.5
35;2021-12-07;238;336;12860;862630;851465;174876;93.2;92.0;18.9
35;2021-12-08;273;437;11010;862903;851902;185886;93.2;92.1;20.1
35;2021-12-09;259;328;12114;863162;852230;198000;93.3;92.1;21.4
35;2021-12-10;289;483;14443;863451;852713;212443;93.3;92.1;23.0
35;2021-12-11;180;236;5155;863631;852949;217598;93.3;92.2;23.5
35;2021-12-12;40;25;1679;863671;852974;219277;93.3;92.2;23.7
35;2021-12-13;205;324;11974;863876;853298;231251;93.3;92.2;25.0
35;2021-12-14;267;382;14692;864143;853680;245943;93.4;92.2;26.6
35;2021-12-15;292;473;12906;864435;854153;258849;93.4;92.3;28.0
35;2021-12-16;259;412;15085;864694;854565;273934;93.4;92.3;29.6
35;2021-12-17;304;491;15710;864998;855056;289644;93.5;92.4;31.3
35;2021-12-18;183;193;5559;865181;855249;295203;93.5;92.4;31.9
35;2021-12-19;48;38;2110;865229;855287;297313;93.5;92.4;32.1
36;2020-12-27;0;0;0;0;0;0;0.0;0.0;0.0
36;2020-12-28;1;0;0;1;0;0;0.0;0.0;0.0
36;2020-12-29;0;0;0;1;0;0;0.0;0.0;0.0
36;2020-12-30;0;0;0;1;0;0;0.0;0.0;0.0
36;2020-12-31;0;0;0;1;0;0;0.0;0.0;0.0
36;2021-01-01;0;0;0;1;0;0;0.0;0.0;0.0
36;2021-01-02;0;0;0;1;0;0;0.0;0.0;0.0
36;2021-01-03;0;0;0;1;0;0;0.0;0.0;0.0
36;2021-01-04;0;0;0;1;0;0;0.0;0.0;0.0
36;2021-01-05;0;0;0;1;0;0;0.0;0.0;0.0
36;2021-01-06;20;0;0;21;0;0;0.0;0.0;0.0
36;2021-01-07;51;0;0;72;0;0;0.0;0.0;0.0
36;2021-01-08;110;0;0;182;0;0;0.1;0.0;0.0
36;2021-01-09;84;1;0;266;1;0;0.1;0.0;0.0
36;2021-01-10;135;0;0;401;1;0;0.2;0.0;0.0
36;2021-01-11;213;1;0;614;2;0;0.3;0.0;0.0
36;2021-01-12;280;0;0;894;2;0;0.5;0.0;0.0
36;2021-01-13;187;2;0;1081;4;0;0.6;0.0;0.0
36;2021-01-14;472;4;0;1553;8;0;0.8;0.0;0.0
36;2021-01-15;178;1;0;1731;9;0;0.9;0.0;0.0
36;2021-01-16;24;1;0;1755;10;0;0.9;0.0;0.0
36;2021-01-17;13;1;0;1768;11;0;0.9;0.0;0.0
36;2021-01-18;606;5;0;2374;16;0;1.2;0.0;0.0
36;2021-01-19;1135;1;0;3509;17;0;1.8;0.0;0.0
36;2021-01-20;1087;4;0;4596;21;0;2.4;0.0;0.0
36;2021-01-21;696;1;0;5292;22;0;2.7;0.0;0.0
36;2021-01-22;837;2;0;6129;24;0;3.2;0.0;0.0
36;2021-01-23;291;0;0;6420;24;0;3.3;0.0;0.0
36;2021-01-24;158;1;0;6578;25;0;3.4;0.0;0.0
36;2021-01-25;578;4;0;7156;29;0;3.7;0.0;0.0
36;2021-01-26;570;2;0;7726;31;0;4.0;0.0;0.0
36;2021-01-27;797;14;0;8523;45;0;4.4;0.0;0.0
36;2021-01-28;439;46;0;8962;91;0;4.6;0.0;0.0
36;2021-01-29;473;91;0;9435;182;0;4.9;0.1;0.0
36;2021-01-30;242;71;0;9677;253;0;5.0;0.1;0.0
36;2021-01-31;106;124;0;9783;377;0;5.1;0.2;0.0
36;2021-02-01;323;90;0;10106;467;0;5.2;0.2;0.0
36;2021-02-02;371;162;0;10477;629;0;5.4;0.3;0.0
36;2021-02-03;411;245;0;10888;874;0;5.6;0.5;0.0
36;2021-02-04;248;264;0;11136;1138;0;5.8;0.6;0.0
36;2021-02-05;260;153;0;11396;1291;0;5.9;0.7;0.0
36;2021-02-06;3;1;0;11399;1292;0;5.9;0.7;0.0
36;2021-02-07;2;0;0;11401;1292;0;5.9;0.7;0.0
36;2021-02-08;235;255;0;11636;1547;0;6.0;0.8;0.0
36;2021-02-09;325;591;0;11961;2138;0;6.2;1.1;0.0
36;2021-02-10;473;634;0;12434;2772;0;6.4;1.4;0.0
36;2021-02-11;366;558;0;12800;3330;0;6.6;1.7;0.0
36;2021-02-12;311;443;0;13111;3773;0;6.8;2.0;0.0
36;2021-02-13;128;81;0;13239;3854;0;6.9;2.0;0.0
36;2021-02-14;26;43;0;13265;3897;0;6.9;2.0;0.0
36;2021-02-15;49;545;0;13314;4442;0;6.9;2.3;0.0
36;2021-02-16;114;403;0;13428;4845;0;7.0;2.5;0.0
36;2021-02-17;125;594;0;13553;5439;0;7.0;2.8;0.0
36;2021-02-18;178;576;0;13731;6015;0;7.1;3.1;0.0
36;2021-02-19;169;500;0;13900;6515;0;7.2;3.4;0.0
36;2021-02-20;83;226;0;13983;6741;0;7.2;3.5;0.0
36;2021-02-21;83;145;0;14066;6886;0;7.3;3.6;0.0
36;2021-02-22;162;447;0;14228;7333;0;7.4;3.8;0.0
36;2021-02-23;65;547;0;14293;7880;0;7.4;4.1;0.0
36;2021-02-24;123;656;0;14416;8536;0;7.5;4.4;0.0
36;2021-02-25;266;294;0;14682;8830;0;7.6;4.6;0.0
36;2021-02-26;341;414;0;15023;9244;0;7.8;4.8;0.0
36;2021-02-27;75;262;0;15098;9506;0;7.8;4.9;0.0
36;2021-02-28;13;89;0;15111;9595;0;7.8;5.0;0.0
36;2021-03-01;203;306;0;15314;9901;0;7.9;5.1;0.0
36;2021-03-02;346;341;0;15660;10242;0;8.1;5.3;0.0
36;2021-03-03;385;469;0;16045;10711;0;8.3;5.6;0.0
36;2021-03-04;651;346;0;16696;11057;0;8.7;5.7;0.0
36;2021-03-05;768;278;0;17464;11335;0;9.1;5.9;0.0
36;2021-03-06;403;18;0;17867;11353;0;9.3;5.9;0.0
36;2021-03-07;338;17;0;18205;11370;0;9.4;5.9;0.0
36;2021-03-08;272;265;0;18477;11635;0;9.6;6.0;0.0
36;2021-03-09;454;262;0;18931;11897;0;9.8;6.2;0.0
36;2021-03-10;699;389;0;19630;12286;0;10.2;6.4;0.0
36;2021-03-11;803;253;0;20433;12539;0;10.6;6.5;0.0
36;2021-03-12;1385;279;0;21818;12818;0;11.3;6.6;0.0
36;2021-03-13;554;130;0;22372;12948;0;11.6;6.7;0.0
36;2021-03-14;111;2;0;22483;12950;0;11.7;6.7;0.0
36;2021-03-15;644;159;0;23127;13109;0;12.0;6.8;0.0
36;2021-03-16;440;73;0;23567;13182;0;12.2;6.8;0.0
36;2021-03-17;750;98;0;24317;13280;0;12.6;6.9;0.0
36;2021-03-18;420;80;0;24737;13360;0;12.8;6.9;0.0
36;2021-03-19;714;47;0;25451;13407;0;13.2;6.9;0.0
36;2021-03-20;450;31;0;25901;13438;0;13.4;7.0;0.0
36;2021-03-21;2;0;0;25903;13438;0;13.4;7.0;0.0
36;2021-03-22;500;60;0;26403;13498;0;13.7;7.0;0.0
36;2021-03-23;732;69;0;27135;13567;0;14.1;7.0;0.0
36;2021-03-24;1059;83;0;28194;13650;0;14.6;7.1;0.0
36;2021-03-25;1313;99;0;29507;13749;0;15.3;7.1;0.0
36;2021-03-26;1401;163;0;30908;13912;0;16.0;7.2;0.0
36;2021-03-27;473;45;0;31381;13957;0;16.3;7.2;0.0
36;2021-03-28;68;56;0;31449;14013;0;16.3;7.3;0.0
36;2021-03-29;535;172;0;31984;14185;0;16.6;7.4;0.0
36;2021-03-30;611;256;0;32595;14441;0;16.9;7.5;0.0
36;2021-03-31;1198;167;0;33793;14608;0;17.5;7.6;0.0
36;2021-04-01;1101;420;0;34894;15028;0;18.1;7.8;0.0
36;2021-04-02;903;148;0;35797;15176;0;18.6;7.9;0.0
36;2021-04-03;265;206;0;36062;15382;0;18.7;8.0;0.0
36;2021-04-04;45;2;0;36107;15384;0;18.7;8.0;0.0
36;2021-04-05;16;45;0;36123;15429;0;18.7;8.0;0.0
36;2021-04-06;768;350;0;36891;15779;0;19.1;8.2;0.0
36;2021-04-07;1014;526;0;37905;16305;0;19.6;8.5;0.0
36;2021-04-08;1337;454;0;39242;16759;0;20.3;8.7;0.0
36;2021-04-09;1806;419;0;41048;17178;0;21.3;8.9;0.0
36;2021-04-10;614;227;0;41662;17405;0;21.6;9.0;0.0
36;2021-04-11;236;82;0;41898;17487;0;21.7;9.1;0.0
36;2021-04-12;831;549;0;42729;18036;0;22.1;9.3;0.0
36;2021-04-13;1116;510;0;43845;18546;0;22.7;9.6;0.0
36;2021-04-14;1501;832;0;45346;19378;0;23.5;10.0;0.0
36;2021-04-15;1538;483;0;46884;19861;0;24.3;10.3;0.0
36;2021-04-16;1443;451;0;48327;20312;0;25.1;10.5;0.0
36;2021-04-17;860;255;0;49187;20567;0;25.5;10.7;0.0
36;2021-04-18;345;8;0;49532;20575;0;25.7;10.7;0.0
36;2021-04-19;827;433;0;50359;21008;0;26.1;10.9;0.0
36;2021-04-20;1083;499;0;51442;21507;0;26.7;11.1;0.0
36;2021-04-21;1191;833;0;52633;22340;0;27.3;11.6;0.0
36;2021-04-22;1436;847;0;54069;23187;0;28.0;12.0;0.0
36;2021-04-23;1206;624;0;55275;23811;0;28.7;12.3;0.0
36;2021-04-24;660;380;0;55935;24191;0;29.0;12.5;0.0
36;2021-04-25;374;104;0;56309;24295;0;29.2;12.6;0.0
36;2021-04-26;1068;455;0;57377;24750;0;29.7;12.8;0.0
36;2021-04-27;1139;555;0;58516;25305;0;30.3;13.1;0.0
36;2021-04-28;1306;980;0;59822;26285;0;31.0;13.6;0.0
36;2021-04-29;1699;711;0;61521;26996;0;31.9;14.0;0.0
36;2021-04-30;1375;444;0;62896;27440;0;32.6;14.2;0.0
36;2021-05-01;692;61;0;63588;27501;0;33.0;14.3;0.0
36;2021-05-02;461;64;0;64049;27565;0;33.2;14.3;0.0
36;2021-05-03;1242;322;0;65291;27887;0;33.8;14.5;0.0
36;2021-05-04;753;773;0;66044;28660;0;34.2;14.9;0.0
36;2021-05-05;1221;1257;0;67265;29917;0;34.9;15.5;0.0
36;2021-05-06;1959;780;0;69224;30697;0;35.9;15.9;0.0
36;2021-05-07;1340;754;0;70564;31451;0;36.6;16.3;0.0
36;2021-05-08;344;123;0;70908;31574;0;36.8;16.4;0.0
36;2021-05-09;183;324;0;71091;31898;0;36.9;16.5;0.0
36;2021-05-10;1184;800;0;72275;32698;0;37.5;16.9;0.0
36;2021-05-11;1630;1192;0;73905;33890;0;38.3;17.6;0.0
36;2021-05-12;1690;1365;0;75595;35255;0;39.2;18.3;0.0
36;2021-05-13;592;307;0;76187;35562;0;39.5;18.4;0.0
36;2021-05-14;713;896;0;76900;36458;0;39.9;18.9;0.0
36;2021-05-15;651;584;0;77551;37042;0;40.2;19.2;0.0
36;2021-05-16;336;340;0;77887;37382;0;40.4;19.4;0.0
36;2021-05-17;678;904;0;78565;38286;0;40.7;19.8;0.0
36;2021-05-18;947;946;0;79512;39232;0;41.2;20.3;0.0
36;2021-05-19;1372;816;0;80884;40048;0;41.9;20.8;0.0
36;2021-05-20;1642;1076;0;82526;41124;0;42.8;21.3;0.0
36;2021-05-21;1229;963;0;83755;42087;0;43.4;21.8;0.0
36;2021-05-22;779;342;0;84534;42429;0;43.8;22.0;0.0
36;2021-05-23;428;287;0;84962;42716;0;44.0;22.1;0.0
36;2021-05-24;593;437;0;85555;43153;0;44.3;22.4;0.0
36;2021-05-25;1122;660;0;86677;43813;0;44.9;22.7;0.0
36;2021-05-26;1524;1044;0;88201;44857;0;45.7;23.3;0.0
36;2021-05-27;1520;945;0;89721;45802;0;46.5;23.7;0.0
36;2021-05-28;1012;1396;0;90733;47198;0;47.0;24.5;0.0
36;2021-05-29;778;518;0;91511;47716;0;47.4;24.7;0.0
36;2021-05-30;133;543;0;91644;48259;0;47.5;25.0;0.0
36;2021-05-31;1236;738;0;92880;48997;0;48.1;25.4;0.0
36;2021-06-01;1466;815;0;94346;49812;0;48.9;25.8;0.0
36;2021-06-02;2003;586;0;96349;50398;0;49.9;26.1;0.0
36;2021-06-03;1823;1152;0;98172;51550;0;50.9;26.7;0.0
36;2021-06-04;1764;1030;0;99936;52580;0;51.8;27.3;0.0
36;2021-06-05;827;680;0;100763;53260;0;52.2;27.6;0.0
36;2021-06-06;351;247;0;101114;53507;0;52.4;27.7;0.0
36;2021-06-07;1008;800;0;102122;54307;0;52.9;28.2;0.0
36;2021-06-08;983;913;0;103105;55220;0;53.4;28.6;0.0
36;2021-06-09;1613;956;0;104718;56176;0;54.3;29.1;0.0
36;2021-06-10;1491;1315;0;106209;57491;0;55.1;29.8;0.0
36;2021-06-11;1313;1395;0;107522;58886;0;55.7;30.5;0.0
36;2021-06-12;951;745;0;108473;59631;0;56.2;30.9;0.0
36;2021-06-13;334;270;0;108807;59901;0;56.4;31.0;0.0
36;2021-06-14;601;1201;0;109408;61102;0;56.7;31.7;0.0
36;2021-06-15;695;1150;0;110103;62252;0;57.1;32.3;0.0
36;2021-06-16;880;1413;0;110983;63665;0;57.5;33.0;0.0
36;2021-06-17;768;1806;0;111751;65471;0;57.9;33.9;0.0
36;2021-06-18;719;1789;0;112470;67260;0;58.3;34.9;0.0
36;2021-06-19;348;455;0;112818;67715;0;58.5;35.1;0.0
36;2021-06-20;234;318;0;113052;68033;0;58.6;35.3;0.0
36;2021-06-21;668;1381;0;113720;69414;0;58.9;36.0;0.0
36;2021-06-22;805;1542;0;114525;70956;0;59.4;36.8;0.0
36;2021-06-23;734;1710;0;115259;72666;0;59.7;37.7;0.0
36;2021-06-24;804;1490;0;116063;74156;0;60.2;38.4;0.0
36;2021-06-25;888;1214;0;116951;75370;0;60.6;39.1;0.0
36;2021-06-26;362;634;0;117313;76004;0;60.8;39.4;0.0
36;2021-06-27;107;272;0;117420;76276;0;60.9;39.5;0.0
36;2021-06-28;633;967;0;118053;77243;0;61.2;40.0;0.0
36;2021-06-29;652;1484;0;118705;78727;0;61.5;40.8;0.0
36;2021-06-30;779;2107;0;119484;80834;0;61.9;41.9;0.0
36;2021-07-01;388;1140;0;119872;81974;0;62.1;42.5;0.0
36;2021-07-02;736;1903;0;120608;83877;0;62.5;43.5;0.0
36;2021-07-03;438;1005;0;121046;84882;0;62.7;44.0;0.0
36;2021-07-04;188;339;0;121234;85221;0;62.8;44.2;0.0
36;2021-07-05;459;1417;0;121693;86638;0;63.1;44.9;0.0
36;2021-07-06;501;1295;0;122194;87933;0;63.3;45.6;0.0
36;2021-07-07;552;1852;0;122746;89785;0;63.6;46.5;0.0
36;2021-07-08;546;1735;0;123292;91520;0;63.9;47.4;0.0
36;2021-07-09;721;1660;0;124013;93180;0;64.3;48.3;0.0
36;2021-07-10;459;1191;0;124472;94371;0;64.5;48.9;0.0
36;2021-07-11;250;171;0;124722;94542;0;64.6;49.0;0.0
36;2021-07-12;326;1729;0;125048;96271;0;64.8;49.9;0.0
36;2021-07-13;317;1967;0;125365;98238;0;65.0;50.9;0.0
36;2021-07-14;378;764;0;125743;99002;0;65.2;51.3;0.0
36;2021-07-15;928;2084;0;126671;101086;0;65.7;52.4;0.0
36;2021-07-16;658;1874;0;127329;102960;0;66.0;53.4;0.0
36;2021-07-17;458;1001;0;127787;103961;0;66.2;53.9;0.0
36;2021-07-18;191;396;0;127978;104357;0;66.3;54.1;0.0
36;2021-07-19;641;1515;0;128619;105872;0;66.7;54.9;0.0
36;2021-07-20;863;1407;0;129482;107279;0;67.1;55.6;0.0
36;2021-07-21;897;1936;0;130379;109215;0;67.6;56.6;0.0
36;2021-07-22;1283;1568;0;131662;110783;0;68.2;57.4;0.0
36;2021-07-23;1060;1682;0;132722;112465;0;68.8;58.3;0.0
36;2021-07-24;686;850;0;133408;113315;0;69.2;58.7;0.0
36;2021-07-25;156;401;0;133564;113716;0;69.2;58.9;0.0
36;2021-07-26;1152;1073;0;134716;114789;0;69.8;59.5;0.0
36;2021-07-27;1057;1295;0;135773;116084;0;70.4;60.2;0.0
36;2021-07-28;1547;1374;0;137320;117458;0;71.2;60.9;0.0
36;2021-07-29;1779;1226;0;139099;118684;0;72.1;61.5;0.0
36;2021-07-30;1578;1293;0;140677;119977;0;72.9;62.2;0.0
36;2021-07-31;1009;572;0;141686;120549;0;73.4;62.5;0.0
36;2021-08-01;224;241;0;141910;120790;0;73.6;62.6;0.0
36;2021-08-02;1148;900;0;143058;121690;0;74.2;63.1;0.0
36;2021-08-03;1353;960;0;144411;122650;0;74.9;63.6;0.0
36;2021-08-04;1718;929;0;146129;123579;0;75.7;64.1;0.0
36;2021-08-05;1694;879;0;147823;124458;0;76.6;64.5;0.0
36;2021-08-06;1351;862;0;149174;125320;0;77.3;65.0;0.0
36;2021-08-07;565;553;0;149739;125873;0;77.6;65.2;0.0
36;2021-08-08;289;156;0;150028;126029;0;77.8;65.3;0.0
36;2021-08-09;842;828;0;150870;126857;0;78.2;65.8;0.0
36;2021-08-10;993;1013;0;151863;127870;0;78.7;66.3;0.0
36;2021-08-11;1291;894;0;153154;128764;0;79.4;66.7;0.0
36;2021-08-12;1093;941;0;154247;129705;0;80.0;67.2;0.0
36;2021-08-13;1126;803;0;155373;130508;0;80.5;67.6;0.0
36;2021-08-14;448;810;0;155821;131318;0;80.8;68.1;0.0
36;2021-08-15;343;97;0;156164;131415;0;80.9;68.1;0.0
36;2021-08-16;607;1022;0;156771;132437;0;81.3;68.6;0.0
36;2021-08-17;733;1151;0;157504;133588;0;81.6;69.2;0.0
36;2021-08-18;924;1211;0;158428;134799;0;82.1;69.9;0.0
36;2021-08-19;765;1218;0;159193;136017;0;82.5;70.5;0.0
36;2021-08-20;462;1523;0;159655;137540;0;82.8;71.3;0.0
36;2021-08-21;294;508;0;159949;138048;0;82.9;71.6;0.0
36;2021-08-22;32;73;0;159981;138121;0;82.9;71.6;0.0
36;2021-08-23;501;1271;0;160482;139392;0;83.2;72.3;0.0
36;2021-08-24;542;1258;0;161024;140650;0;83.5;72.9;0.0
36;2021-08-25;457;1146;0;161481;141796;0;83.7;73.5;0.0
36;2021-08-26;586;1507;0;162067;143303;0;84.0;74.3;0.0
36;2021-08-27;511;1427;0;162578;144730;0;84.3;75.0;0.0
36;2021-08-28;348;648;0;162926;145378;0;84.5;75.4;0.0
36;2021-08-29;208;254;0;163134;145632;0;84.6;75.5;0.0
36;2021-08-30;234;808;23;163368;146440;23;84.7;75.9;0.0
36;2021-08-31;359;889;88;163727;147329;111;84.9;76.4;0.1
36;2021-09-01;396;1015;151;164123;148344;262;85.1;76.9;0.1
36;2021-09-02;318;912;142;164441;149256;404;85.2;77.4;0.2
36;2021-09-03;300;1344;134;164741;150600;538;85.4;78.1;0.3
36;2021-09-04;235;799;85;164976;151399;623;85.5;78.5;0.3
36;2021-09-05;119;312;57;165095;151711;680;85.6;78.6;0.4
36;2021-09-06;168;837;179;165263;152548;859;85.7;79.1;0.4
36;2021-09-07;177;690;160;165440;153238;1019;85.8;79.4;0.5
36;2021-09-08;229;1009;177;165669;154247;1196;85.9;80.0;0.6
36;2021-09-09;266;791;185;165935;155038;1381;86.0;80.4;0.7
36;2021-09-10;283;953;182;166218;155991;1563;86.2;80.9;0.8
36;2021-09-11;142;742;41;166360;156733;1604;86.2;81.2;0.8
36;2021-09-12;81;187;45;166441;156920;1649;86.3;81.3;0.9
36;2021-09-13;177;521;169;166618;157441;1818;86.4;81.6;0.9
36;2021-09-14;169;432;385;166787;157873;2203;86.5;81.8;1.1
36;2021-09-15;286;536;352;167073;158409;2555;86.6;82.1;1.3
36;2021-09-16;234;619;269;167307;159028;2824;86.7;82.4;1.5
36;2021-09-17;261;556;150;167568;159584;2974;86.9;82.7;1.5
36;2021-09-18;117;408;90;167685;159992;3064;86.9;82.9;1.6
36;2021-09-19;35;197;22;167720;160189;3086;86.9;83.0;1.6
36;2021-09-20;130;293;273;167850;160482;3359;87.0;83.2;1.7
36;2021-09-21;133;307;238;167983;160789;3597;87.1;83.3;1.9
36;2021-09-22;112;598;296;168095;161387;3893;87.1;83.7;2.0
36;2021-09-23;128;412;364;168223;161799;4257;87.2;83.9;2.2
36;2021-09-24;118;470;319;168341;162269;4576;87.3;84.1;2.4
36;2021-09-25;112;490;129;168453;162759;4705;87.3;84.4;2.4
36;2021-09-26;19;305;55;168472;163064;4760;87.3;84.5;2.5
36;2021-09-27;63;231;192;168535;163295;4952;87.4;84.6;2.6
36;2021-09-28;69;216;221;168604;163511;5173;87.4;84.8;2.7
36;2021-09-29;96;360;287;168700;163871;5460;87.4;84.9;2.8
36;2021-09-30;95;240;371;168795;164111;5831;87.5;85.1;3.0
36;2021-10-01;164;293;282;168959;164404;6113;87.6;85.2;3.2
36;2021-10-02;50;188;133;169009;164592;6246;87.6;85.3;3.2
36;2021-10-03;4;21;8;169013;164613;6254;87.6;85.3;3.2
36;2021-10-04;59;203;356;169072;164816;6610;87.6;85.4;3.4
36;2021-10-05;116;149;328;169188;164965;6938;87.7;85.5;3.6
36;2021-10-06;108;289;294;169296;165254;7232;87.8;85.7;3.7
36;2021-10-07;84;188;268;169380;165442;7500;87.8;85.8;3.9
36;2021-10-08;129;277;483;169509;165719;7983;87.9;85.9;4.1
36;2021-10-09;86;203;188;169595;165922;8171;87.9;86.0;4.2
36;2021-10-10;5;12;17;169600;165934;8188;87.9;86.0;4.2
36;2021-10-11;79;133;251;169679;166067;8439;88.0;86.1;4.4
36;2021-10-12;65;94;341;169744;166161;8780;88.0;86.1;4.6
36;2021-10-13;130;247;513;169874;166408;9293;88.1;86.3;4.8
36;2021-10-14;55;73;360;169929;166481;9653;88.1;86.3;5.0
36;2021-10-15;104;230;431;170033;166711;10084;88.1;86.4;5.2
36;2021-10-16;89;147;182;170122;166858;10266;88.2;86.5;5.3
36;2021-10-17;4;7;13;170126;166865;10279;88.2;86.5;5.3
36;2021-10-18;38;114;193;170164;166979;10472;88.2;86.6;5.4
36;2021-10-19;20;54;139;170184;167033;10611;88.2;86.6;5.5
36;2021-10-20;121;178;513;170305;167211;11124;88.3;86.7;5.8
36;2021-10-21;43;191;304;170348;167402;11428;88.3;86.8;5.9
36;2021-10-22;99;202;414;170447;167604;11842;88.4;86.9;6.1
36;2021-10-23;39;52;198;170486;167656;12040;88.4;86.9;6.2
36;2021-10-24;50;53;60;170536;167709;12100;88.4;86.9;6.3
36;2021-10-25;63;64;312;170599;167773;12412;88.4;87.0;6.4
36;2021-10-26;42;48;244;170641;167821;12656;88.5;87.0;6.6
36;2021-10-27;99;125;475;170740;167946;13131;88.5;87.1;6.8
36;2021-10-28;49;79;457;170789;168025;13588;88.5;87.1;7.0
36;2021-10-29;60;89;237;170849;168114;13825;88.6;87.1;7.2
36;2021-10-30;60;139;321;170909;168253;14146;88.6;87.2;7.3
36;2021-10-31;7;6;4;170916;168259;14150;88.6;87.2;7.3
36;2021-11-01;0;2;2;170916;168261;14152;88.6;87.2;7.3
36;2021-11-02;48;99;312;170964;168360;14464;88.6;87.3;7.5
36;2021-11-03;44;64;335;171008;168424;14799;88.6;87.3;7.7
36;2021-11-04;79;100;587;171087;168524;15386;88.7;87.4;8.0
36;2021-11-05;65;110;570;171152;168634;15956;88.7;87.4;8.3
36;2021-11-06;79;130;442;171231;168764;16398;88.8;87.5;8.5
36;2021-11-07;0;6;13;171231;168770;16411;88.8;87.5;8.5
36;2021-11-08;32;57;435;171263;168827;16846;88.8;87.5;8.7
36;2021-11-09;37;55;441;171300;168882;17287;88.8;87.5;9.0
36;2021-11-10;83;103;634;171383;168985;17921;88.8;87.6;9.3
36;2021-11-11;0;3;27;171383;168988;17948;88.8;87.6;9.3
36;2021-11-12;34;76;456;171417;169064;18404;88.9;87.6;9.5
36;2021-11-13;58;87;488;171475;169151;18892;88.9;87.7;9.8
36;2021-11-14;2;9;26;171477;169160;18918;88.9;87.7;9.8
36;2021-11-15;32;68;598;171509;169228;19516;88.9;87.7;10.1
36;2021-11-16;58;84;802;171567;169312;20318;88.9;87.8;10.5
36;2021-11-17;89;77;782;171656;169389;21100;89.0;87.8;10.9
36;2021-11-18;36;61;569;171692;169450;21669;89.0;87.8;11.2
36;2021-11-19;67;89;972;171759;169539;22641;89.0;87.9;11.7
36;2021-11-20;28;41;372;171787;169580;23013;89.0;87.9;11.9
36;2021-11-21;35;28;213;171822;169608;23226;89.1;87.9;12.0
36;2021-11-22;28;33;529;171850;169641;23755;89.1;87.9;12.3
36;2021-11-23;44;46;822;171894;169687;24577;89.1;88.0;12.7
36;2021-11-24;93;77;1114;171987;169764;25691;89.1;88.0;13.3
36;2021-11-25;65;42;1066;172052;169806;26757;89.2;88.0;13.9
36;2021-11-26;76;80;1479;172128;169886;28236;89.2;88.1;14.6
36;2021-11-27;56;119;691;172184;170005;28927;89.3;88.1;15.0
36;2021-11-28;2;5;52;172186;170010;28979;89.3;88.1;15.0
36;2021-11-29;39;54;1024;172225;170064;30003;89.3;88.2;15.6
36;2021-11-30;54;43;1288;172279;170107;31291;89.3;88.2;16.2
36;2021-12-01;69;49;1612;172348;170156;32903;89.3;88.2;17.1
36;2021-12-02;91;41;2088;172439;170197;34991;89.4;88.2;18.1
36;2021-12-03;55;102;2145;172494;170299;37136;89.4;88.3;19.2
36;2021-12-04;45;31;898;172539;170330;38034;89.4;88.3;19.7
36;2021-12-05;18;27;322;172557;170357;38356;89.4;88.3;19.9
36;2021-12-06;34;33;1263;172591;170390;39619;89.5;88.3;20.5
36;2021-12-07;72;48;2097;172663;170438;41716;89.5;88.3;21.6
36;2021-12-08;62;68;2157;172725;170506;43873;89.5;88.4;22.7
36;2021-12-09;65;53;2860;172790;170559;46733;89.6;88.4;24.2
36;2021-12-10;89;72;2848;172879;170631;49581;89.6;88.4;25.7
36;2021-12-11;33;48;1037;172912;170679;50618;89.6;88.5;26.2
36;2021-12-12;6;6;439;172918;170685;51057;89.6;88.5;26.5
36;2021-12-13;26;84;1553;172944;170769;52610;89.6;88.5;27.3
36;2021-12-14;52;54;2591;172996;170823;55201;89.7;88.5;28.6
36;2021-12-15;68;82;2866;173064;170905;58067;89.7;88.6;30.1
36;2021-12-16;97;84;3194;173161;170989;61261;89.8;88.6;31.8
36;2021-12-17;66;96;3139;173227;171085;64400;89.8;88.7;33.4
36;2021-12-18;34;56;1326;173261;171141;65726;89.8;88.7;34.1
36;2021-12-19;20;27;502;173281;171168;66228;89.8;88.7;34.3
37;2020-12-27;0;0;0;0;0;0;0.0;0.0;0.0
37;2020-12-28;16;0;0;16;0;0;0.0;0.0;0.0
37;2020-12-29;9;0;0;25;0;0;0.0;0.0;0.0
37;2020-12-30;0;0;0;25;0;0;0.0;0.0;0.0
37;2020-12-31;0;0;0;25;0;0;0.0;0.0;0.0
37;2021-01-01;0;0;0;25;0;0;0.0;0.0;0.0
37;2021-01-02;0;0;0;25;0;0;0.0;0.0;0.0
37;2021-01-03;0;0;0;25;0;0;0.0;0.0;0.0
37;2021-01-04;23;0;0;48;0;0;0.0;0.0;0.0
37;2021-01-05;44;0;0;92;0;0;0.0;0.0;0.0
37;2021-01-06;89;0;0;181;0;0;0.0;0.0;0.0
37;2021-01-07;128;1;0;309;1;0;0.1;0.0;0.0
37;2021-01-08;456;2;0;765;3;0;0.1;0.0;0.0
37;2021-01-09;80;2;0;845;5;0;0.2;0.0;0.0
37;2021-01-10;83;0;0;928;5;0;0.2;0.0;0.0
37;2021-01-11;290;0;0;1218;5;0;0.2;0.0;0.0
37;2021-01-12;660;6;0;1878;11;0;0.4;0.0;0.0
37;2021-01-13;539;1;0;2417;12;0;0.5;0.0;0.0
37;2021-01-14;534;3;0;2951;15;0;0.6;0.0;0.0
37;2021-01-15;636;2;0;3587;17;0;0.7;0.0;0.0
37;2021-01-16;291;2;0;3878;19;0;0.7;0.0;0.0
37;2021-01-17;245;1;0;4123;20;0;0.8;0.0;0.0
37;2021-01-18;752;11;0;4875;31;0;0.9;0.0;0.0
37;2021-01-19;1238;11;0;6113;42;0;1.2;0.0;0.0
37;2021-01-20;1051;5;0;7164;47;0;1.4;0.0;0.0
37;2021-01-21;903;0;0;8067;47;0;1.5;0.0;0.0
37;2021-01-22;789;1;0;8856;48;0;1.7;0.0;0.0
37;2021-01-23;178;0;0;9034;48;0;1.7;0.0;0.0
37;2021-01-24;14;0;0;9048;48;0;1.7;0.0;0.0
37;2021-01-25;560;19;0;9608;67;0;1.8;0.0;0.0
37;2021-01-26;1753;69;0;11361;136;0;2.2;0.0;0.0
37;2021-01-27;1439;77;0;12800;213;0;2.4;0.0;0.0
37;2021-01-28;1500;99;0;14300;312;0;2.7;0.1;0.0
37;2021-01-29;658;306;0;14958;618;0;2.9;0.1;0.0
37;2021-01-30;240;60;0;15198;678;0;2.9;0.1;0.0
37;2021-01-31;14;64;0;15212;742;0;2.9;0.1;0.0
37;2021-02-01;363;211;0;15575;953;0;3.0;0.2;0.0
37;2021-02-02;500;514;0;16075;1467;0;3.1;0.3;0.0
37;2021-02-03;655;361;0;16730;1828;0;3.2;0.3;0.0
37;2021-02-04;594;407;0;17324;2235;0;3.3;0.4;0.0
37;2021-02-05;466;462;0;17790;2697;0;3.4;0.5;0.0
37;2021-02-06;198;6;0;17988;2703;0;3.4;0.5;0.0
37;2021-02-07;24;1;0;18012;2704;0;3.4;0.5;0.0
37;2021-02-08;341;354;0;18353;3058;0;3.5;0.6;0.0
37;2021-02-09;609;728;0;18962;3786;0;3.6;0.7;0.0
37;2021-02-10;659;533;0;19621;4319;0;3.7;0.8;0.0
37;2021-02-11;654;598;0;20275;4917;0;3.9;0.9;0.0
37;2021-02-12;546;579;0;20821;5496;0;4.0;1.0;0.0
37;2021-02-13;152;200;0;20973;5696;0;4.0;1.1;0.0
37;2021-02-14;3;57;0;20976;5753;0;4.0;1.1;0.0
37;2021-02-15;414;495;0;21390;6248;0;4.1;1.2;0.0
37;2021-02-16;826;1390;0;22216;7638;0;4.2;1.5;0.0
37;2021-02-17;626;1311;0;22842;8949;0;4.4;1.7;0.0
37;2021-02-18;895;1386;0;23737;10335;0;4.5;2.0;0.0
37;2021-02-19;804;809;0;24541;11144;0;4.7;2.1;0.0
37;2021-02-20;234;216;0;24775;11360;0;4.7;2.2;0.0
37;2021-02-21;6;13;0;24781;11373;0;4.7;2.2;0.0
37;2021-02-22;329;614;0;25110;11987;0;4.8;2.3;0.0
37;2021-02-23;605;630;0;25715;12617;0;4.9;2.4;0.0
37;2021-02-24;551;644;0;26266;13261;0;5.0;2.5;0.0
37;2021-02-25;857;654;0;27123;13915;0;5.2;2.7;0.0
37;2021-02-26;1082;571;0;28205;14486;0;5.4;2.8;0.0
37;2021-02-27;569;196;0;28774;14682;0;5.5;2.8;0.0
37;2021-02-28;24;5;0;28798;14687;0;5.5;2.8;0.0
37;2021-03-01;601;378;0;29399;15065;0;5.6;2.9;0.0
37;2021-03-02;1082;558;0;30481;15623;0;5.8;3.0;0.0
37;2021-03-03;1002;575;0;31483;16198;0;6.0;3.1;0.0
37;2021-03-04;1574;529;0;33057;16727;0;6.3;3.2;0.0
37;2021-03-05;2149;590;0;35206;17317;0;6.7;3.3;0.0
37;2021-03-06;1204;223;0;36410;17540;0;6.9;3.3;0.0
37;2021-03-07;494;76;0;36904;17616;0;7.0;3.4;0.0
37;2021-03-08;679;419;0;37583;18035;0;7.2;3.4;0.0
37;2021-03-09;1623;702;0;39206;18737;0;7.5;3.6;0.0
37;2021-03-10;1606;754;0;40812;19491;0;7.8;3.7;0.0
37;2021-03-11;2096;721;0;42908;20212;0;8.2;3.9;0.0
37;2021-03-12;3239;530;0;46147;20742;0;8.8;4.0;0.0
37;2021-03-13;1945;193;0;48092;20935;0;9.2;4.0;0.0
37;2021-03-14;226;5;0;48318;20940;0;9.2;4.0;0.0
37;2021-03-15;1050;260;0;49368;21200;0;9.4;4.0;0.0
37;2021-03-16;1070;517;0;50438;21717;0;9.6;4.1;0.0
37;2021-03-17;981;284;0;51419;22001;0;9.8;4.2;0.0
37;2021-03-18;1067;522;0;52486;22523;0;10.0;4.3;0.0
37;2021-03-19;2252;340;0;54738;22863;0;10.4;4.4;0.0
37;2021-03-20;1333;143;0;56071;23006;0;10.7;4.4;0.0
37;2021-03-21;195;5;0;56266;23011;0;10.7;4.4;0.0
37;2021-03-22;1295;250;0;57561;23261;0;11.0;4.4;0.0
37;2021-03-23;2285;569;0;59846;23830;0;11.4;4.5;0.0
37;2021-03-24;2287;469;0;62133;24299;0;11.8;4.6;0.0
37;2021-03-25;3085;443;0;65218;24742;0;12.4;4.7;0.0
37;2021-03-26;3574;425;0;68792;25167;0;13.1;4.8;0.0
37;2021-03-27;1206;126;0;69998;25293;0;13.3;4.8;0.0
37;2021-03-28;145;15;0;70143;25308;0;13.4;4.8;0.0
37;2021-03-29;1626;362;0;71769;25670;0;13.7;4.9;0.0
37;2021-03-30;2570;667;0;74339;26337;0;14.2;5.0;0.0
37;2021-03-31;2135;505;0;76474;26842;0;14.6;5.1;0.0
37;2021-04-01;2642;990;0;79116;27832;0;15.1;5.3;0.0
37;2021-04-02;2843;697;0;81959;28529;0;15.6;5.4;0.0
37;2021-04-03;809;244;0;82768;28773;0;15.8;5.5;0.0
37;2021-04-04;107;14;0;82875;28787;0;15.8;5.5;0.0
37;2021-04-05;37;3;0;82912;28790;0;15.8;5.5;0.0
37;2021-04-06;2246;788;0;85158;29578;0;16.2;5.6;0.0
37;2021-04-07;3201;902;0;88359;30480;0;16.8;5.8;0.0
37;2021-04-08;3983;1010;0;92342;31490;0;17.6;6.0;0.0
37;2021-04-09;4523;999;0;96865;32489;0;18.5;6.2;0.0
37;2021-04-10;1341;459;0;98206;32948;0;18.7;6.3;0.0
37;2021-04-11;114;23;0;98320;32971;0;18.7;6.3;0.0
37;2021-04-12;2590;695;0;100910;33666;0;19.2;6.4;0.0
37;2021-04-13;4094;1223;0;105004;34889;0;20.0;6.7;0.0
37;2021-04-14;3076;930;0;108080;35819;0;20.6;6.8;0.0
37;2021-04-15;3777;1030;0;111857;36849;0;21.3;7.0;0.0
37;2021-04-16;4283;1236;0;116140;38085;0;22.1;7.3;0.0
37;2021-04-17;1176;254;0;117316;38339;0;22.4;7.3;0.0
37;2021-04-18;115;12;0;117431;38351;0;22.4;7.3;0.0
37;2021-04-19;2469;882;0;119900;39233;0;22.9;7.5;0.0
37;2021-04-20;3219;1378;0;123119;40611;0;23.5;7.7;0.0
37;2021-04-21;2970;1254;0;126089;41865;0;24.0;8.0;0.0
37;2021-04-22;3553;1519;0;129642;43384;0;24.7;8.3;0.0
37;2021-04-23;3717;1831;0;133359;45215;0;25.4;8.6;0.0
37;2021-04-24;1153;446;0;134512;45661;0;25.6;8.7;0.0
37;2021-04-25;173;11;0;134685;45672;0;25.7;8.7;0.0
37;2021-04-26;2982;1369;0;137667;47041;0;26.2;9.0;0.0
37;2021-04-27;4278;1873;0;141945;48914;0;27.1;9.3;0.0
37;2021-04-28;3626;1951;0;145571;50865;0;27.8;9.7;0.0
37;2021-04-29;4761;2042;0;150332;52907;0;28.7;10.1;0.0
37;2021-04-30;5029;2036;0;155361;54943;0;29.6;10.5;0.0
37;2021-05-01;645;200;0;156006;55143;0;29.7;10.5;0.0
37;2021-05-02;131;29;0;156137;55172;0;29.8;10.5;0.0
37;2021-05-03;2786;1916;0;158923;57088;0;30.3;10.9;0.0
37;2021-05-04;3771;2747;0;162694;59835;0;31.0;11.4;0.0
37;2021-05-05;3640;2117;0;166334;61952;0;31.7;11.8;0.0
37;2021-05-06;5042;2022;0;171376;63974;0;32.7;12.2;0.0
37;2021-05-07;4649;2846;0;176025;66820;0;33.6;12.7;0.0
37;2021-05-08;645;318;0;176670;67138;0;33.7;12.8;0.0
37;2021-05-09;145;67;0;176815;67205;0;33.7;12.8;0.0
37;2021-05-10;2352;3423;0;179167;70628;0;34.2;13.5;0.0
37;2021-05-11;4070;3945;0;183237;74573;0;34.9;14.2;0.0
37;2021-05-12;4326;2658;0;187563;77231;0;35.8;14.7;0.0
37;2021-05-13;1435;534;0;188998;77765;0;36.0;14.8;0.0
37;2021-05-14;4160;2627;0;193158;80392;0;36.8;15.3;0.0
37;2021-05-15;2548;782;0;195706;81174;0;37.3;15.5;0.0
37;2021-05-16;205;113;0;195911;81287;0;37.3;15.5;0.0
37;2021-05-17;3005;2044;0;198916;83331;0;37.9;15.9;0.0
37;2021-05-18;4171;2395;0;203087;85726;0;38.7;16.3;0.0
37;2021-05-19;3887;1870;0;206974;87596;0;39.5;16.7;0.0
37;2021-05-20;5098;1904;0;212072;89500;0;40.4;17.1;0.0
37;2021-05-21;4719;2583;0;216791;92083;0;41.3;17.6;0.0
37;2021-05-22;1375;748;0;218166;92831;0;41.6;17.7;0.0
37;2021-05-23;148;90;0;218314;92921;0;41.6;17.7;0.0
37;2021-05-24;890;121;0;219204;93042;0;41.8;17.7;0.0
37;2021-05-25;5176;2182;0;224380;95224;0;42.8;18.2;0.0
37;2021-05-26;5105;2186;0;229485;97410;0;43.7;18.6;0.0
37;2021-05-27;6091;2419;0;235576;99829;0;44.9;19.0;0.0
37;2021-05-28;6004;3270;0;241580;103099;0;46.1;19.7;0.0
37;2021-05-29;1743;1187;0;243323;104286;0;46.4;19.9;0.0
37;2021-05-30;131;169;0;243454;104455;0;46.4;19.9;0.0
37;2021-05-31;3725;2529;0;247179;106984;0;47.1;20.4;0.0
37;2021-06-01;5855;3543;0;253034;110527;0;48.2;21.1;0.0
37;2021-06-02;5219;2562;0;258253;113089;0;49.2;21.6;0.0
37;2021-06-03;6202;2961;0;264455;116050;0;50.4;22.1;0.0
37;2021-06-04;5633;4214;0;270088;120264;0;51.5;22.9;0.0
37;2021-06-05;2039;1434;0;272127;121698;0;51.9;23.2;0.0
37;2021-06-06;134;292;0;272261;121990;0;51.9;23.3;0.0
37;2021-06-07;3121;4165;0;275382;126155;0;52.5;24.0;0.0
37;2021-06-08;4190;4671;0;279572;130826;0;53.3;24.9;0.0
37;2021-06-09;3947;3774;0;283519;134600;0;54.0;25.7;0.0
37;2021-06-10;5172;3717;0;288691;138317;0;55.0;26.4;0.0
37;2021-06-11;4883;4843;0;293574;143160;0;56.0;27.3;0.0
37;2021-06-12;3542;1368;0;297116;144528;0;56.6;27.6;0.0
37;2021-06-13;83;298;0;297199;144826;0;56.7;27.6;0.0
37;2021-06-14;2625;4129;0;299824;148955;0;57.2;28.4;0.0
37;2021-06-15;3861;4796;0;303685;153751;0;57.9;29.3;0.0
37;2021-06-16;3234;3731;0;306919;157482;0;58.5;30.0;0.0
37;2021-06-17;3903;4556;0;310822;162038;0;59.3;30.9;0.0
37;2021-06-18;4474;5118;0;315296;167156;0;60.1;31.9;0.0
37;2021-06-19;2451;1248;0;317747;168404;0;60.6;32.1;0.0
37;2021-06-20;43;245;0;317790;168649;0;60.6;32.2;0.0
37;2021-06-21;2372;3946;0;320162;172595;0;61.0;32.9;0.0
37;2021-06-22;2876;5187;0;323038;177782;0;61.6;33.9;0.0
37;2021-06-23;2585;3959;0;325623;181741;0;62.1;34.6;0.0
37;2021-06-24;2790;3664;0;328413;185405;0;62.6;35.3;0.0
37;2021-06-25;3209;4950;0;331622;190355;0;63.2;36.3;0.0
37;2021-06-26;1203;3183;0;332825;193538;0;63.4;36.9;0.0
37;2021-06-27;51;236;0;332876;193774;0;63.5;36.9;0.0
37;2021-06-28;1685;4686;0;334561;198460;0;63.8;37.8;0.0
37;2021-06-29;1848;6421;0;336409;204881;0;64.1;39.1;0.0
37;2021-06-30;1880;4753;0;338289;209634;0;64.5;40.0;0.0
37;2021-07-01;2098;4948;0;340387;214582;0;64.9;40.9;0.0
37;2021-07-02;2654;5733;0;343041;220315;0;65.4;42.0;0.0
37;2021-07-03;887;2295;0;343928;222610;0;65.6;42.4;0.0
37;2021-07-04;30;184;0;343958;222794;0;65.6;42.5;0.0
37;2021-07-05;1598;5195;0;345556;227989;0;65.9;43.5;0.0
37;2021-07-06;1886;6758;0;347442;234747;0;66.2;44.8;0.0
37;2021-07-07;1829;5522;0;349271;240269;0;66.6;45.8;0.0
37;2021-07-08;2355;6690;0;351626;246959;0;67.0;47.1;0.0
37;2021-07-09;1985;7580;0;353611;254539;0;67.4;48.5;0.0
37;2021-07-10;1017;2789;0;354628;257328;0;67.6;49.1;0.0
37;2021-07-11;56;168;0;354684;257496;0;67.6;49.1;0.0
37;2021-07-12;1160;6009;0;355844;263505;0;67.8;50.2;0.0
37;2021-07-13;1703;7774;0;357547;271279;0;68.2;51.7;0.0
37;2021-07-14;622;600;0;358169;271879;0;68.3;51.8;0.0
37;2021-07-15;2620;7550;0;360789;279429;0;68.8;53.3;0.0
37;2021-07-16;2739;7699;0;363528;287128;0;69.3;54.7;0.0
37;2021-07-17;1241;2582;0;364769;289710;0;69.5;55.2;0.0
37;2021-07-18;144;147;0;364913;289857;0;69.6;55.3;0.0
37;2021-07-19;1750;6130;0;366663;295987;0;69.9;56.4;0.0
37;2021-07-20;2989;6965;0;369652;302952;0;70.5;57.8;0.0
37;2021-07-21;3088;5636;0;372740;308588;0;71.1;58.8;0.0
37;2021-07-22;4034;6352;0;376774;314940;0;71.8;60.0;0.0
37;2021-07-23;3852;6896;0;380626;321836;0;72.6;61.4;0.0
37;2021-07-24;1805;3178;0;382431;325014;0;72.9;62.0;0.0
37;2021-07-25;146;145;0;382577;325159;0;72.9;62.0;0.0
37;2021-07-26;3301;4293;0;385878;329452;0;73.6;62.8;0.0
37;2021-07-27;4286;4884;0;390164;334336;0;74.4;63.7;0.0
37;2021-07-28;4163;3680;0;394327;338016;0;75.2;64.4;0.0
37;2021-07-29;4991;4210;0;399318;342226;0;76.1;65.2;0.0
37;2021-07-30;5026;4804;0;404344;347030;0;77.1;66.2;0.0
37;2021-07-31;1941;1809;0;406285;348839;0;77.5;66.5;0.0
37;2021-08-01;119;72;0;406404;348911;0;77.5;66.5;0.0
37;2021-08-02;3359;3193;0;409763;352104;0;78.1;67.1;0.0
37;2021-08-03;5031;3066;0;414794;355170;0;79.1;67.7;0.0
37;2021-08-04;4505;1969;0;419299;357139;0;79.9;68.1;0.0
37;2021-08-05;4678;2581;0;423977;359720;0;80.8;68.6;0.0
37;2021-08-06;4602;3229;0;428579;362949;0;81.7;69.2;0.0
37;2021-08-07;1633;1114;0;430212;364063;0;82.0;69.4;0.0
37;2021-08-08;104;201;0;430316;364264;0;82.0;69.4;0.0
37;2021-08-09;2354;2147;0;432670;366411;0;82.5;69.8;0.0
37;2021-08-10;2968;2646;0;435638;369057;0;83.0;70.4;0.0
37;2021-08-11;2073;2199;0;437711;371256;0;83.4;70.8;0.0
37;2021-08-12;2406;2640;0;440117;373896;0;83.9;71.3;0.0
37;2021-08-13;2358;2791;0;442475;376687;0;84.4;71.8;0.0
37;2021-08-14;755;877;0;443230;377564;0;84.5;72.0;0.0
37;2021-08-15;42;101;0;443272;377665;0;84.5;72.0;0.0
37;2021-08-16;1467;3174;0;444739;380839;0;84.8;72.6;0.0
37;2021-08-17;1783;3866;0;446522;384705;0;85.1;73.3;0.0
37;2021-08-18;1412;3172;0;447934;387877;0;85.4;73.9;0.0
37;2021-08-19;1499;3664;0;449433;391541;0;85.7;74.6;0.0
37;2021-08-20;1554;4442;0;450987;395983;0;86.0;75.5;0.0
37;2021-08-21;645;1259;0;451632;397242;0;86.1;75.7;0.0
37;2021-08-22;25;99;0;451657;397341;0;86.1;75.7;0.0
37;2021-08-23;1258;3964;0;452915;401305;0;86.3;76.5;0.0
37;2021-08-24;1529;4723;0;454444;406028;0;86.6;77.4;0.0
37;2021-08-25;1031;4159;0;455475;410187;0;86.8;78.2;0.0
37;2021-08-26;1257;4254;0;456732;414441;0;87.1;79.0;0.0
37;2021-08-27;1385;5378;0;458117;419819;0;87.3;80.0;0.0
37;2021-08-28;413;1473;0;458530;421292;0;87.4;80.3;0.0
37;2021-08-29;11;57;0;458541;421349;0;87.4;80.3;0.0
37;2021-08-30;1041;3731;68;459582;425080;68;87.6;81.0;0.0
37;2021-08-31;1233;3635;123;460815;428715;191;87.8;81.7;0.0
37;2021-09-01;991;2500;196;461806;431215;387;88.0;82.2;0.1
37;2021-09-02;877;2403;288;462683;433618;675;88.2;82.7;0.1
37;2021-09-03;978;3317;390;463661;436935;1065;88.4;83.3;0.2
37;2021-09-04;656;1331;138;464317;438266;1203;88.5;83.5;0.2
37;2021-09-05;7;42;2;464324;438308;1205;88.5;83.6;0.2
37;2021-09-06;376;1134;218;464700;439442;1423;88.6;83.8;0.3
37;2021-09-07;514;1300;232;465214;440742;1655;88.7;84.0;0.3
37;2021-09-08;803;1812;229;466017;442554;1884;88.8;84.4;0.4
37;2021-09-09;543;1298;284;466560;443852;2168;88.9;84.6;0.4
37;2021-09-10;754;1546;310;467314;445398;2478;89.1;84.9;0.5
37;2021-09-11;384;1027;78;467698;446425;2556;89.2;85.1;0.5
37;2021-09-12;16;44;10;467714;446469;2566;89.2;85.1;0.5
37;2021-09-13;434;1077;373;468148;447546;2939;89.2;85.3;0.6
37;2021-09-14;500;1112;495;468648;448658;3434;89.3;85.5;0.7
37;2021-09-15;611;1450;573;469259;450108;4007;89.5;85.8;0.8
37;2021-09-16;360;815;574;469619;450923;4581;89.5;86.0;0.9
37;2021-09-17;594;1423;536;470213;452346;5117;89.6;86.2;1.0
37;2021-09-18;292;869;134;470505;453215;5251;89.7;86.4;1.0
37;2021-09-19;23;55;20;470528;453270;5271;89.7;86.4;1.0
37;2021-09-20;269;666;423;470797;453936;5694;89.7;86.5;1.1
37;2021-09-21;387;1216;914;471184;455152;6608;89.8;86.8;1.3
37;2021-09-22;392;1231;468;471576;456383;7076;89.9;87.0;1.3
37;2021-09-23;406;1009;556;471982;457392;7632;90.0;87.2;1.5
37;2021-09-24;475;1298;545;472457;458690;8177;90.1;87.4;1.6
37;2021-09-25;221;764;103;472678;459454;8280;90.1;87.6;1.6
37;2021-09-26;6;28;2;472684;459482;8282;90.1;87.6;1.6
37;2021-09-27;272;655;385;472956;460137;8667;90.2;87.7;1.7
37;2021-09-28;381;626;467;473337;460763;9134;90.2;87.8;1.7
37;2021-09-29;357;905;569;473694;461668;9703;90.3;88.0;1.8
37;2021-09-30;370;488;691;474064;462156;10394;90.4;88.1;2.0
37;2021-10-01;460;774;636;474524;462930;11030;90.5;88.2;2.1
37;2021-10-02;228;533;190;474752;463463;11220;90.5;88.4;2.1
37;2021-10-03;16;26;1;474768;463489;11221;90.5;88.4;2.1
37;2021-10-04;260;501;418;475028;463990;11639;90.6;88.5;2.2
37;2021-10-05;310;407;660;475338;464397;12299;90.6;88.5;2.3
37;2021-10-06;346;648;567;475684;465045;12866;90.7;88.7;2.5
37;2021-10-07;271;396;666;475955;465441;13532;90.7;88.7;2.6
37;2021-10-08;402;621;690;476357;466062;14222;90.8;88.8;2.7
37;2021-10-09;197;459;182;476554;466521;14404;90.8;88.9;2.7
37;2021-10-10;6;16;2;476560;466537;14406;90.8;88.9;2.7
37;2021-10-11;214;338;480;476774;466875;14886;90.9;89.0;2.8
37;2021-10-12;216;403;675;476990;467278;15561;90.9;89.1;3.0
37;2021-10-13;300;487;601;477290;467765;16162;91.0;89.2;3.1
37;2021-10-14;207;388;722;477497;468153;16884;91.0;89.2;3.2
37;2021-10-15;371;673;902;477868;468826;17786;91.1;89.4;3.4
37;2021-10-16;223;317;183;478091;469143;17969;91.1;89.4;3.4
37;2021-10-17;9;4;1;478100;469147;17970;91.1;89.4;3.4
37;2021-10-18;204;276;492;478304;469423;18462;91.2;89.5;3.5
37;2021-10-19;178;337;851;478482;469760;19313;91.2;89.6;3.7
37;2021-10-20;247;391;897;478729;470151;20210;91.3;89.6;3.9
37;2021-10-21;166;384;840;478895;470535;21050;91.3;89.7;4.0
37;2021-10-22;355;566;1139;479250;471101;22189;91.4;89.8;4.2
37;2021-10-23;127;186;266;479377;471287;22455;91.4;89.8;4.3
37;2021-10-24;7;12;4;479384;471299;22459;91.4;89.8;4.3
37;2021-10-25;179;229;688;479563;471528;23147;91.4;89.9;4.4
37;2021-10-26;163;240;773;479726;471768;23920;91.5;89.9;4.6
37;2021-10-27;220;406;1100;479946;472174;25020;91.5;90.0;4.8
37;2021-10-28;164;195;696;480110;472369;25716;91.5;90.0;4.9
37;2021-10-29;246;392;1171;480356;472761;26887;91.6;90.1;5.1
37;2021-10-30;97;134;282;480453;472895;27169;91.6;90.1;5.2
37;2021-10-31;3;9;1;480456;472904;27170;91.6;90.2;5.2
37;2021-11-01;11;8;10;480467;472912;27180;91.6;90.2;5.2
37;2021-11-02;212;342;1024;480679;473254;28204;91.6;90.2;5.4
37;2021-11-03;193;295;1206;480872;473549;29410;91.7;90.3;5.6
37;2021-11-04;124;199;1113;480996;473748;30523;91.7;90.3;5.8
37;2021-11-05;302;401;1568;481298;474149;32091;91.8;90.4;6.1
37;2021-11-06;120;203;502;481418;474352;32593;91.8;90.4;6.2
37;2021-11-07;0;11;11;481418;474363;32604;91.8;90.4;6.2
37;2021-11-08;140;234;1041;481558;474597;33645;91.8;90.5;6.4
37;2021-11-09;148;274;2418;481706;474871;36063;91.8;90.5;6.9
37;2021-11-10;211;316;1876;481917;475187;37939;91.9;90.6;7.2
37;2021-11-11;13;12;66;481930;475199;38005;91.9;90.6;7.2
37;2021-11-12;221;428;1844;482151;475627;39849;91.9;90.7;7.6
37;2021-11-13;61;123;501;482212;475750;40350;91.9;90.7;7.7
37;2021-11-14;4;11;5;482216;475761;40355;91.9;90.7;7.7
37;2021-11-15;105;205;1749;482321;475966;42104;91.9;90.7;8.0
37;2021-11-16;207;214;2704;482528;476180;44808;92.0;90.8;8.5
37;2021-11-17;239;255;2240;482767;476435;47048;92.0;90.8;9.0
37;2021-11-18;157;178;2093;482924;476613;49141;92.1;90.9;9.4
37;2021-11-19;300;352;3334;483224;476965;52475;92.1;90.9;10.0
37;2021-11-20;153;164;857;483377;477129;53332;92.1;91.0;10.2
37;2021-11-21;0;7;11;483377;477136;53343;92.1;91.0;10.2
37;2021-11-22;143;90;1567;483520;477226;54910;92.2;91.0;10.5
37;2021-11-23;208;187;2726;483728;477413;57636;92.2;91.0;11.0
37;2021-11-24;264;224;2294;483992;477637;59930;92.3;91.1;11.4
37;2021-11-25;137;154;2621;484129;477791;62551;92.3;91.1;11.9
37;2021-11-26;285;344;4636;484414;478135;67187;92.3;91.1;12.8
37;2021-11-27;123;141;1408;484537;478276;68595;92.4;91.2;13.1
37;2021-11-28;3;16;72;484540;478292;68667;92.4;91.2;13.1
37;2021-11-29;82;157;2937;484622;478449;71604;92.4;91.2;13.7
37;2021-11-30;191;157;4722;484813;478606;76326;92.4;91.2;14.6
37;2021-12-01;170;215;4834;484983;478821;81160;92.5;91.3;15.5
37;2021-12-02;108;118;5995;485091;478939;87155;92.5;91.3;16.6
37;2021-12-03;211;237;7408;485302;479176;94563;92.5;91.3;18.0
37;2021-12-04;68;90;3009;485370;479266;97572;92.5;91.4;18.6
37;2021-12-05;7;10;150;485377;479276;97722;92.5;91.4;18.6
37;2021-12-06;110;135;5093;485487;479411;102815;92.5;91.4;19.6
37;2021-12-07;150;208;7011;485637;479619;109826;92.6;91.4;20.9
37;2021-12-08;111;219;5772;485748;479838;115598;92.6;91.5;22.0
37;2021-12-09;145;166;7389;485893;480004;122987;92.6;91.5;23.4
37;2021-12-10;146;322;8469;486039;480326;131456;92.7;91.6;25.1
37;2021-12-11;91;142;4048;486130;480468;135504;92.7;91.6;25.8
37;2021-12-12;13;9;370;486143;480477;135874;92.7;91.6;25.9
37;2021-12-13;99;179;5626;486242;480656;141500;92.7;91.6;27.0
37;2021-12-14;198;251;8956;486440;480907;150456;92.7;91.7;28.7
37;2021-12-15;153;283;7136;486593;481190;157592;92.8;91.7;30.0
37;2021-12-16;189;205;8296;486782;481395;165888;92.8;91.8;31.6
37;2021-12-17;211;335;9244;486993;481730;175132;92.8;91.8;33.4
37;2021-12-18;123;126;4171;487116;481856;179303;92.9;91.9;34.2
37;2021-12-19;24;18;807;487140;481874;180110;92.9;91.9;34.3
38;2020-12-27;1;0;0;1;0;0;0.0;0.0;0.0
38;2020-12-28;0;0;0;1;0;0;0.0;0.0;0.0
38;2020-12-29;0;0;0;1;0;0;0.0;0.0;0.0
38;2020-12-30;0;0;0;1;0;0;0.0;0.0;0.0
38;2020-12-31;5;0;0;6;0;0;0.0;0.0;0.0
38;2021-01-01;2;0;0;8;0;0;0.0;0.0;0.0
38;2021-01-02;0;0;0;8;0;0;0.0;0.0;0.0
38;2021-01-03;1;1;0;9;1;0;0.0;0.0;0.0
38;2021-01-04;156;0;0;165;1;0;0.0;0.0;0.0
38;2021-01-05;263;1;0;428;2;0;0.0;0.0;0.0
38;2021-01-06;384;0;0;812;2;0;0.1;0.0;0.0
38;2021-01-07;677;1;0;1489;3;0;0.1;0.0;0.0
38;2021-01-08;716;0;0;2205;3;0;0.2;0.0;0.0
38;2021-01-09;39;0;0;2244;3;0;0.2;0.0;0.0
38;2021-01-10;1;0;0;2245;3;0;0.2;0.0;0.0
38;2021-01-11;849;3;0;3094;6;0;0.3;0.0;0.0
38;2021-01-12;1498;4;0;4592;10;0;0.4;0.0;0.0
38;2021-01-13;1154;8;0;5746;18;0;0.5;0.0;0.0
38;2021-01-14;1723;16;0;7469;34;0;0.7;0.0;0.0
38;2021-01-15;1687;9;0;9156;43;0;0.8;0.0;0.0
38;2021-01-16;319;2;0;9475;45;0;0.9;0.0;0.0
38;2021-01-17;10;0;0;9485;45;0;0.9;0.0;0.0
38;2021-01-18;1227;7;0;10712;52;0;1.0;0.0;0.0
38;2021-01-19;2310;9;0;13022;61;0;1.2;0.0;0.0
38;2021-01-20;2044;11;0;15066;72;0;1.4;0.0;0.0
38;2021-01-21;1776;15;0;16842;87;0;1.6;0.0;0.0
38;2021-01-22;1491;9;0;18333;96;0;1.7;0.0;0.0
38;2021-01-23;487;4;0;18820;100;0;1.7;0.0;0.0
38;2021-01-24;11;0;0;18831;100;0;1.7;0.0;0.0
38;2021-01-25;906;102;0;19737;202;0;1.8;0.0;0.0
38;2021-01-26;993;181;0;20730;383;0;1.9;0.0;0.0
38;2021-01-27;1255;277;0;21985;660;0;2.0;0.1;0.0
38;2021-01-28;1387;484;0;23372;1144;0;2.2;0.1;0.0
38;2021-01-29;1070;380;0;24442;1524;0;2.3;0.1;0.0
38;2021-01-30;383;1;0;24825;1525;0;2.3;0.1;0.0
38;2021-01-31;12;0;0;24837;1525;0;2.3;0.1;0.0
38;2021-02-01;775;592;0;25612;2117;0;2.4;0.2;0.0
38;2021-02-02;1102;959;0;26714;3076;0;2.5;0.3;0.0
38;2021-02-03;1276;725;0;27990;3801;0;2.6;0.4;0.0
38;2021-02-04;1378;999;0;29368;4800;0;2.7;0.4;0.0
38;2021-02-05;1453;867;0;30821;5667;0;2.9;0.5;0.0
38;2021-02-06;251;97;0;31072;5764;0;2.9;0.5;0.0
38;2021-02-07;6;50;0;31078;5814;0;2.9;0.5;0.0
38;2021-02-08;917;885;0;31995;6699;0;3.0;0.6;0.0
38;2021-02-09;1652;1394;0;33647;8093;0;3.1;0.7;0.0
38;2021-02-10;1681;1361;0;35328;9454;0;3.3;0.9;0.0
38;2021-02-11;1905;1243;0;37233;10697;0;3.4;1.0;0.0
38;2021-02-12;1591;1185;0;38824;11882;0;3.6;1.1;0.0
38;2021-02-13;503;221;0;39327;12103;0;3.6;1.1;0.0
38;2021-02-14;7;12;0;39334;12115;0;3.6;1.1;0.0
38;2021-02-15;1021;990;0;40355;13105;0;3.7;1.2;0.0
38;2021-02-16;1385;1073;0;41740;14178;0;3.9;1.3;0.0
38;2021-02-17;1373;1203;0;43113;15381;0;4.0;1.4;0.0
38;2021-02-18;1777;1220;0;44890;16601;0;4.2;1.5;0.0
38;2021-02-19;1272;977;0;46162;17578;0;4.3;1.6;0.0
38;2021-02-20;485;383;0;46647;17961;0;4.3;1.7;0.0
38;2021-02-21;3;8;0;46650;17969;0;4.3;1.7;0.0
38;2021-02-22;1104;994;0;47754;18963;0;4.4;1.8;0.0
38;2021-02-23;1550;1086;0;49304;20049;0;4.6;1.9;0.0
38;2021-02-24;1718;1262;0;51022;21311;0;4.7;2.0;0.0
38;2021-02-25;2572;1203;0;53594;22514;0;5.0;2.1;0.0
38;2021-02-26;3392;1105;0;56986;23619;0;5.3;2.2;0.0
38;2021-02-27;1532;507;0;58518;24126;0;5.4;2.2;0.0
38;2021-02-28;28;15;0;58546;24141;0;5.4;2.2;0.0
38;2021-03-01;2471;873;0;61017;25014;0;5.7;2.3;0.0
38;2021-03-02;4030;1200;0;65047;26214;0;6.0;2.4;0.0
38;2021-03-03;3374;1361;0;68421;27575;0;6.3;2.6;0.0
38;2021-03-04;4532;1462;0;72953;29037;0;6.8;2.7;0.0
38;2021-03-05;5299;1318;0;78252;30355;0;7.2;2.8;0.0
38;2021-03-06;3177;297;0;81429;30652;0;7.5;2.8;0.0
38;2021-03-07;309;34;0;81738;30686;0;7.6;2.8;0.0
38;2021-03-08;2465;934;0;84203;31620;0;7.8;2.9;0.0
38;2021-03-09;4061;1364;0;88264;32984;0;8.2;3.1;0.0
38;2021-03-10;3601;1156;0;91865;34140;0;8.5;3.2;0.0
38;2021-03-11;5199;1639;0;97064;35779;0;9.0;3.3;0.0
38;2021-03-12;7279;1263;0;104343;37042;0;9.7;3.4;0.0
38;2021-03-13;3906;265;0;108249;37307;0;10.0;3.5;0.0
38;2021-03-14;617;22;0;108866;37329;0;10.1;3.5;0.0
38;2021-03-15;2784;1034;0;111650;38363;0;10.3;3.6;0.0
38;2021-03-16;2207;1382;0;113857;39745;0;10.5;3.7;0.0
38;2021-03-17;2128;1210;0;115985;40955;0;10.7;3.8;0.0
38;2021-03-18;2900;1404;0;118885;42359;0;11.0;3.9;0.0
38;2021-03-19;4269;1147;0;123154;43506;0;11.4;4.0;0.0
38;2021-03-20;1987;259;0;125141;43765;0;11.6;4.1;0.0
38;2021-03-21;248;21;0;125389;43786;0;11.6;4.1;0.0
38;2021-03-22;3075;995;0;128464;44781;0;11.9;4.1;0.0
38;2021-03-23;5035;1520;0;133499;46301;0;12.4;4.3;0.0
38;2021-03-24;3963;1588;0;137462;47889;0;12.7;4.4;0.0
38;2021-03-25;6153;1574;0;143615;49463;0;13.3;4.6;0.0
38;2021-03-26;6874;1763;0;150489;51226;0;13.9;4.7;0.0
38;2021-03-27;2660;776;0;153149;52002;0;14.2;4.8;0.0
38;2021-03-28;1025;46;0;154174;52048;0;14.3;4.8;0.0
38;2021-03-29;2907;1855;0;157081;53903;0;14.6;5.0;0.0
38;2021-03-30;4856;2576;0;161937;56479;0;15.0;5.2;0.0
38;2021-03-31;3972;2285;0;165909;58764;0;15.4;5.4;0.0
38;2021-04-01;5490;2604;0;171399;61368;0;15.9;5.7;0.0
38;2021-04-02;4263;2575;0;175662;63943;0;16.3;5.9;0.0
38;2021-04-03;1722;1086;0;177384;65029;0;16.4;6.0;0.0
38;2021-04-04;818;105;0;178202;65134;0;16.5;6.0;0.0
38;2021-04-05;2528;377;0;180730;65511;0;16.7;6.1;0.0
38;2021-04-06;4584;2473;0;185314;67984;0;17.2;6.3;0.0
38;2021-04-07;4619;2867;0;189933;70851;0;17.6;6.6;0.0
38;2021-04-08;5892;2786;0;195825;73637;0;18.1;6.8;0.0
38;2021-04-09;8649;2765;0;204474;76402;0;18.9;7.1;0.0
38;2021-04-10;3631;1609;0;208105;78011;0;19.3;7.2;0.0
38;2021-04-11;1128;199;0;209233;78210;0;19.4;7.2;0.0
38;2021-04-12;4333;2362;0;213566;80572;0;19.8;7.5;0.0
38;2021-04-13;6323;2616;0;219889;83188;0;20.4;7.7;0.0
38;2021-04-14;5352;2642;0;225241;85830;0;20.9;8.0;0.0
38;2021-04-15;6639;3076;0;231880;88906;0;21.5;8.2;0.0
38;2021-04-16;6386;2950;0;238266;91856;0;22.1;8.5;0.0
38;2021-04-17;2855;1132;0;241121;92988;0;22.3;8.6;0.0
38;2021-04-18;1438;159;0;242559;93147;0;22.5;8.6;0.0
38;2021-04-19;4324;3028;0;246883;96175;0;22.9;8.9;0.0
38;2021-04-20;5541;3156;0;252424;99331;0;23.4;9.2;0.0
38;2021-04-21;5136;3010;0;257560;102341;0;23.9;9.5;0.0
38;2021-04-22;5897;3086;0;263457;105427;0;24.4;9.8;0.0
38;2021-04-23;6264;3101;0;269721;108528;0;25.0;10.1;0.0
38;2021-04-24;2992;1501;0;272713;110029;0;25.3;10.2;0.0
38;2021-04-25;889;674;0;273602;110703;0;25.3;10.3;0.0
38;2021-04-26;4552;2677;0;278154;113380;0;25.8;10.5;0.0
38;2021-04-27;6068;3020;0;284222;116400;0;26.3;10.8;0.0
38;2021-04-28;6197;2799;0;290419;119199;0;26.9;11.0;0.0
38;2021-04-29;8241;3371;0;298660;122570;0;27.7;11.4;0.0
38;2021-04-30;7597;4241;0;306257;126811;0;28.4;11.7;0.0
38;2021-05-01;1981;276;0;308238;127087;0;28.6;11.8;0.0
38;2021-05-02;966;485;0;309204;127572;0;28.6;11.8;0.0
38;2021-05-03;5327;3996;0;314531;131568;0;29.1;12.2;0.0
38;2021-05-04;6304;5526;0;320835;137094;0;29.7;12.7;0.0
38;2021-05-05;6518;4790;0;327353;141884;0;30.3;13.1;0.0
38;2021-05-06;7282;5500;0;334635;147384;0;31.0;13.7;0.0
38;2021-05-07;7752;6594;0;342387;153978;0;31.7;14.3;0.0
38;2021-05-08;3910;837;0;346297;154815;0;32.1;14.3;0.0
38;2021-05-09;3269;2038;0;349566;156853;0;32.4;14.5;0.0
38;2021-05-10;6225;5493;0;355791;162346;0;33.0;15.0;0.0
38;2021-05-11;8532;6232;0;364323;168578;0;33.8;15.6;0.0
38;2021-05-12;9729;4934;0;374052;173512;0;34.7;16.1;0.0
38;2021-05-13;7590;1569;0;381642;175081;0;35.4;16.2;0.0
38;2021-05-14;10264;3652;0;391906;178733;0;36.3;16.6;0.0
38;2021-05-15;7410;1583;0;399316;180316;0;37.0;16.7;0.0
38;2021-05-16;6080;706;0;405396;181022;0;37.6;16.8;0.0
38;2021-05-17;8043;3229;0;413439;184251;0;38.3;17.1;0.0
38;2021-05-18;9358;4211;0;422797;188462;0;39.2;17.5;0.0
38;2021-05-19;8853;3576;0;431650;192038;0;40.0;17.8;0.0
38;2021-05-20;9454;4677;0;441104;196715;0;40.9;18.2;0.0
38;2021-05-21;10138;4734;0;451242;201449;0;41.8;18.7;0.0
38;2021-05-22;7497;1985;0;458739;203434;0;42.5;18.8;0.0
38;2021-05-23;5217;620;0;463956;204054;0;43.0;18.9;0.0
38;2021-05-24;7646;1671;0;471602;205725;0;43.7;19.1;0.0
38;2021-05-25;9391;5002;0;480993;210727;0;44.6;19.5;0.0
38;2021-05-26;8184;4993;0;489177;215720;0;45.3;20.0;0.0
38;2021-05-27;9349;5790;0;498526;221510;0;46.2;20.5;0.0
38;2021-05-28;9021;6728;0;507547;228238;0;47.0;21.1;0.0
38;2021-05-29;6011;3635;0;513558;231873;0;47.6;21.5;0.0
38;2021-05-30;2751;1743;0;516309;233616;0;47.8;21.6;0.0
38;2021-05-31;8072;5362;0;524381;238978;0;48.6;22.1;0.0
38;2021-06-01;7884;6557;0;532265;245535;0;49.3;22.7;0.0
38;2021-06-02;7319;5913;0;539584;251448;0;50.0;23.3;0.0
38;2021-06-03;7810;6969;0;547394;258417;0;50.7;23.9;0.0
38;2021-06-04;8375;7678;0;555769;266095;0;51.5;24.7;0.0
38;2021-06-05;6123;4167;0;561892;270262;0;52.1;25.0;0.0
38;2021-06-06;2762;1514;0;564654;271776;0;52.3;25.2;0.0
38;2021-06-07;5874;6981;0;570528;278757;0;52.9;25.8;0.0
38;2021-06-08;6341;7624;0;576869;286381;0;53.4;26.5;0.0
38;2021-06-09;5478;6556;0;582347;292937;0;54.0;27.1;0.0
38;2021-06-10;5835;6861;0;588182;299798;0;54.5;27.8;0.0
38;2021-06-11;6293;7927;0;594475;307725;0;55.1;28.5;0.0
38;2021-06-12;4291;3426;0;598766;311151;0;55.5;28.8;0.0
38;2021-06-13;1260;1359;0;600026;312510;0;55.6;29.0;0.0
38;2021-06-14;3893;7867;0;603919;320377;0;56.0;29.7;0.0
38;2021-06-15;5351;8413;0;609270;328790;0;56.4;30.5;0.0
38;2021-06-16;5294;7873;0;614564;336663;0;56.9;31.2;0.0
38;2021-06-17;4747;7565;0;619311;344228;0;57.4;31.9;0.0
38;2021-06-18;6193;9801;0;625504;354029;0;58.0;32.8;0.0
38;2021-06-19;3763;5643;0;629267;359672;0;58.3;33.3;0.0
38;2021-06-20;1191;2973;0;630458;362645;0;58.4;33.6;0.0
38;2021-06-21;3812;9028;0;634270;371673;0;58.8;34.4;0.0
38;2021-06-22;3738;10684;0;638008;382357;0;59.1;35.4;0.0
38;2021-06-23;3303;10182;0;641311;392539;0;59.4;36.4;0.0
38;2021-06-24;3552;9341;0;644863;401880;0;59.7;37.2;0.0
38;2021-06-25;3937;12013;0;648800;413893;0;60.1;38.3;0.0
38;2021-06-26;2282;8325;0;651082;422218;0;60.3;39.1;0.0
38;2021-06-27;1175;4715;0;652257;426933;0;60.4;39.6;0.0
38;2021-06-28;2704;10765;0;654961;437698;0;60.7;40.6;0.0
38;2021-06-29;3553;11125;0;658514;448823;0;61.0;41.6;0.0
38;2021-06-30;3886;10511;0;662400;459334;0;61.4;42.6;0.0
38;2021-07-01;3830;9264;0;666230;468598;0;61.7;43.4;0.0
38;2021-07-02;3946;11900;0;670176;480498;0;62.1;44.5;0.0
38;2021-07-03;2013;8765;0;672189;489263;0;62.3;45.3;0.0
38;2021-07-04;1318;3361;0;673507;492624;0;62.4;45.6;0.0
38;2021-07-05;3017;10702;0;676524;503326;0;62.7;46.6;0.0
38;2021-07-06;3529;10434;0;680053;513760;0;63.0;47.6;0.0
38;2021-07-07;3777;9663;0;683830;523423;0;63.4;48.5;0.0
38;2021-07-08;3728;8562;0;687558;531985;0;63.7;49.3;0.0
38;2021-07-09;4277;10998;0;691835;542983;0;64.1;50.3;0.0
38;2021-07-10;2555;8109;0;694390;551092;0;64.3;51.1;0.0
38;2021-07-11;1044;2280;0;695434;553372;0;64.4;51.3;0.0
38;2021-07-12;3582;10777;0;699016;564149;0;64.8;52.3;0.0
38;2021-07-13;6713;11266;0;705729;575415;0;65.4;53.3;0.0
38;2021-07-14;4617;3397;0;710346;578812;0;65.8;53.6;0.0
38;2021-07-15;8841;10193;0;719187;589005;0;66.6;54.6;0.0
38;2021-07-16;9148;10986;0;728335;599991;0;67.5;55.6;0.0
38;2021-07-17;5189;7739;0;733524;607730;0;68.0;56.3;0.0
38;2021-07-18;2792;2745;0;736316;610475;0;68.2;56.6;0.0
38;2021-07-19;6311;9422;0;742627;619897;0;68.8;57.4;0.0
38;2021-07-20;6822;8786;0;749449;628683;0;69.4;58.2;0.0
38;2021-07-21;8398;8526;0;757847;637209;0;70.2;59.0;0.0
38;2021-07-22;8230;7432;0;766077;644641;0;71.0;59.7;0.0
38;2021-07-23;9396;9367;0;775473;654008;0;71.8;60.6;0.0
38;2021-07-24;5925;5807;0;781398;659815;0;72.4;61.1;0.0
38;2021-07-25;2798;1889;0;784196;661704;0;72.7;61.3;0.0
38;2021-07-26;8078;7298;0;792274;669002;0;73.4;62.0;0.0
38;2021-07-27;8233;6472;0;800507;675474;0;74.2;62.6;0.0
38;2021-07-28;9132;5920;0;809639;681394;0;75.0;63.1;0.0
38;2021-07-29;8338;5147;0;817977;686541;0;75.8;63.6;0.0
38;2021-07-30;8233;6916;0;826210;693457;0;76.5;64.2;0.0
38;2021-07-31;4954;3877;0;831164;697334;0;77.0;64.6;0.0
38;2021-08-01;1563;1370;0;832727;698704;0;77.2;64.7;0.0
38;2021-08-02;5161;4867;0;837888;703571;0;77.6;65.2;0.0
38;2021-08-03;5460;5082;0;843348;708653;0;78.1;65.7;0.0
38;2021-08-04;5412;4712;0;848760;713365;0;78.6;66.1;0.0
38;2021-08-05;4406;4934;0;853166;718299;0;79.0;66.5;0.0
38;2021-08-06;4602;6367;0;857768;724666;0;79.5;67.1;0.0
38;2021-08-07;2845;3951;0;860613;728617;0;79.7;67.5;0.0
38;2021-08-08;964;2084;0;861577;730701;0;79.8;67.7;0.0
38;2021-08-09;3906;6225;0;865483;736926;0;80.2;68.3;0.0
38;2021-08-10;5002;6525;0;870485;743451;0;80.6;68.9;0.0
38;2021-08-11;4038;5399;0;874523;748850;0;81.0;69.4;0.0
38;2021-08-12;3687;5286;0;878210;754136;0;81.4;69.9;0.0
38;2021-08-13;4222;6435;0;882432;760571;0;81.8;70.5;0.0
38;2021-08-14;2069;4413;0;884501;764984;0;81.9;70.9;0.0
38;2021-08-15;544;1798;0;885045;766782;0;82.0;71.0;0.0
38;2021-08-16;3022;8249;0;888067;775031;0;82.3;71.8;0.0
38;2021-08-17;3426;6424;0;891493;781455;0;82.6;72.4;0.0
38;2021-08-18;3020;7599;0;894513;789054;0;82.9;73.1;0.0
38;2021-08-19;2784;5386;0;897297;794440;0;83.1;73.6;0.0
38;2021-08-20;2990;8518;0;900287;802958;0;83.4;74.4;0.0
38;2021-08-21;1254;5209;0;901541;808167;0;83.5;74.9;0.0
38;2021-08-22;514;1585;0;902055;809752;0;83.6;75.0;0.0
38;2021-08-23;2604;8021;0;904659;817773;0;83.8;75.8;0.0
38;2021-08-24;2762;6042;0;907421;823815;0;84.1;76.3;0.0
38;2021-08-25;2608;6458;0;910029;830273;0;84.3;76.9;0.0
38;2021-08-26;2328;4845;0;912357;835118;0;84.5;77.4;0.0
38;2021-08-27;2617;6567;0;914974;841685;0;84.8;78.0;0.0
38;2021-08-28;1429;4249;0;916403;845934;0;84.9;78.4;0.0
38;2021-08-29;426;1444;0;916829;847378;0;84.9;78.5;0.0
38;2021-08-30;2316;6099;110;919145;853477;110;85.2;79.1;0.0
38;2021-08-31;2330;5033;163;921475;858510;273;85.4;79.5;0.0
38;2021-09-01;2513;4371;362;923988;862881;635;85.6;79.9;0.1
38;2021-09-02;1785;3430;416;925773;866311;1051;85.8;80.3;0.1
38;2021-09-03;2048;4968;512;927821;871279;1563;86.0;80.7;0.1
38;2021-09-04;1236;3183;185;929057;874462;1748;86.1;81.0;0.2
38;2021-09-05;388;782;66;929445;875244;1814;86.1;81.1;0.2
38;2021-09-06;1256;3033;494;930701;878277;2308;86.2;81.4;0.2
38;2021-09-07;1359;2992;607;932060;881269;2915;86.4;81.6;0.3
38;2021-09-08;1800;3377;460;933860;884646;3375;86.5;82.0;0.3
38;2021-09-09;1133;2183;426;934993;886829;3801;86.6;82.2;0.4
38;2021-09-10;1641;3358;697;936634;890187;4498;86.8;82.5;0.4
38;2021-09-11;1096;2425;142;937730;892612;4640;86.9;82.7;0.4
38;2021-09-12;216;553;27;937946;893165;4667;86.9;82.7;0.4
38;2021-09-13;962;2269;757;938908;895434;5424;87.0;83.0;0.5
38;2021-09-14;1001;2121;893;939909;897555;6317;87.1;83.2;0.6
38;2021-09-15;1326;2800;808;941235;900355;7125;87.2;83.4;0.7
38;2021-09-16;762;1687;768;941997;902042;7893;87.3;83.6;0.7
38;2021-09-17;937;2631;793;942934;904673;8686;87.4;83.8;0.8
38;2021-09-18;761;2276;200;943695;906949;8886;87.4;84.0;0.8
38;2021-09-19;116;416;30;943811;907365;8916;87.4;84.1;0.8
38;2021-09-20;608;1737;964;944419;909102;9880;87.5;84.2;0.9
38;2021-09-21;525;1514;1061;944944;910616;10941;87.5;84.4;1.0
38;2021-09-22;725;2694;876;945669;913310;11817;87.6;84.6;1.1
38;2021-09-23;476;1461;996;946145;914771;12813;87.7;84.8;1.2
38;2021-09-24;777;2276;1006;946922;917047;13819;87.7;85.0;1.3
38;2021-09-25;512;1923;205;947434;918970;14024;87.8;85.1;1.3
38;2021-09-26;100;386;22;947534;919356;14046;87.8;85.2;1.3
38;2021-09-27;432;1221;786;947966;920577;14832;87.8;85.3;1.4
38;2021-09-28;530;1201;972;948496;921778;15804;87.9;85.4;1.5
38;2021-09-29;685;1974;1087;949181;923752;16891;87.9;85.6;1.6
38;2021-09-30;458;911;944;949639;924663;17835;88.0;85.7;1.7
38;2021-10-01;867;1552;1047;950506;926215;18882;88.1;85.8;1.7
38;2021-10-02;517;1226;310;951023;927441;19192;88.1;85.9;1.8
38;2021-10-03;82;204;19;951105;927645;19211;88.1;85.9;1.8
38;2021-10-04;581;1010;1234;951686;928655;20445;88.2;86.0;1.9
38;2021-10-05;463;950;1293;952149;929605;21738;88.2;86.1;2.0
38;2021-10-06;654;1357;1217;952803;930962;22955;88.3;86.3;2.1
38;2021-10-07;434;872;1174;953237;931834;24129;88.3;86.3;2.2
38;2021-10-08;740;1361;1554;953977;933195;25683;88.4;86.5;2.4
38;2021-10-09;513;889;365;954490;934084;26048;88.4;86.5;2.4
38;2021-10-10;43;117;61;954533;934201;26109;88.4;86.6;2.4
38;2021-10-11;381;846;1357;954914;935047;27466;88.5;86.6;2.5
38;2021-10-12;494;695;1280;955408;935742;28746;88.5;86.7;2.7
38;2021-10-13;574;1040;1720;955982;936782;30466;88.6;86.8;2.8
38;2021-10-14;408;614;1533;956390;937396;31999;88.6;86.8;3.0
38;2021-10-15;618;1104;1959;957008;938500;33958;88.7;86.9;3.1
38;2021-10-16;446;687;435;957454;939187;34393;88.7;87.0;3.2
38;2021-10-17;12;46;13;957466;939233;34406;88.7;87.0;3.2
38;2021-10-18;408;597;1330;957874;939830;35736;88.7;87.1;3.3
38;2021-10-19;231;517;1605;958105;940347;37341;88.8;87.1;3.5
38;2021-10-20;362;706;1995;958467;941053;39336;88.8;87.2;3.6
38;2021-10-21;186;384;1374;958653;941437;40710;88.8;87.2;3.8
38;2021-10-22;363;770;2234;959016;942207;42944;88.9;87.3;4.0
38;2021-10-23;253;551;599;959269;942758;43543;88.9;87.3;4.0
38;2021-10-24;29;85;64;959298;942843;43607;88.9;87.4;4.0
38;2021-10-25;252;493;1696;959550;943336;45303;88.9;87.4;4.2
38;2021-10-26;212;400;1888;959762;943736;47191;88.9;87.4;4.4
38;2021-10-27;273;618;2047;960035;944354;49238;88.9;87.5;4.6
38;2021-10-28;200;387;1685;960235;944741;50923;89.0;87.5;4.7
38;2021-10-29;276;708;2265;960511;945449;53188;89.0;87.6;4.9
38;2021-10-30;127;440;709;960638;945889;53897;89.0;87.6;5.0
38;2021-10-31;10;27;18;960648;945916;53915;89.0;87.6;5.0
38;2021-11-01;61;46;43;960709;945962;53958;89.0;87.6;5.0
38;2021-11-02;275;566;2041;960984;946528;55999;89.0;87.7;5.2
38;2021-11-03;258;502;2553;961242;947030;58552;89.1;87.7;5.4
38;2021-11-04;231;410;1999;961473;947440;60551;89.1;87.8;5.6
38;2021-11-05;300;568;2761;961773;948008;63312;89.1;87.8;5.9
38;2021-11-06;208;437;1029;961981;948445;64341;89.1;87.9;6.0
38;2021-11-07;6;14;53;961987;948459;64394;89.1;87.9;6.0
38;2021-11-08;171;359;2297;962158;948818;66691;89.1;87.9;6.2
38;2021-11-09;207;417;3436;962365;949235;70127;89.2;87.9;6.5
38;2021-11-10;322;554;4043;962687;949789;74170;89.2;88.0;6.9
38;2021-11-11;15;47;120;962702;949836;74290;89.2;88.0;6.9
38;2021-11-12;291;439;3810;962993;950275;78100;89.2;88.0;7.2
38;2021-11-13;204;253;1193;963197;950528;79293;89.2;88.1;7.3
38;2021-11-14;9;17;78;963206;950545;79371;89.2;88.1;7.4
38;2021-11-15;162;273;3063;963368;950818;82434;89.3;88.1;7.6
38;2021-11-16;176;285;3943;963544;951103;86377;89.3;88.1;8.0
38;2021-11-17;322;396;3940;963866;951499;90317;89.3;88.2;8.4
38;2021-11-18;214;300;3372;964080;951799;93689;89.3;88.2;8.7
38;2021-11-19;257;385;4949;964337;952184;98638;89.3;88.2;9.1
38;2021-11-20;215;306;1495;964552;952490;100133;89.4;88.2;9.3
38;2021-11-21;15;24;183;964567;952514;100316;89.4;88.2;9.3
38;2021-11-22;190;169;3338;964757;952683;103654;89.4;88.3;9.6
38;2021-11-23;229;235;4564;964986;952918;108218;89.4;88.3;10.0
38;2021-11-24;305;422;4668;965291;953340;112886;89.4;88.3;10.5
38;2021-11-25;211;242;5029;965502;953582;117915;89.5;88.3;10.9
38;2021-11-26;277;348;7717;965779;953930;125632;89.5;88.4;11.6
38;2021-11-27;271;276;3862;966050;954206;129494;89.5;88.4;12.0
38;2021-11-28;14;25;310;966064;954231;129804;89.5;88.4;12.0
38;2021-11-29;140;201;6583;966204;954432;136387;89.5;88.4;12.6
38;2021-11-30;194;265;9351;966398;954697;145738;89.5;88.5;13.5
38;2021-12-01;223;378;8873;966621;955075;154611;89.6;88.5;14.3
38;2021-12-02;164;208;9816;966785;955283;164427;89.6;88.5;15.2
38;2021-12-03;209;398;11515;966994;955681;175942;89.6;88.5;16.3
38;2021-12-04;165;256;5955;967159;955937;181897;89.6;88.6;16.9
38;2021-12-05;50;50;2044;967209;955987;183941;89.6;88.6;17.0
38;2021-12-06;135;222;9500;967344;956209;193441;89.6;88.6;17.9
38;2021-12-07;176;261;12065;967520;956470;205506;89.6;88.6;19.0
38;2021-12-08;270;385;10663;967790;956855;216169;89.7;88.7;20.0
38;2021-12-09;165;274;12421;967955;957129;228590;89.7;88.7;21.2
38;2021-12-10;259;354;15017;968214;957483;243607;89.7;88.7;22.6
38;2021-12-11;230;329;9936;968444;957812;253543;89.7;88.7;23.5
38;2021-12-12;58;50;4009;968502;957862;257552;89.7;88.7;23.9
38;2021-12-13;192;255;13067;968694;958117;270619;89.7;88.8;25.1
38;2021-12-14;255;283;16235;968949;958400;286854;89.8;88.8;26.6
38;2021-12-15;270;359;15010;969219;958759;301864;89.8;88.8;28.0
38;2021-12-16;298;329;15920;969517;959088;317784;89.8;88.9;29.4
38;2021-12-17;314;356;16835;969831;959444;334619;89.9;88.9;31.0
38;2021-12-18;248;330;10772;970079;959774;345391;89.9;88.9;32.0
38;2021-12-19;102;64;4345;970181;959838;349736;89.9;88.9;32.4
39;2020-12-27;0;0;0;0;0;0;0.0;0.0;0.0
39;2020-12-28;0;0;0;0;0;0;0.0;0.0;0.0
39;2020-12-29;0;0;0;0;0;0;0.0;0.0;0.0
39;2020-12-30;0;0;0;0;0;0;0.0;0.0;0.0
39;2020-12-31;0;0;0;0;0;0;0.0;0.0;0.0
39;2021-01-01;1;0;0;1;0;0;0.0;0.0;0.0
39;2021-01-02;0;0;0;1;0;0;0.0;0.0;0.0
39;2021-01-03;0;0;0;1;0;0;0.0;0.0;0.0
39;2021-01-04;2;0;0;3;0;0;0.0;0.0;0.0
39;2021-01-05;3;0;0;6;0;0;0.0;0.0;0.0
39;2021-01-06;48;3;0;54;3;0;0.0;0.0;0.0
39;2021-01-07;332;2;0;386;5;0;0.2;0.0;0.0
39;2021-01-08;611;2;0;997;7;0;0.4;0.0;0.0
39;2021-01-09;170;0;0;1167;7;0;0.5;0.0;0.0
39;2021-01-10;1;0;0;1168;7;0;0.5;0.0;0.0
39;2021-01-11;447;1;0;1615;8;0;0.7;0.0;0.0
39;2021-01-12;433;1;0;2048;9;0;0.9;0.0;0.0
39;2021-01-13;409;2;0;2457;11;0;1.1;0.0;0.0
39;2021-01-14;570;3;0;3027;14;0;1.3;0.0;0.0
39;2021-01-15;454;2;0;3481;16;0;1.5;0.0;0.0
39;2021-01-16;138;0;0;3619;16;0;1.6;0.0;0.0
39;2021-01-17;4;1;0;3623;17;0;1.6;0.0;0.0
39;2021-01-18;893;7;0;4516;24;0;2.0;0.0;0.0
39;2021-01-19;1127;9;0;5643;33;0;2.5;0.0;0.0
39;2021-01-20;885;5;0;6528;38;0;2.9;0.0;0.0
39;2021-01-21;1176;3;0;7704;41;0;3.4;0.0;0.0
39;2021-01-22;954;3;0;8658;44;0;3.9;0.0;0.0
39;2021-01-23;368;1;0;9026;45;0;4.0;0.0;0.0
39;2021-01-24;0;0;0;9026;45;0;4.0;0.0;0.0
39;2021-01-25;635;2;0;9661;47;0;4.3;0.0;0.0
39;2021-01-26;1030;15;0;10691;62;0;4.8;0.0;0.0
39;2021-01-27;845;20;0;11536;82;0;5.1;0.0;0.0
39;2021-01-28;679;231;0;12215;313;0;5.4;0.1;0.0
39;2021-01-29;522;390;0;12737;703;0;5.7;0.3;0.0
39;2021-01-30;236;105;0;12973;808;0;5.8;0.4;0.0
39;2021-01-31;1;0;0;12974;808;0;5.8;0.4;0.0
39;2021-02-01;534;254;0;13508;1062;0;6.0;0.5;0.0
39;2021-02-02;716;314;0;14224;1376;0;6.3;0.6;0.0
39;2021-02-03;468;493;0;14692;1869;0;6.5;0.8;0.0
39;2021-02-04;505;436;0;15197;2305;0;6.8;1.0;0.0
39;2021-02-05;413;414;0;15610;2719;0;6.9;1.2;0.0
39;2021-02-06;233;105;0;15843;2824;0;7.0;1.3;0.0
39;2021-02-07;0;2;0;15843;2826;0;7.0;1.3;0.0
39;2021-02-08;307;362;0;16150;3188;0;7.2;1.4;0.0
39;2021-02-09;314;452;0;16464;3640;0;7.3;1.6;0.0
39;2021-02-10;244;339;0;16708;3979;0;7.4;1.8;0.0
39;2021-02-11;545;503;0;17253;4482;0;7.7;2.0;0.0
39;2021-02-12;346;398;0;17599;4880;0;7.8;2.2;0.0
39;2021-02-13;99;65;0;17698;4945;0;7.9;2.2;0.0
39;2021-02-14;1;1;0;17699;4946;0;7.9;2.2;0.0
39;2021-02-15;101;741;0;17800;5687;0;7.9;2.5;0.0
39;2021-02-16;108;877;0;17908;6564;0;8.0;2.9;0.0
39;2021-02-17;59;668;0;17967;7232;0;8.0;3.2;0.0
39;2021-02-18;107;831;0;18074;8063;0;8.0;3.6;0.0
39;2021-02-19;58;484;0;18132;8547;0;8.1;3.8;0.0
39;2021-02-20;20;353;0;18152;8900;0;8.1;4.0;0.0
39;2021-02-21;0;1;0;18152;8901;0;8.1;4.0;0.0
39;2021-02-22;97;677;0;18249;9578;0;8.1;4.3;0.0
39;2021-02-23;19;686;0;18268;10264;0;8.1;4.6;0.0
39;2021-02-24;115;773;0;18383;11037;0;8.2;4.9;0.0
39;2021-02-25;213;700;0;18596;11737;0;8.3;5.2;0.0
39;2021-02-26;202;432;0;18798;12169;0;8.4;5.4;0.0
39;2021-02-27;167;267;0;18965;12436;0;8.4;5.5;0.0
39;2021-02-28;4;0;0;18969;12436;0;8.4;5.5;0.0
39;2021-03-01;258;616;0;19227;13052;0;8.6;5.8;0.0
39;2021-03-02;344;774;0;19571;13826;0;8.7;6.2;0.0
39;2021-03-03;570;474;0;20141;14300;0;9.0;6.4;0.0
39;2021-03-04;638;452;0;20779;14752;0;9.2;6.6;0.0
39;2021-03-05;636;323;0;21415;15075;0;9.5;6.7;0.0
39;2021-03-06;728;217;0;22143;15292;0;9.9;6.8;0.0
39;2021-03-07;200;69;0;22343;15361;0;9.9;6.8;0.0
39;2021-03-08;276;421;0;22619;15782;0;10.1;7.0;0.0
39;2021-03-09;771;418;0;23390;16200;0;10.4;7.2;0.0
39;2021-03-10;930;285;0;24320;16485;0;10.8;7.3;0.0
39;2021-03-11;758;445;0;25078;16930;0;11.2;7.5;0.0
39;2021-03-12;764;281;0;25842;17211;0;11.5;7.7;0.0
39;2021-03-13;746;95;0;26588;17306;0;11.8;7.7;0.0
39;2021-03-14;45;8;0;26633;17314;0;11.9;7.7;0.0
39;2021-03-15;453;114;0;27086;17428;0;12.1;7.8;0.0
39;2021-03-16;493;54;0;27579;17482;0;12.3;7.8;0.0
39;2021-03-17;572;71;0;28151;17553;0;12.5;7.8;0.0
39;2021-03-18;590;73;0;28741;17626;0;12.8;7.8;0.0
39;2021-03-19;424;80;0;29165;17706;0;13.0;7.9;0.0
39;2021-03-20;335;22;0;29500;17728;0;13.1;7.9;0.0
39;2021-03-21;9;1;0;29509;17729;0;13.1;7.9;0.0
39;2021-03-22;734;121;0;30243;17850;0;13.5;7.9;0.0
39;2021-03-23;1071;63;0;31314;17913;0;13.9;8.0;0.0
39;2021-03-24;1124;103;0;32438;18016;0;14.4;8.0;0.0
39;2021-03-25;1961;140;0;34399;18156;0;15.3;8.1;0.0
39;2021-03-26;828;127;0;35227;18283;0;15.7;8.1;0.0
39;2021-03-27;358;11;0;35585;18294;0;15.8;8.1;0.0
39;2021-03-28;37;4;0;35622;18298;0;15.9;8.1;0.0
39;2021-03-29;1010;195;0;36632;18493;0;16.3;8.2;0.0
39;2021-03-30;1341;278;0;37973;18771;0;16.9;8.4;0.0
39;2021-03-31;669;459;0;38642;19230;0;17.2;8.6;0.0
39;2021-04-01;1170;292;0;39812;19522;0;17.7;8.7;0.0
39;2021-04-02;636;139;0;40448;19661;0;18.0;8.7;0.0
39;2021-04-03;202;13;0;40650;19674;0;18.1;8.8;0.0
39;2021-04-04;4;2;0;40654;19676;0;18.1;8.8;0.0
39;2021-04-05;12;2;0;40666;19678;0;18.1;8.8;0.0
39;2021-04-06;813;579;0;41479;20257;0;18.5;9.0;0.0
39;2021-04-07;1069;614;0;42548;20871;0;18.9;9.3;0.0
39;2021-04-08;1654;517;0;44202;21388;0;19.7;9.5;0.0
39;2021-04-09;1641;299;0;45843;21687;0;20.4;9.7;0.0
39;2021-04-10;366;155;0;46209;21842;0;20.6;9.7;0.0
39;2021-04-11;10;1;0;46219;21843;0;20.6;9.7;0.0
39;2021-04-12;677;345;0;46896;22188;0;20.9;9.9;0.0
39;2021-04-13;1167;527;0;48063;22715;0;21.4;10.1;0.0
39;2021-04-14;796;591;0;48859;23306;0;21.7;10.4;0.0
39;2021-04-15;1373;681;0;50232;23987;0;22.4;10.7;0.0
39;2021-04-16;1050;223;0;51282;24210;0;22.8;10.8;0.0
39;2021-04-17;262;74;0;51544;24284;0;22.9;10.8;0.0
39;2021-04-18;6;2;0;51550;24286;0;22.9;10.8;0.0
39;2021-04-19;539;664;0;52089;24950;0;23.2;11.1;0.0
39;2021-04-20;804;552;0;52893;25502;0;23.5;11.3;0.0
39;2021-04-21;1001;663;0;53894;26165;0;24.0;11.6;0.0
39;2021-04-22;1006;1068;0;54900;27233;0;24.4;12.1;0.0
39;2021-04-23;477;378;0;55377;27611;0;24.6;12.3;0.0
39;2021-04-24;305;146;0;55682;27757;0;24.8;12.4;0.0
39;2021-04-25;19;4;0;55701;27761;0;24.8;12.4;0.0
39;2021-04-26;565;1018;0;56266;28779;0;25.0;12.8;0.0
39;2021-04-27;802;953;0;57068;29732;0;25.4;13.2;0.0
39;2021-04-28;1513;433;0;58581;30165;0;26.1;13.4;0.0
39;2021-04-29;2414;861;0;60995;31026;0;27.1;13.8;0.0
39;2021-04-30;2238;421;0;63233;31447;0;28.1;14.0;0.0
39;2021-05-01;84;65;0;63317;31512;0;28.2;14.0;0.0
39;2021-05-02;24;3;0;63341;31515;0;28.2;14.0;0.0
39;2021-05-03;935;768;0;64276;32283;0;28.6;14.4;0.0
39;2021-05-04;994;1077;0;65270;33360;0;29.0;14.8;0.0
39;2021-05-05;1756;867;0;67026;34227;0;29.8;15.2;0.0
39;2021-05-06;2230;1226;0;69256;35453;0;30.8;15.8;0.0
39;2021-05-07;1282;624;0;70538;36077;0;31.4;16.1;0.0
39;2021-05-08;175;51;0;70713;36128;0;31.5;16.1;0.0
39;2021-05-09;24;21;0;70737;36149;0;31.5;16.1;0.0
39;2021-05-10;1705;868;0;72442;37017;0;32.2;16.5;0.0
39;2021-05-11;1768;1464;0;74210;38481;0;33.0;17.1;0.0
39;2021-05-12;1655;1374;0;75865;39855;0;33.8;17.7;0.0
39;2021-05-13;262;48;0;76127;39903;0;33.9;17.8;0.0
39;2021-05-14;2261;360;0;78388;40263;0;34.9;17.9;0.0
39;2021-05-15;1531;262;0;79919;40525;0;35.6;18.0;0.0
39;2021-05-16;37;6;0;79956;40531;0;35.6;18.0;0.0
39;2021-05-17;1924;712;0;81880;41243;0;36.4;18.4;0.0
39;2021-05-18;1707;1120;0;83587;42363;0;37.2;18.9;0.0
39;2021-05-19;2299;540;0;85886;42903;0;38.2;19.1;0.0
39;2021-05-20;2167;787;0;88053;43690;0;39.2;19.4;0.0
39;2021-05-21;1790;585;0;89843;44275;0;40.0;19.7;0.0
39;2021-05-22;322;232;0;90165;44507;0;40.1;19.8;0.0
39;2021-05-23;36;65;0;90201;44572;0;40.1;19.8;0.0
39;2021-05-24;169;52;0;90370;44624;0;40.2;19.9;0.0
39;2021-05-25;1641;1183;0;92011;45807;0;40.9;20.4;0.0
39;2021-05-26;1603;1301;0;93614;47108;0;41.7;21.0;0.0
39;2021-05-27;1474;1538;0;95088;48646;0;42.3;21.6;0.0
39;2021-05-28;974;1254;0;96062;49900;0;42.7;22.2;0.0
39;2021-05-29;352;312;0;96414;50212;0;42.9;22.3;0.0
39;2021-05-30;19;44;0;96433;50256;0;42.9;22.4;0.0
39;2021-05-31;1534;1208;0;97967;51464;0;43.6;22.9;0.0
39;2021-06-01;1791;1327;0;99758;52791;0;44.4;23.5;0.0
39;2021-06-02;1656;1016;0;101414;53807;0;45.1;23.9;0.0
39;2021-06-03;1326;1129;0;102740;54936;0;45.7;24.4;0.0
39;2021-06-04;1017;1075;0;103757;56011;0;46.2;24.9;0.0
39;2021-06-05;671;551;0;104428;56562;0;46.5;25.2;0.0
39;2021-06-06;62;44;0;104490;56606;0;46.5;25.2;0.0
39;2021-06-07;1944;893;0;106434;57499;0;47.4;25.6;0.0
39;2021-06-08;2050;1120;0;108484;58619;0;48.3;26.1;0.0
39;2021-06-09;1655;1174;0;110139;59793;0;49.0;26.6;0.0
39;2021-06-10;1611;1928;0;111750;61721;0;49.7;27.5;0.0
39;2021-06-11;1528;1193;0;113278;62914;0;50.4;28.0;0.0
39;2021-06-12;1097;396;0;114375;63310;0;50.9;28.2;0.0
39;2021-06-13;33;29;0;114408;63339;0;50.9;28.2;0.0
39;2021-06-14;1289;1819;0;115697;65158;0;51.5;29.0;0.0
39;2021-06-15;1328;1286;0;117025;66444;0;52.1;29.6;0.0
39;2021-06-16;1173;1414;0;118198;67858;0;52.6;30.2;0.0
39;2021-06-17;1023;1617;0;119221;69475;0;53.1;30.9;0.0
39;2021-06-18;1501;1191;0;120722;70666;0;53.7;31.4;0.0
39;2021-06-19;345;417;0;121067;71083;0;53.9;31.6;0.0
39;2021-06-20;24;33;0;121091;71116;0;53.9;31.6;0.0
39;2021-06-21;404;2410;0;121495;73526;0;54.1;32.7;0.0
39;2021-06-22;797;2249;0;122292;75775;0;54.4;33.7;0.0
39;2021-06-23;1110;1237;0;123402;77012;0;54.9;34.3;0.0
39;2021-06-24;756;1072;0;124158;78084;0;55.2;34.7;0.0
39;2021-06-25;689;2744;0;124847;80828;0;55.6;36.0;0.0
39;2021-06-26;223;1410;0;125070;82238;0;55.7;36.6;0.0
39;2021-06-27;23;30;0;125093;82268;0;55.7;36.6;0.0
39;2021-06-28;336;2627;0;125429;84895;0;55.8;37.8;0.0
39;2021-06-29;519;2629;0;125948;87524;0;56.0;38.9;0.0
39;2021-06-30;818;2250;0;126766;89774;0;56.4;39.9;0.0
39;2021-07-01;696;1764;0;127462;91538;0;56.7;40.7;0.0
39;2021-07-02;1045;1461;0;128507;92999;0;57.2;41.4;0.0
39;2021-07-03;529;509;0;129036;93508;0;57.4;41.6;0.0
39;2021-07-04;24;37;0;129060;93545;0;57.4;41.6;0.0
39;2021-07-05;556;2469;0;129616;96014;0;57.7;42.7;0.0
39;2021-07-06;816;1860;0;130432;97874;0;58.0;43.6;0.0
39;2021-07-07;609;1371;0;131041;99245;0;58.3;44.2;0.0
39;2021-07-08;685;1006;0;131726;100251;0;58.6;44.6;0.0
39;2021-07-09;1025;1594;0;132751;101845;0;59.1;45.3;0.0
39;2021-07-10;646;588;0;133397;102433;0;59.4;45.6;0.0
39;2021-07-11;24;20;0;133421;102453;0;59.4;45.6;0.0
39;2021-07-12;521;2441;0;133942;104894;0;59.6;46.7;0.0
39;2021-07-13;1487;2553;0;135429;107447;0;60.3;47.8;0.0
39;2021-07-14;82;84;0;135511;107531;0;60.3;47.8;0.0
39;2021-07-15;1578;1792;0;137089;109323;0;61.0;48.6;0.0
39;2021-07-16;2717;1991;0;139806;111314;0;62.2;49.5;0.0
39;2021-07-17;1680;943;0;141486;112257;0;63.0;50.0;0.0
39;2021-07-18;157;87;0;141643;112344;0;63.0;50.0;0.0
39;2021-07-19;1245;2762;0;142888;115106;0;63.6;51.2;0.0
39;2021-07-20;1594;2586;0;144482;117692;0;64.3;52.4;0.0
39;2021-07-21;2090;2366;0;146572;120058;0;65.2;53.4;0.0
39;2021-07-22;1618;1814;0;148190;121872;0;65.9;54.2;0.0
39;2021-07-23;1557;1820;0;149747;123692;0;66.6;55.0;0.0
39;2021-07-24;1091;1229;0;150838;124921;0;67.1;55.6;0.0
39;2021-07-25;53;46;0;150891;124967;0;67.1;55.6;0.0
39;2021-07-26;1112;1869;0;152003;126836;0;67.6;56.4;0.0
39;2021-07-27;1910;1800;0;153913;128636;0;68.5;57.2;0.0
39;2021-07-28;2157;1353;0;156070;129989;0;69.4;57.8;0.0
39;2021-07-29;1915;1506;0;157985;131495;0;70.3;58.5;0.0
39;2021-07-30;1770;1318;0;159755;132813;0;71.1;59.1;0.0
39;2021-07-31;1140;648;0;160895;133461;0;71.6;59.4;0.0
39;2021-08-01;78;31;0;160973;133492;0;71.6;59.4;0.0
39;2021-08-02;1098;1225;0;162071;134717;0;72.1;59.9;0.0
39;2021-08-03;1637;1204;0;163708;135921;0;72.8;60.5;0.0
39;2021-08-04;978;663;0;164686;136584;0;73.3;60.8;0.0
39;2021-08-05;1124;721;0;165810;137305;0;73.8;61.1;0.0
39;2021-08-06;1214;1975;0;167024;139280;0;74.3;62.0;0.0
39;2021-08-07;859;1025;0;167883;140305;0;74.7;62.4;0.0
39;2021-08-08;48;40;0;167931;140345;0;74.7;62.5;0.0
39;2021-08-09;482;392;0;168413;140737;0;74.9;62.6;0.0
39;2021-08-10;1152;941;0;169565;141678;0;75.5;63.0;0.0
39;2021-08-11;874;1369;0;170439;143047;0;75.8;63.7;0.0
39;2021-08-12;1400;1867;0;171839;144914;0;76.5;64.5;0.0
39;2021-08-13;1202;1849;0;173041;146763;0;77.0;65.3;0.0
39;2021-08-14;350;934;0;173391;147697;0;77.2;65.7;0.0
39;2021-08-15;11;15;0;173402;147712;0;77.2;65.7;0.0
39;2021-08-16;504;725;0;173906;148437;0;77.4;66.1;0.0
39;2021-08-17;598;1337;0;174504;149774;0;77.7;66.6;0.0
39;2021-08-18;779;1487;0;175283;151261;0;78.0;67.3;0.0
39;2021-08-19;842;1384;0;176125;152645;0;78.4;67.9;0.0
39;2021-08-20;640;2148;0;176765;154793;0;78.7;68.9;0.0
39;2021-08-21;441;1101;0;177206;155894;0;78.9;69.4;0.0
39;2021-08-22;17;56;0;177223;155950;0;78.9;69.4;0.0
39;2021-08-23;296;918;0;177519;156868;0;79.0;69.8;0.0
39;2021-08-24;440;1463;0;177959;158331;0;79.2;70.5;0.0
39;2021-08-25;605;1464;0;178564;159795;0;79.5;71.1;0.0
39;2021-08-26;677;1613;0;179241;161408;0;79.8;71.8;0.0
39;2021-08-27;412;1777;0;179653;163185;0;79.9;72.6;0.0
39;2021-08-28;323;1158;0;179976;164343;0;80.1;73.1;0.0
39;2021-08-29;10;29;0;179986;164372;0;80.1;73.1;0.0
39;2021-08-30;360;952;9;180346;165324;9;80.3;73.6;0.0
39;2021-08-31;430;1013;36;180776;166337;45;80.4;74.0;0.0
39;2021-09-01;542;1320;158;181318;167657;203;80.7;74.6;0.1
39;2021-09-02;339;1248;130;181657;168905;333;80.8;75.2;0.1
39;2021-09-03;483;1958;163;182140;170863;496;81.0;76.0;0.2
39;2021-09-04;170;255;26;182310;171118;522;81.1;76.1;0.2
39;2021-09-05;9;17;0;182319;171135;522;81.1;76.2;0.2
39;2021-09-06;281;519;98;182600;171654;620;81.3;76.4;0.3
39;2021-09-07;251;342;100;182851;171996;720;81.4;76.5;0.3
39;2021-09-08;458;680;305;183309;172676;1025;81.6;76.8;0.5
39;2021-09-09;427;791;406;183736;173467;1431;81.8;77.2;0.6
39;2021-09-10;244;618;185;183980;174085;1616;81.9;77.5;0.7
39;2021-09-11;269;762;114;184249;174847;1730;82.0;77.8;0.8
39;2021-09-12;10;31;1;184259;174878;1731;82.0;77.8;0.8
39;2021-09-13;190;218;97;184449;175096;1828;82.1;77.9;0.8
39;2021-09-14;225;354;123;184674;175450;1951;82.2;78.1;0.9
39;2021-09-15;275;565;608;184949;176015;2559;82.3;78.3;1.1
39;2021-09-16;433;960;444;185382;176975;3003;82.5;78.8;1.3
39;2021-09-17;429;688;285;185811;177663;3288;82.7;79.1;1.5
39;2021-09-18;108;258;81;185919;177921;3369;82.7;79.2;1.5
39;2021-09-19;3;13;1;185922;177934;3370;82.7;79.2;1.5
39;2021-09-20;110;172;115;186032;178106;3485;82.8;79.3;1.6
39;2021-09-21;117;175;275;186149;178281;3760;82.8;79.3;1.7
39;2021-09-22;277;763;432;186426;179044;4192;83.0;79.7;1.9
39;2021-09-23;179;322;393;186605;179366;4585;83.0;79.8;2.0
39;2021-09-24;225;587;317;186830;179953;4902;83.1;80.1;2.2
39;2021-09-25;82;262;92;186912;180215;4994;83.2;80.2;2.2
39;2021-09-26;1;3;1;186913;180218;4995;83.2;80.2;2.2
39;2021-09-27;131;328;219;187044;180546;5214;83.2;80.3;2.3
39;2021-09-28;72;181;285;187116;180727;5499;83.3;80.4;2.4
39;2021-09-29;203;539;398;187319;181266;5897;83.4;80.7;2.6
39;2021-09-30;185;425;377;187504;181691;6274;83.4;80.9;2.8
39;2021-10-01;161;241;300;187665;181932;6574;83.5;81.0;2.9
39;2021-10-02;118;238;148;187783;182170;6722;83.6;81.1;3.0
39;2021-10-03;1;7;0;187784;182177;6722;83.6;81.1;3.0
39;2021-10-04;76;159;119;187860;182336;6841;83.6;81.1;3.0
39;2021-10-05;80;151;313;187940;182487;7154;83.6;81.2;3.2
39;2021-10-06;212;334;433;188152;182821;7587;83.7;81.4;3.4
39;2021-10-07;138;430;433;188290;183251;8020;83.8;81.5;3.6
39;2021-10-08;240;479;569;188530;183730;8589;83.9;81.8;3.8
39;2021-10-09;64;75;59;188594;183805;8648;83.9;81.8;3.8
39;2021-10-10;0;5;3;188594;183810;8651;83.9;81.8;3.8
39;2021-10-11;49;101;93;188643;183911;8744;83.9;81.8;3.9
39;2021-10-12;102;117;293;188745;184028;9037;84.0;81.9;4.0
39;2021-10-13;108;196;256;188853;184224;9293;84.0;82.0;4.1
39;2021-10-14;134;244;390;188987;184468;9683;84.1;82.1;4.3
39;2021-10-15;324;477;750;189311;184945;10433;84.2;82.3;4.6
39;2021-10-16;62;97;92;189373;185042;10525;84.3;82.3;4.7
39;2021-10-17;3;8;0;189376;185050;10525;84.3;82.3;4.7
39;2021-10-18;35;56;113;189411;185106;10638;84.3;82.4;4.7
39;2021-10-19;63;77;180;189474;185183;10818;84.3;82.4;4.8
39;2021-10-20;64;89;159;189538;185272;10977;84.3;82.4;4.9
39;2021-10-21;122;219;473;189660;185491;11450;84.4;82.5;5.1
39;2021-10-22;313;444;938;189973;185935;12388;84.5;82.7;5.5
39;2021-10-23;65;140;183;190038;186075;12571;84.6;82.8;5.6
39;2021-10-24;2;5;0;190040;186080;12571;84.6;82.8;5.6
39;2021-10-25;34;63;126;190074;186143;12697;84.6;82.8;5.6
39;2021-10-26;52;63;224;190126;186206;12921;84.6;82.9;5.7
39;2021-10-27;102;168;332;190228;186374;13253;84.6;82.9;5.9
39;2021-10-28;164;189;531;190392;186563;13784;84.7;83.0;6.1
39;2021-10-29;127;169;517;190519;186732;14301;84.8;83.1;6.4
39;2021-10-30;38;64;245;190557;186796;14546;84.8;83.1;6.5
39;2021-10-31;0;6;0;190557;186802;14546;84.8;83.1;6.5
39;2021-11-01;8;7;3;190565;186809;14549;84.8;83.1;6.5
39;2021-11-02;44;100;219;190609;186909;14768;84.8;83.2;6.6
39;2021-11-03;92;121;450;190701;187030;15218;84.9;83.2;6.8
39;2021-11-04;70;119;688;190771;187149;15906;84.9;83.3;7.1
39;2021-11-05;212;314;1076;190983;187463;16982;85.0;83.4;7.6
39;2021-11-06;30;49;120;191013;187512;17102;85.0;83.4;7.6
39;2021-11-07;0;4;3;191013;187516;17105;85.0;83.4;7.6
39;2021-11-08;36;69;280;191049;187585;17385;85.0;83.5;7.7
39;2021-11-09;65;92;718;191114;187677;18103;85.0;83.5;8.1
39;2021-11-10;188;182;1276;191302;187859;19379;85.1;83.6;8.6
39;2021-11-11;4;9;25;191306;187868;19404;85.1;83.6;8.6
39;2021-11-12;91;149;615;191397;188017;20019;85.2;83.7;8.9
39;2021-11-13;44;74;346;191441;188091;20365;85.2;83.7;9.1
39;2021-11-14;5;1;11;191446;188092;20376;85.2;83.7;9.1
39;2021-11-15;21;55;259;191467;188147;20635;85.2;83.7;9.2
39;2021-11-16;106;97;1045;191573;188244;21680;85.2;83.8;9.6
39;2021-11-17;95;195;1046;191668;188439;22726;85.3;83.9;10.1
39;2021-11-18;111;117;811;191779;188556;23537;85.3;83.9;10.5
39;2021-11-19;161;237;1403;191940;188793;24940;85.4;84.0;11.1
39;2021-11-20;82;51;378;192022;188844;25318;85.4;84.0;11.3
39;2021-11-21;2;2;2;192024;188846;25320;85.4;84.0;11.3
39;2021-11-22;34;55;334;192058;188901;25654;85.5;84.1;11.4
39;2021-11-23;116;86;1080;192174;188987;26734;85.5;84.1;11.9
39;2021-11-24;139;153;1274;192313;189140;28008;85.6;84.2;12.5
39;2021-11-25;127;86;1185;192440;189226;29193;85.6;84.2;13.0
39;2021-11-26;138;139;1976;192578;189365;31169;85.7;84.3;13.9
39;2021-11-27;46;70;613;192624;189435;31782;85.7;84.3;14.1
39;2021-11-28;5;4;27;192629;189439;31809;85.7;84.3;14.2
39;2021-11-29;51;64;1253;192680;189503;33062;85.7;84.3;14.7
39;2021-11-30;89;106;2338;192769;189609;35400;85.8;84.4;15.8
39;2021-12-01;93;163;2481;192862;189772;37881;85.8;84.4;16.9
39;2021-12-02;85;88;3172;192947;189860;41053;85.9;84.5;18.3
39;2021-12-03;93;146;2799;193040;190006;43852;85.9;84.6;19.5
39;2021-12-04;48;63;1057;193088;190069;44909;85.9;84.6;20.0
39;2021-12-05;2;5;46;193090;190074;44955;85.9;84.6;20.0
39;2021-12-06;54;58;1968;193144;190132;46923;85.9;84.6;20.9
39;2021-12-07;105;113;2980;193249;190245;49903;86.0;84.7;22.2
39;2021-12-08;118;88;3183;193367;190333;53086;86.0;84.7;23.6
39;2021-12-09;120;132;3562;193487;190465;56648;86.1;84.8;25.2
39;2021-12-10;96;178;3359;193583;190643;60007;86.1;84.8;26.7
39;2021-12-11;50;94;1076;193633;190737;61083;86.2;84.9;27.2
39;2021-12-12;5;5;50;193638;190742;61133;86.2;84.9;27.2
39;2021-12-13;92;67;2391;193730;190809;63524;86.2;84.9;28.3
39;2021-12-14;83;126;3261;193813;190935;66785;86.2;85.0;29.7
39;2021-12-15;118;153;3417;193931;191088;70202;86.3;85.0;31.2
39;2021-12-16;85;148;3393;194016;191236;73595;86.3;85.1;32.7
39;2021-12-17;133;166;3293;194149;191402;76888;86.4;85.2;34.2
39;2021-12-18;105;79;1499;194254;191481;78387;86.4;85.2;34.9
39;2021-12-19;6;2;81;194260;191483;78468;86.4;85.2;34.9
40;2020-12-27;0;0;0;0;0;0;0.0;0.0;0.0
40;2020-12-28;0;0;0;0;0;0;0.0;0.0;0.0
40;2020-12-29;0;0;0;0;0;0;0.0;0.0;0.0
40;2020-12-30;0;0;0;0;0;0;0.0;0.0;0.0
40;2020-12-31;0;0;0;0;0;0;0.0;0.0;0.0
40;2021-01-01;0;0;0;0;0;0;0.0;0.0;0.0
40;2021-01-02;2;0;0;2;0;0;0.0;0.0;0.0
40;2021-01-03;0;0;0;2;0;0;0.0;0.0;0.0
40;2021-01-04;1;0;0;3;0;0;0.0;0.0;0.0
40;2021-01-05;1;0;0;4;0;0;0.0;0.0;0.0
40;2021-01-06;5;0;0;9;0;0;0.0;0.0;0.0
40;2021-01-07;238;1;0;247;1;0;0.1;0.0;0.0
40;2021-01-08;437;4;0;684;5;0;0.2;0.0;0.0
40;2021-01-09;4;0;0;688;5;0;0.2;0.0;0.0
40;2021-01-10;4;0;0;692;5;0;0.2;0.0;0.0
40;2021-01-11;130;0;0;822;5;0;0.2;0.0;0.0
40;2021-01-12;63;0;0;885;5;0;0.2;0.0;0.0
40;2021-01-13;707;6;0;1592;11;0;0.4;0.0;0.0
40;2021-01-14;918;8;0;2510;19;0;0.7;0.0;0.0
40;2021-01-15;855;3;0;3365;22;0;0.9;0.0;0.0
40;2021-01-16;156;0;0;3521;22;0;1.0;0.0;0.0
40;2021-01-17;3;0;0;3524;22;0;1.0;0.0;0.0
40;2021-01-18;477;1;0;4001;23;0;1.1;0.0;0.0
40;2021-01-19;1216;4;0;5217;27;0;1.4;0.0;0.0
40;2021-01-20;943;3;0;6160;30;0;1.7;0.0;0.0
40;2021-01-21;1373;5;0;7533;35;0;2.1;0.0;0.0
40;2021-01-22;906;4;0;8439;39;0;2.3;0.0;0.0
40;2021-01-23;313;0;0;8752;39;0;2.4;0.0;0.0
40;2021-01-24;32;0;0;8784;39;0;2.4;0.0;0.0
40;2021-01-25;453;3;0;9237;42;0;2.5;0.0;0.0
40;2021-01-26;856;5;0;10093;47;0;2.8;0.0;0.0
40;2021-01-27;1131;14;0;11224;61;0;3.1;0.0;0.0
40;2021-01-28;783;131;0;12007;192;0;3.3;0.1;0.0
40;2021-01-29;625;268;0;12632;460;0;3.5;0.1;0.0
40;2021-01-30;252;8;0;12884;468;0;3.6;0.1;0.0
40;2021-01-31;22;2;0;12906;470;0;3.6;0.1;0.0
40;2021-02-01;403;132;0;13309;602;0;3.7;0.2;0.0
40;2021-02-02;934;89;0;14243;691;0;3.9;0.2;0.0
40;2021-02-03;918;322;0;15161;1013;0;4.2;0.3;0.0
40;2021-02-04;1110;607;0;16271;1620;0;4.5;0.4;0.0
40;2021-02-05;813;416;0;17084;2036;0;4.7;0.6;0.0
40;2021-02-06;397;83;0;17481;2119;0;4.8;0.6;0.0
40;2021-02-07;26;1;0;17507;2120;0;4.8;0.6;0.0
40;2021-02-08;426;142;0;17933;2262;0;4.9;0.6;0.0
40;2021-02-09;811;559;0;18744;2821;0;5.2;0.8;0.0
40;2021-02-10;760;532;0;19504;3353;0;5.4;0.9;0.0
40;2021-02-11;800;721;0;20304;4074;0;5.6;1.1;0.0
40;2021-02-12;614;731;0;20918;4805;0;5.8;1.3;0.0
40;2021-02-13;355;108;0;21273;4913;0;5.9;1.4;0.0
40;2021-02-14;10;8;0;21283;4921;0;5.9;1.4;0.0
40;2021-02-15;52;433;0;21335;5354;0;5.9;1.5;0.0
40;2021-02-16;287;642;0;21622;5996;0;6.0;1.7;0.0
40;2021-02-17;343;898;0;21965;6894;0;6.1;1.9;0.0
40;2021-02-18;398;839;0;22363;7733;0;6.2;2.1;0.0
40;2021-02-19;163;679;0;22526;8412;0;6.2;2.3;0.0
40;2021-02-20;44;147;0;22570;8559;0;6.2;2.4;0.0
40;2021-02-21;6;86;0;22576;8645;0;6.2;2.4;0.0
40;2021-02-22;101;592;0;22677;9237;0;6.3;2.5;0.0
40;2021-02-23;246;879;0;22923;10116;0;6.3;2.8;0.0
40;2021-02-24;323;735;0;23246;10851;0;6.4;3.0;0.0
40;2021-02-25;764;1007;0;24010;11858;0;6.6;3.3;0.0
40;2021-02-26;724;702;0;24734;12560;0;6.8;3.5;0.0
40;2021-02-27;406;174;0;25140;12734;0;6.9;3.5;0.0
40;2021-02-28;5;24;0;25145;12758;0;6.9;3.5;0.0
40;2021-03-01;451;533;0;25596;13291;0;7.1;3.7;0.0
40;2021-03-02;777;1046;0;26373;14337;0;7.3;4.0;0.0
40;2021-03-03;962;939;0;27335;15276;0;7.5;4.2;0.0
40;2021-03-04;1372;872;0;28707;16148;0;7.9;4.5;0.0
40;2021-03-05;1298;768;0;30005;16916;0;8.3;4.7;0.0
40;2021-03-06;908;382;0;30913;17298;0;8.5;4.8;0.0
40;2021-03-07;125;32;0;31038;17330;0;8.6;4.8;0.0
40;2021-03-08;908;527;0;31946;17857;0;8.8;4.9;0.0
40;2021-03-09;1554;645;0;33500;18502;0;9.2;5.1;0.0
40;2021-03-10;1809;725;0;35309;19227;0;9.7;5.3;0.0
40;2021-03-11;2070;686;0;37379;19913;0;10.3;5.5;0.0
40;2021-03-12;2213;492;0;39592;20405;0;10.9;5.6;0.0
40;2021-03-13;1111;226;0;40703;20631;0;11.2;5.7;0.0
40;2021-03-14;143;2;0;40846;20633;0;11.3;5.7;0.0
40;2021-03-15;1029;98;0;41875;20731;0;11.6;5.7;0.0
40;2021-03-16;1039;289;0;42914;21020;0;11.8;5.8;0.0
40;2021-03-17;1613;332;0;44527;21352;0;12.3;5.9;0.0
40;2021-03-18;1648;334;0;46175;21686;0;12.7;6.0;0.0
40;2021-03-19;1871;166;0;48046;21852;0;13.3;6.0;0.0
40;2021-03-20;809;15;0;48855;21867;0;13.5;6.0;0.0
40;2021-03-21;108;3;0;48963;21870;0;13.5;6.0;0.0
40;2021-03-22;1243;58;0;50206;21928;0;13.9;6.1;0.0
40;2021-03-23;2377;205;0;52583;22133;0;14.5;6.1;0.0
40;2021-03-24;2418;267;0;55001;22400;0;15.2;6.2;0.0
40;2021-03-25;2873;405;0;57874;22805;0;16.0;6.3;0.0
40;2021-03-26;3151;257;0;61025;23062;0;16.8;6.4;0.0
40;2021-03-27;977;74;0;62002;23136;0;17.1;6.4;0.0
40;2021-03-28;259;36;0;62261;23172;0;17.2;6.4;0.0
40;2021-03-29;1245;398;0;63506;23570;0;17.5;6.5;0.0
40;2021-03-30;2395;446;0;65901;24016;0;18.2;6.6;0.0
40;2021-03-31;2090;352;0;67991;24368;0;18.8;6.7;0.0
40;2021-04-01;2561;377;0;70552;24745;0;19.5;6.8;0.0
40;2021-04-02;2455;254;0;73007;24999;0;20.1;6.9;0.0
40;2021-04-03;760;142;0;73767;25141;0;20.4;6.9;0.0
40;2021-04-04;366;21;0;74133;25162;0;20.5;6.9;0.0
40;2021-04-05;586;57;0;74719;25219;0;20.6;7.0;0.0
40;2021-04-06;2176;870;0;76895;26089;0;21.2;7.2;0.0
40;2021-04-07;2679;966;0;79574;27055;0;22.0;7.5;0.0
40;2021-04-08;3134;982;0;82708;28037;0;22.8;7.7;0.0
40;2021-04-09;3909;691;0;86617;28728;0;23.9;7.9;0.0
40;2021-04-10;1680;428;0;88297;29156;0;24.4;8.0;0.0
40;2021-04-11;91;35;0;88388;29191;0;24.4;8.1;0.0
40;2021-04-12;2237;808;0;90625;29999;0;25.0;8.3;0.0
40;2021-04-13;2678;1213;0;93303;31212;0;25.7;8.6;0.0
40;2021-04-14;2615;1480;0;95918;32692;0;26.5;9.0;0.0
40;2021-04-15;3052;1571;0;98970;34263;0;27.3;9.5;0.0
40;2021-04-16;2955;1245;0;101925;35508;0;28.1;9.8;0.0
40;2021-04-17;1506;439;0;103431;35947;0;28.5;9.9;0.0
40;2021-04-18;126;86;0;103557;36033;0;28.6;9.9;0.0
40;2021-04-19;1231;1136;0;104788;37169;0;28.9;10.3;0.0
40;2021-04-20;1756;1808;0;106544;38977;0;29.4;10.8;0.0
40;2021-04-21;1910;1765;0;108454;40742;0;29.9;11.2;0.0
40;2021-04-22;2171;1857;0;110625;42599;0;30.5;11.8;0.0
40;2021-04-23;2265;1420;0;112890;44019;0;31.1;12.1;0.0
40;2021-04-24;1422;656;0;114312;44675;0;31.5;12.3;0.0
40;2021-04-25;102;94;0;114414;44769;0;31.6;12.4;0.0
40;2021-04-26;1400;1162;0;115814;45931;0;32.0;12.7;0.0
40;2021-04-27;1682;2053;0;117496;47984;0;32.4;13.2;0.0
40;2021-04-28;2235;1479;0;119731;49463;0;33.0;13.6;0.0
40;2021-04-29;2772;1938;0;122503;51401;0;33.8;14.2;0.0
40;2021-04-30;2833;1684;0;125336;53085;0;34.6;14.6;0.0
40;2021-05-01;1349;766;0;126685;53851;0;35.0;14.9;0.0
40;2021-05-02;216;309;0;126901;54160;0;35.0;14.9;0.0
40;2021-05-03;1962;1589;0;128863;55749;0;35.6;15.4;0.0
40;2021-05-04;2090;2600;0;130953;58349;0;36.1;16.1;0.0
40;2021-05-05;2388;2663;0;133341;61012;0;36.8;16.8;0.0
40;2021-05-06;2512;2889;0;135853;63901;0;37.5;17.6;0.0
40;2021-05-07;2152;3068;0;138005;66969;0;38.1;18.5;0.0
40;2021-05-08;791;471;0;138796;67440;0;38.3;18.6;0.0
40;2021-05-09;393;65;0;139189;67505;0;38.4;18.6;0.0
40;2021-05-10;1560;2233;0;140749;69738;0;38.8;19.2;0.0
40;2021-05-11;2447;2714;0;143196;72452;0;39.5;20.0;0.0
40;2021-05-12;2931;2076;0;146127;74528;0;40.3;20.6;0.0
40;2021-05-13;2113;532;0;148240;75060;0;40.9;20.7;0.0
40;2021-05-14;2485;1769;0;150725;76829;0;41.6;21.2;0.0
40;2021-05-15;1504;1009;0;152229;77838;0;42.0;21.5;0.0
40;2021-05-16;487;81;0;152716;77919;0;42.1;21.5;0.0
40;2021-05-17;2347;1472;0;155063;79391;0;42.8;21.9;0.0
40;2021-05-18;2716;1498;0;157779;80889;0;43.5;22.3;0.0
40;2021-05-19;3149;1185;0;160928;82074;0;44.4;22.6;0.0
40;2021-05-20;3732;1290;0;164660;83364;0;45.4;23.0;0.0
40;2021-05-21;3079;1428;0;167739;84792;0;46.3;23.4;0.0
40;2021-05-22;1377;865;0;169116;85657;0;46.7;23.6;0.0
40;2021-05-23;623;67;0;169739;85724;0;46.8;23.7;0.0
40;2021-05-24;1318;458;0;171057;86182;0;47.2;23.8;0.0
40;2021-05-25;2338;1445;0;173395;87627;0;47.8;24.2;0.0
40;2021-05-26;2796;1655;0;176191;89282;0;48.6;24.6;0.0
40;2021-05-27;2879;2042;0;179070;91324;0;49.4;25.2;0.0
40;2021-05-28;2794;2347;0;181864;93671;0;50.2;25.8;0.0
40;2021-05-29;1730;1330;0;183594;95001;0;50.7;26.2;0.0
40;2021-05-30;99;84;0;183693;95085;0;50.7;26.2;0.0
40;2021-05-31;2723;1348;0;186416;96433;0;51.4;26.6;0.0
40;2021-06-01;3172;1914;0;189588;98347;0;52.3;27.1;0.0
40;2021-06-02;3298;2102;0;192886;100449;0;53.2;27.7;0.0
40;2021-06-03;3750;2361;0;196636;102810;0;54.3;28.4;0.0
40;2021-06-04;3201;2866;0;199837;105676;0;55.1;29.2;0.0
40;2021-06-05;1951;1454;0;201788;107130;0;55.7;29.6;0.0
40;2021-06-06;568;108;0;202356;107238;0;55.8;29.6;0.0
40;2021-06-07;2348;2087;0;204704;109325;0;56.5;30.2;0.0
40;2021-06-08;3201;2232;0;207905;111557;0;57.4;30.8;0.0
40;2021-06-09;3334;2340;0;211239;113897;0;58.3;31.4;0.0
40;2021-06-10;3175;2122;0;214414;116019;0;59.2;32.0;0.0
40;2021-06-11;3267;2971;0;217681;118990;0;60.1;32.8;0.0
40;2021-06-12;2057;1718;0;219738;120708;0;60.6;33.3;0.0
40;2021-06-13;650;199;0;220388;120907;0;60.8;33.4;0.0
40;2021-06-14;1603;2699;0;221991;123606;0;61.3;34.1;0.0
40;2021-06-15;2337;2977;0;224328;126583;0;61.9;34.9;0.0
40;2021-06-16;2690;2687;0;227018;129270;0;62.6;35.7;0.0
40;2021-06-17;2536;2615;0;229554;131885;0;63.3;36.4;0.0
40;2021-06-18;2439;3074;0;231993;134959;0;64.0;37.2;0.0
40;2021-06-19;1808;1335;0;233801;136294;0;64.5;37.6;0.0
40;2021-06-20;338;320;0;234139;136614;0;64.6;37.7;0.0
40;2021-06-21;1337;2612;0;235476;139226;0;65.0;38.4;0.0
40;2021-06-22;1714;3212;0;237190;142438;0;65.4;39.3;0.0
40;2021-06-23;1648;3530;0;238838;145968;0;65.9;40.3;0.0
40;2021-06-24;1727;2374;0;240565;148342;0;66.4;40.9;0.0
40;2021-06-25;1830;3403;0;242395;151745;0;66.9;41.9;0.0
40;2021-06-26;1332;1838;0;243727;153583;0;67.2;42.4;0.0
40;2021-06-27;296;427;0;244023;154010;0;67.3;42.5;0.0
40;2021-06-28;1357;3069;0;245380;157079;0;67.7;43.3;0.0
40;2021-06-29;1606;3655;0;246986;160734;0;68.1;44.3;0.0
40;2021-06-30;1793;3818;0;248779;164552;0;68.6;45.4;0.0
40;2021-07-01;1734;4021;0;250513;168573;0;69.1;46.5;0.0
40;2021-07-02;1547;3968;0;252060;172541;0;69.5;47.6;0.0
40;2021-07-03;717;2068;0;252777;174609;0;69.7;48.2;0.0
40;2021-07-04;219;586;0;252996;175195;0;69.8;48.3;0.0
40;2021-07-05;1381;3083;0;254377;178278;0;70.2;49.2;0.0
40;2021-07-06;1663;3680;0;256040;181958;0;70.6;50.2;0.0
40;2021-07-07;1820;3877;0;257860;185835;0;71.1;51.3;0.0
40;2021-07-08;1873;3349;0;259733;189184;0;71.7;52.2;0.0
40;2021-07-09;1679;3995;0;261412;193179;0;72.1;53.3;0.0
40;2021-07-10;841;2226;0;262253;195405;0;72.4;53.9;0.0
40;2021-07-11;160;331;0;262413;195736;0;72.4;54.0;0.0
40;2021-07-12;1068;3911;0;263481;199647;0;72.7;55.1;0.0
40;2021-07-13;1973;4557;0;265454;204204;0;73.2;56.3;0.0
40;2021-07-14;1740;1935;0;267194;206139;0;73.7;56.9;0.0
40;2021-07-15;2253;4694;0;269447;210833;0;74.3;58.2;0.0
40;2021-07-16;2646;3760;0;272093;214593;0;75.1;59.2;0.0
40;2021-07-17;1616;2620;0;273709;217213;0;75.5;59.9;0.0
40;2021-07-18;319;597;0;274028;217810;0;75.6;60.1;0.0
40;2021-07-19;1904;3580;0;275932;221390;0;76.1;61.1;0.0
40;2021-07-20;2308;3784;0;278240;225174;0;76.8;62.1;0.0
40;2021-07-21;2503;3707;0;280743;228881;0;77.5;63.2;0.0
40;2021-07-22;2872;3689;0;283615;232570;0;78.3;64.2;0.0
40;2021-07-23;3096;3849;0;286711;236419;0;79.1;65.2;0.0
40;2021-07-24;2023;2013;0;288734;238432;0;79.7;65.8;0.0
40;2021-07-25;685;465;0;289419;238897;0;79.9;65.9;0.0
40;2021-07-26;2183;2718;0;291602;241615;0;80.5;66.7;0.0
40;2021-07-27;2579;3202;0;294181;244817;0;81.2;67.5;0.0
40;2021-07-28;2702;2979;0;296883;247796;0;81.9;68.4;0.0
40;2021-07-29;2764;2991;0;299647;250787;0;82.7;69.2;0.0
40;2021-07-30;2513;2938;0;302160;253725;0;83.4;70.0;0.0
40;2021-07-31;1470;1707;0;303630;255432;0;83.8;70.5;0.0
40;2021-08-01;233;194;0;303863;255626;0;83.8;70.5;0.0
40;2021-08-02;1636;1942;0;305499;257568;0;84.3;71.1;0.0
40;2021-08-03;1960;2203;0;307459;259771;0;84.8;71.7;0.0
40;2021-08-04;1785;1929;0;309244;261700;0;85.3;72.2;0.0
40;2021-08-05;1673;2206;0;310917;263906;0;85.8;72.8;0.0
40;2021-08-06;1591;2497;0;312508;266403;0;86.2;73.5;0.0
40;2021-08-07;1086;1508;0;313594;267911;0;86.5;73.9;0.0
40;2021-08-08;97;136;0;313691;268047;0;86.6;74.0;0.0
40;2021-08-09;1318;2281;0;315009;270328;0;86.9;74.6;0.0
40;2021-08-10;1261;2394;0;316270;272722;0;87.3;75.2;0.0
40;2021-08-11;1184;2038;0;317454;274760;0;87.6;75.8;0.0
40;2021-08-12;1103;2287;0;318557;277047;0;87.9;76.4;0.0
40;2021-08-13;979;2193;0;319536;279240;0;88.2;77.0;0.0
40;2021-08-14;566;1693;0;320102;280933;0;88.3;77.5;0.0
40;2021-08-15;27;219;0;320129;281152;0;88.3;77.6;0.0
40;2021-08-16;946;2556;0;321075;283708;0;88.6;78.3;0.0
40;2021-08-17;1013;2673;0;322088;286381;0;88.9;79.0;0.0
40;2021-08-18;849;2699;0;322937;289080;0;89.1;79.8;0.0
40;2021-08-19;788;2432;0;323725;291512;0;89.3;80.4;0.0
40;2021-08-20;757;2523;0;324482;294035;0;89.5;81.1;0.0
40;2021-08-21;455;1597;0;324937;295632;0;89.7;81.6;0.0
40;2021-08-22;79;394;0;325016;296026;0;89.7;81.7;0.0
40;2021-08-23;646;2425;0;325662;298451;0;89.9;82.3;0.0
40;2021-08-24;614;2256;0;326276;300707;0;90.0;83.0;0.0
40;2021-08-25;600;1807;0;326876;302514;0;90.2;83.5;0.0
40;2021-08-26;447;1550;0;327323;304064;0;90.3;83.9;0.0
40;2021-08-27;595;2230;0;327918;306294;0;90.5;84.5;0.0
40;2021-08-28;302;1147;0;328220;307441;0;90.6;84.8;0.0
40;2021-08-29;12;67;0;328232;307508;0;90.6;84.8;0.0
40;2021-08-30;571;1954;46;328803;309462;46;90.7;85.4;0.0
40;2021-08-31;461;1427;84;329264;310889;130;90.8;85.8;0.0
40;2021-09-01;473;1312;196;329737;312201;326;91.0;86.1;0.1
40;2021-09-02;425;1276;324;330162;313477;650;91.1;86.5;0.2
40;2021-09-03;441;1337;296;330603;314814;946;91.2;86.9;0.3
40;2021-09-04;346;974;133;330949;315788;1079;91.3;87.1;0.3
40;2021-09-05;12;41;24;330961;315829;1103;91.3;87.1;0.3
40;2021-09-06;254;704;198;331215;316533;1301;91.4;87.3;0.4
40;2021-09-07;273;788;217;331488;317321;1518;91.5;87.6;0.4
40;2021-09-08;372;915;322;331860;318236;1840;91.6;87.8;0.5
40;2021-09-09;278;721;310;332138;318957;2150;91.6;88.0;0.6
40;2021-09-10;371;987;341;332509;319944;2491;91.7;88.3;0.7
40;2021-09-11;259;699;123;332768;320643;2614;91.8;88.5;0.7
40;2021-09-12;25;31;2;332793;320674;2616;91.8;88.5;0.7
40;2021-09-13;353;576;405;333146;321250;3021;91.9;88.6;0.8
40;2021-09-14;315;401;549;333461;321651;3570;92.0;88.7;1.0
40;2021-09-15;414;849;602;333875;322500;4172;92.1;89.0;1.2
40;2021-09-16;255;346;357;334130;322846;4529;92.2;89.1;1.2
40;2021-09-17;353;795;625;334483;323641;5154;92.3;89.3;1.4
40;2021-09-18;189;599;161;334672;324240;5315;92.3;89.5;1.5
40;2021-09-19;3;17;21;334675;324257;5336;92.3;89.5;1.5
40;2021-09-20;163;398;378;334838;324655;5714;92.4;89.6;1.6
40;2021-09-21;161;267;474;334999;324922;6188;92.4;89.7;1.7
40;2021-09-22;233;580;442;335232;325502;6630;92.5;89.8;1.8
40;2021-09-23;160;296;669;335392;325798;7299;92.5;89.9;2.0
40;2021-09-24;239;590;405;335631;326388;7704;92.6;90.1;2.1
40;2021-09-25;136;414;151;335767;326802;7855;92.6;90.2;2.2
40;2021-09-26;1;9;3;335768;326811;7858;92.6;90.2;2.2
40;2021-09-27;106;252;236;335874;327063;8094;92.7;90.2;2.2
40;2021-09-28;77;237;406;335951;327300;8500;92.7;90.3;2.3
40;2021-09-29;218;548;361;336169;327848;8861;92.8;90.5;2.4
40;2021-09-30;107;226;379;336276;328074;9240;92.8;90.5;2.5
40;2021-10-01;264;402;469;336540;328476;9709;92.9;90.6;2.7
40;2021-10-02;197;336;142;336737;328812;9851;92.9;90.7;2.7
40;2021-10-03;1;11;0;336738;328823;9851;92.9;90.7;2.7
40;2021-10-04;121;245;323;336859;329068;10174;92.9;90.8;2.8
40;2021-10-05;102;242;390;336961;329310;10564;93.0;90.9;2.9
40;2021-10-06;264;425;684;337225;329735;11248;93.0;91.0;3.1
40;2021-10-07;112;226;461;337337;329961;11709;93.1;91.0;3.2
40;2021-10-08;205;447;816;337542;330408;12525;93.1;91.2;3.5
40;2021-10-09;139;225;223;337681;330633;12748;93.2;91.2;3.5
40;2021-10-10;3;15;4;337684;330648;12752;93.2;91.2;3.5
40;2021-10-11;82;172;340;337766;330820;13092;93.2;91.3;3.6
40;2021-10-12;101;165;415;337867;330985;13507;93.2;91.3;3.7
40;2021-10-13;210;369;800;338077;331354;14307;93.3;91.4;3.9
40;2021-10-14;77;151;659;338154;331505;14966;93.3;91.5;4.1
40;2021-10-15;148;325;774;338302;331830;15740;93.3;91.6;4.3
40;2021-10-16;116;184;240;338418;332014;15980;93.4;91.6;4.4
40;2021-10-17;2;2;3;338420;332016;15983;93.4;91.6;4.4
40;2021-10-18;76;165;452;338496;332181;16435;93.4;91.7;4.5
40;2021-10-19;92;127;507;338588;332308;16942;93.4;91.7;4.7
40;2021-10-20;192;264;1212;338780;332572;18154;93.5;91.8;5.0
40;2021-10-21;107;149;650;338887;332721;18804;93.5;91.8;5.2
40;2021-10-22;156;232;950;339043;332953;19754;93.5;91.9;5.5
40;2021-10-23;130;216;410;339173;333169;20164;93.6;91.9;5.6
40;2021-10-24;2;4;12;339175;333173;20176;93.6;91.9;5.6
40;2021-10-25;90;125;555;339265;333298;20731;93.6;92.0;5.7
40;2021-10-26;90;95;669;339355;333393;21400;93.6;92.0;5.9
40;2021-10-27;167;266;1307;339522;333659;22707;93.7;92.1;6.3
40;2021-10-28;82;98;686;339604;333757;23393;93.7;92.1;6.5
40;2021-10-29;134;190;1131;339738;333947;24524;93.7;92.1;6.8
40;2021-10-30;105;151;386;339843;334098;24910;93.8;92.2;6.9
40;2021-10-31;2;5;5;339845;334103;24915;93.8;92.2;6.9
40;2021-11-01;17;7;7;339862;334110;24922;93.8;92.2;6.9
40;2021-11-02;90;154;689;339952;334264;25611;93.8;92.2;7.1
40;2021-11-03;161;197;1455;340113;334461;27066;93.8;92.3;7.5
40;2021-11-04;105;130;913;340218;334591;27979;93.9;92.3;7.7
40;2021-11-05;116;168;1438;340334;334759;29417;93.9;92.4;8.1
40;2021-11-06;74;90;377;340408;334849;29794;93.9;92.4;8.2
40;2021-11-07;0;6;3;340408;334855;29797;93.9;92.4;8.2
40;2021-11-08;69;105;969;340477;334960;30766;93.9;92.4;8.5
40;2021-11-09;108;147;1484;340585;335107;32250;94.0;92.5;8.9
40;2021-11-10;150;198;1873;340735;335305;34123;94.0;92.5;9.4
40;2021-11-11;27;20;140;340762;335325;34263;94.0;92.5;9.5
40;2021-11-12;155;206;1928;340917;335531;36191;94.1;92.6;10.0
40;2021-11-13;66;103;450;340983;335634;36641;94.1;92.6;10.1
40;2021-11-14;2;8;6;340985;335642;36647;94.1;92.6;10.1
40;2021-11-15;100;87;1070;341085;335729;37717;94.1;92.6;10.4
40;2021-11-16;110;102;1914;341195;335831;39631;94.1;92.7;10.9
40;2021-11-17;168;167;2006;341363;335998;41637;94.2;92.7;11.5
40;2021-11-18;106;109;1639;341469;336107;43276;94.2;92.7;11.9
40;2021-11-19;164;197;2287;341633;336304;45563;94.3;92.8;12.6
40;2021-11-20;117;151;723;341750;336455;46286;94.3;92.8;12.8
40;2021-11-21;1;7;3;341751;336462;46289;94.3;92.8;12.8
40;2021-11-22;68;46;1357;341819;336508;47646;94.3;92.8;13.1
40;2021-11-23;138;109;2208;341957;336617;49854;94.4;92.9;13.8
40;2021-11-24;200;209;2249;342157;336826;52103;94.4;92.9;14.4
40;2021-11-25;115;120;2047;342272;336946;54150;94.4;93.0;14.9
40;2021-11-26;157;193;3015;342429;337139;57165;94.5;93.0;15.8
40;2021-11-27;80;111;906;342509;337250;58071;94.5;93.1;16.0
40;2021-11-28;9;8;266;342518;337258;58337;94.5;93.1;16.1
40;2021-11-29;73;99;2426;342591;337357;60763;94.5;93.1;16.8
40;2021-11-30;163;128;3679;342754;337485;64442;94.6;93.1;17.8
40;2021-12-01;133;174;4111;342887;337659;68553;94.6;93.2;18.9
40;2021-12-02;97;108;4222;342984;337767;72775;94.6;93.2;20.1
40;2021-12-03;138;204;4730;343122;337971;77505;94.7;93.3;21.4
40;2021-12-04;72;95;1568;343194;338066;79073;94.7;93.3;21.8
40;2021-12-05;9;9;269;343203;338075;79342;94.7;93.3;21.9
40;2021-12-06;127;158;4129;343330;338233;83471;94.7;93.3;23.0
40;2021-12-07;129;162;5721;343459;338395;89192;94.8;93.4;24.6
40;2021-12-08;139;183;4815;343598;338578;94007;94.8;93.4;25.9
40;2021-12-09;122;135;6065;343720;338713;100072;94.8;93.5;27.6
40;2021-12-10;135;192;5847;343855;338905;105919;94.9;93.5;29.2
40;2021-12-11;87;158;2282;343942;339063;108201;94.9;93.6;29.9
40;2021-12-12;19;8;384;343961;339071;108585;94.9;93.6;30.0
40;2021-12-13;98;126;4546;344059;339197;113131;94.9;93.6;31.2
40;2021-12-14;142;173;6151;344201;339370;119282;95.0;93.6;32.9
40;2021-12-15;141;216;5486;344342;339586;124768;95.0;93.7;34.4
40;2021-12-16;126;159;6463;344468;339745;131231;95.0;93.7;36.2
40;2021-12-17;169;234;6129;344637;339979;137360;95.1;93.8;37.9
40;2021-12-18;97;99;2897;344734;340078;140257;95.1;93.8;38.7
40;2021-12-19;16;13;512;344750;340091;140769;95.1;93.8;38.8
41;2020-12-27;0;0;0;0;0;0;0.0;0.0;0.0
41;2020-12-28;0;0;0;0;0;0;0.0;0.0;0.0
41;2020-12-29;1;0;0;1;0;0;0.0;0.0;0.0
41;2020-12-30;0;0;0;1;0;0;0.0;0.0;0.0
41;2020-12-31;0;0;0;1;0;0;0.0;0.0;0.0
41;2021-01-01;1;0;0;2;0;0;0.0;0.0;0.0
41;2021-01-02;0;0;0;2;0;0;0.0;0.0;0.0
41;2021-01-03;0;0;0;2;0;0;0.0;0.0;0.0
41;2021-01-04;0;0;0;2;0;0;0.0;0.0;0.0
41;2021-01-05;39;0;0;41;0;0;0.0;0.0;0.0
41;2021-01-06;51;0;0;92;0;0;0.0;0.0;0.0
41;2021-01-07;30;0;0;122;0;0;0.0;0.0;0.0
41;2021-01-08;10;0;0;132;0;0;0.0;0.0;0.0
41;2021-01-09;5;0;0;137;0;0;0.0;0.0;0.0
41;2021-01-10;2;0;0;139;0;0;0.0;0.0;0.0
41;2021-01-11;150;0;0;289;0;0;0.1;0.0;0.0
41;2021-01-12;318;1;0;607;1;0;0.2;0.0;0.0
41;2021-01-13;295;1;0;902;2;0;0.3;0.0;0.0
41;2021-01-14;307;2;0;1209;4;0;0.4;0.0;0.0
41;2021-01-15;236;2;0;1445;6;0;0.5;0.0;0.0
41;2021-01-16;3;0;0;1448;6;0;0.5;0.0;0.0
41;2021-01-17;17;0;0;1465;6;0;0.5;0.0;0.0
41;2021-01-18;412;1;0;1877;7;0;0.7;0.0;0.0
41;2021-01-19;844;2;0;2721;9;0;1.0;0.0;0.0
41;2021-01-20;1102;6;0;3823;15;0;1.3;0.0;0.0
41;2021-01-21;1511;10;0;5334;25;0;1.9;0.0;0.0
41;2021-01-22;858;1;0;6192;26;0;2.2;0.0;0.0
41;2021-01-23;91;0;0;6283;26;0;2.2;0.0;0.0
41;2021-01-24;2;0;0;6285;26;0;2.2;0.0;0.0
41;2021-01-25;414;4;0;6699;30;0;2.3;0.0;0.0
41;2021-01-26;534;9;0;7233;39;0;2.5;0.0;0.0
41;2021-01-27;439;3;0;7672;42;0;2.7;0.0;0.0
41;2021-01-28;606;63;0;8278;105;0;2.9;0.0;0.0
41;2021-01-29;280;27;0;8558;132;0;3.0;0.0;0.0
41;2021-01-30;9;2;0;8567;134;0;3.0;0.0;0.0
41;2021-01-31;0;0;0;8567;134;0;3.0;0.0;0.0
41;2021-02-01;346;143;0;8913;277;0;3.1;0.1;0.0
41;2021-02-02;458;239;0;9371;516;0;3.3;0.2;0.0
41;2021-02-03;363;214;0;9734;730;0;3.4;0.3;0.0
41;2021-02-04;499;189;0;10233;919;0;3.6;0.3;0.0
41;2021-02-05;360;208;0;10593;1127;0;3.7;0.4;0.0
41;2021-02-06;10;5;0;10603;1132;0;3.7;0.4;0.0
41;2021-02-07;4;1;0;10607;1133;0;3.7;0.4;0.0
41;2021-02-08;334;299;0;10941;1432;0;3.8;0.5;0.0
41;2021-02-09;548;434;0;11489;1866;0;4.0;0.7;0.0
41;2021-02-10;501;651;0;11990;2517;0;4.2;0.9;0.0
41;2021-02-11;987;1083;0;12977;3600;0;4.5;1.3;0.0
41;2021-02-12;671;364;0;13648;3964;0;4.8;1.4;0.0
41;2021-02-13;17;14;0;13665;3978;0;4.8;1.4;0.0
41;2021-02-14;1;41;0;13666;4019;0;4.8;1.4;0.0
41;2021-02-15;323;320;0;13989;4339;0;4.9;1.5;0.0
41;2021-02-16;363;556;0;14352;4895;0;5.0;1.7;0.0
41;2021-02-17;344;475;0;14696;5370;0;5.1;1.9;0.0
41;2021-02-18;582;384;0;15278;5754;0;5.3;2.0;0.0
41;2021-02-19;460;353;0;15738;6107;0;5.5;2.1;0.0
41;2021-02-20;82;57;0;15820;6164;0;5.5;2.2;0.0
41;2021-02-21;0;0;0;15820;6164;0;5.5;2.2;0.0
41;2021-02-22;339;411;0;16159;6575;0;5.6;2.3;0.0
41;2021-02-23;482;355;0;16641;6930;0;5.8;2.4;0.0
41;2021-02-24;317;451;0;16958;7381;0;5.9;2.6;0.0
41;2021-02-25;667;469;0;17625;7850;0;6.2;2.7;0.0
41;2021-02-26;638;271;0;18263;8121;0;6.4;2.8;0.0
41;2021-02-27;178;15;0;18441;8136;0;6.4;2.8;0.0
41;2021-02-28;3;30;0;18444;8166;0;6.4;2.9;0.0
41;2021-03-01;333;334;0;18777;8500;0;6.6;3.0;0.0
41;2021-03-02;595;425;0;19372;8925;0;6.8;3.1;0.0
41;2021-03-03;534;467;0;19906;9392;0;7.0;3.3;0.0
41;2021-03-04;794;793;0;20700;10185;0;7.2;3.6;0.0
41;2021-03-05;858;652;0;21558;10837;0;7.5;3.8;0.0
41;2021-03-06;746;24;0;22304;10861;0;7.8;3.8;0.0
41;2021-03-07;467;26;0;22771;10887;0;8.0;3.8;0.0
41;2021-03-08;312;377;0;23083;11264;0;8.1;3.9;0.0
41;2021-03-09;1042;449;0;24125;11713;0;8.4;4.1;0.0
41;2021-03-10;776;464;0;24901;12177;0;8.7;4.3;0.0
41;2021-03-11;1176;678;0;26077;12855;0;9.1;4.5;0.0
41;2021-03-12;1188;413;0;27265;13268;0;9.5;4.6;0.0
41;2021-03-13;1191;25;0;28456;13293;0;9.9;4.6;0.0
41;2021-03-14;357;6;0;28813;13299;0;10.1;4.6;0.0
41;2021-03-15;786;354;0;29599;13653;0;10.3;4.8;0.0
41;2021-03-16;940;420;0;30539;14073;0;10.7;4.9;0.0
41;2021-03-17;585;256;0;31124;14329;0;10.9;5.0;0.0
41;2021-03-18;881;397;0;32005;14726;0;11.2;5.1;0.0
41;2021-03-19;915;332;0;32920;15058;0;11.5;5.3;0.0
41;2021-03-20;531;22;0;33451;15080;0;11.7;5.3;0.0
41;2021-03-21;8;0;0;33459;15080;0;11.7;5.3;0.0
41;2021-03-22;781;312;0;34240;15392;0;12.0;5.4;0.0
41;2021-03-23;1201;521;0;35441;15913;0;12.4;5.6;0.0
41;2021-03-24;1255;397;0;36696;16310;0;12.8;5.7;0.0
41;2021-03-25;1890;421;0;38586;16731;0;13.5;5.8;0.0
41;2021-03-26;1578;339;0;40164;17070;0;14.0;6.0;0.0
41;2021-03-27;467;68;0;40631;17138;0;14.2;6.0;0.0
41;2021-03-28;7;1;0;40638;17139;0;14.2;6.0;0.0
41;2021-03-29;928;312;0;41566;17451;0;14.5;6.1;0.0
41;2021-03-30;1462;541;0;43028;17992;0;15.0;6.3;0.0
41;2021-03-31;1141;516;0;44169;18508;0;15.4;6.5;0.0
41;2021-04-01;2105;540;0;46274;19048;0;16.2;6.7;0.0
41;2021-04-02;1251;469;0;47525;19517;0;16.6;6.8;0.0
41;2021-04-03;347;28;0;47872;19545;0;16.7;6.8;0.0
41;2021-04-04;54;3;0;47926;19548;0;16.8;6.8;0.0
41;2021-04-05;142;2;0;48068;19550;0;16.8;6.8;0.0
41;2021-04-06;1299;607;0;49367;20157;0;17.3;7.0;0.0
41;2021-04-07;1857;666;0;51224;20823;0;17.9;7.3;0.0
41;2021-04-08;2219;882;0;53443;21705;0;18.7;7.6;0.0
41;2021-04-09;2522;602;0;55965;22307;0;19.6;7.8;0.0
41;2021-04-10;1053;466;0;57018;22773;0;19.9;8.0;0.0
41;2021-04-11;293;346;0;57311;23119;0;20.0;8.1;0.0
41;2021-04-12;1714;635;0;59025;23754;0;20.6;8.3;0.0
41;2021-04-13;2249;894;0;61274;24648;0;21.4;8.6;0.0
41;2021-04-14;1845;558;0;63119;25206;0;22.1;8.8;0.0
41;2021-04-15;2396;935;0;65515;26141;0;22.9;9.1;0.0
41;2021-04-16;1983;619;0;67498;26760;0;23.6;9.4;0.0
41;2021-04-17;761;120;0;68259;26880;0;23.9;9.4;0.0
41;2021-04-18;26;9;0;68285;26889;0;23.9;9.4;0.0
41;2021-04-19;1299;664;0;69584;27553;0;24.3;9.6;0.0
41;2021-04-20;1967;1040;0;71551;28593;0;25.0;10.0;0.0
41;2021-04-21;1548;828;0;73099;29421;0;25.6;10.3;0.0
41;2021-04-22;2197;1385;0;75296;30806;0;26.3;10.8;0.0
41;2021-04-23;1736;1023;0;77032;31829;0;26.9;11.1;0.0
41;2021-04-24;1421;279;0;78453;32108;0;27.4;11.2;0.0
41;2021-04-25;792;15;0;79245;32123;0;27.7;11.2;0.0
41;2021-04-26;1382;638;0;80627;32761;0;28.2;11.5;0.0
41;2021-04-27;2112;1027;0;82739;33788;0;28.9;11.8;0.0
41;2021-04-28;1621;892;0;84360;34680;0;29.5;12.1;0.0
41;2021-04-29;2208;1311;0;86568;35991;0;30.3;12.6;0.0
41;2021-04-30;1993;871;0;88561;36862;0;31.0;12.9;0.0
41;2021-05-01;216;26;0;88777;36888;0;31.0;12.9;0.0
41;2021-05-02;134;22;0;88911;36910;0;31.1;12.9;0.0
41;2021-05-03;1826;953;0;90737;37863;0;31.7;13.2;0.0
41;2021-05-04;2043;1528;0;92780;39391;0;32.4;13.8;0.0
41;2021-05-05;1922;1230;0;94702;40621;0;33.1;14.2;0.0
41;2021-05-06;2352;1654;0;97054;42275;0;33.9;14.8;0.0
41;2021-05-07;2004;1814;0;99058;44089;0;34.6;15.4;0.0
41;2021-05-08;228;171;0;99286;44260;0;34.7;15.5;0.0
41;2021-05-09;34;373;0;99320;44633;0;34.7;15.6;0.0
41;2021-05-10;1585;1595;0;100905;46228;0;35.3;16.2;0.0
41;2021-05-11;1998;2057;0;102903;48285;0;36.0;16.9;0.0
41;2021-05-12;1954;1688;0;104857;49973;0;36.7;17.5;0.0
41;2021-05-13;1283;897;0;106140;50870;0;37.1;17.8;0.0
41;2021-05-14;1570;1345;0;107710;52215;0;37.7;18.3;0.0
41;2021-05-15;381;354;0;108091;52569;0;37.8;18.4;0.0
41;2021-05-16;41;13;0;108132;52582;0;37.8;18.4;0.0
41;2021-05-17;2364;619;0;110496;53201;0;38.6;18.6;0.0
41;2021-05-18;3026;1005;0;113522;54206;0;39.7;19.0;0.0
41;2021-05-19;2534;724;0;116056;54930;0;40.6;19.2;0.0
41;2021-05-20;3129;1106;0;119185;56036;0;41.7;19.6;0.0
41;2021-05-21;2560;1015;0;121745;57051;0;42.6;19.9;0.0
41;2021-05-22;528;259;0;122273;57310;0;42.7;20.0;0.0
41;2021-05-23;40;10;0;122313;57320;0;42.8;20.0;0.0
41;2021-05-24;2196;130;0;124509;57450;0;43.5;20.1;0.0
41;2021-05-25;2777;639;0;127286;58089;0;44.5;20.3;0.0
41;2021-05-26;2825;751;0;130111;58840;0;45.5;20.6;0.0
41;2021-05-27;3051;1169;0;133162;60009;0;46.6;21.0;0.0
41;2021-05-28;2978;1113;0;136140;61122;0;47.6;21.4;0.0
41;2021-05-29;2044;480;0;138184;61602;0;48.3;21.5;0.0
41;2021-05-30;316;41;0;138500;61643;0;48.4;21.6;0.0
41;2021-05-31;1836;1571;0;140336;63214;0;49.1;22.1;0.0
41;2021-06-01;2324;1931;0;142660;65145;0;49.9;22.8;0.0
41;2021-06-02;1976;1331;0;144636;66476;0;50.6;23.2;0.0
41;2021-06-03;2639;1891;0;147275;68367;0;51.5;23.9;0.0
41;2021-06-04;2325;1964;0;149600;70331;0;52.3;24.6;0.0
41;2021-06-05;887;1402;0;150487;71733;0;52.6;25.1;0.0
41;2021-06-06;135;742;0;150622;72475;0;52.7;25.3;0.0
41;2021-06-07;1664;1640;0;152286;74115;0;53.2;25.9;0.0
41;2021-06-08;1889;2323;0;154175;76438;0;53.9;26.7;0.0
41;2021-06-09;1816;1655;0;155991;78093;0;54.5;27.3;0.0
41;2021-06-10;2144;1812;0;158135;79905;0;55.3;27.9;0.0
41;2021-06-11;1738;1834;0;159873;81739;0;55.9;28.6;0.0
41;2021-06-12;912;740;0;160785;82479;0;56.2;28.8;0.0
41;2021-06-13;59;84;0;160844;82563;0;56.2;28.9;0.0
41;2021-06-14;1465;1988;0;162309;84551;0;56.7;29.6;0.0
41;2021-06-15;1988;2679;0;164297;87230;0;57.4;30.5;0.0
41;2021-06-16;1918;2333;0;166215;89563;0;58.1;31.3;0.0
41;2021-06-17;2008;2473;0;168223;92036;0;58.8;32.2;0.0
41;2021-06-18;1801;2362;0;170024;94398;0;59.4;33.0;0.0
41;2021-06-19;667;613;0;170691;95011;0;59.7;33.2;0.0
41;2021-06-20;33;49;0;170724;95060;0;59.7;33.2;0.0
41;2021-06-21;1439;1830;0;172163;96890;0;60.2;33.9;0.0
41;2021-06-22;1705;2472;0;173868;99362;0;60.8;34.7;0.0
41;2021-06-23;1519;2061;0;175387;101423;0;61.3;35.5;0.0
41;2021-06-24;1494;2164;0;176881;103587;0;61.8;36.2;0.0
41;2021-06-25;1342;2604;0;178223;106191;0;62.3;37.1;0.0
41;2021-06-26;613;779;0;178836;106970;0;62.5;37.4;0.0
41;2021-06-27;13;50;0;178849;107020;0;62.5;37.4;0.0
41;2021-06-28;569;2712;0;179418;109732;0;62.7;38.4;0.0
41;2021-06-29;823;3366;0;180241;113098;0;63.0;39.5;0.0
41;2021-06-30;731;3073;0;180972;116171;0;63.3;40.6;0.0
41;2021-07-01;877;3017;0;181849;119188;0;63.6;41.7;0.0
41;2021-07-02;791;3382;0;182640;122570;0;63.9;42.9;0.0
41;2021-07-03;405;853;0;183045;123423;0;64.0;43.1;0.0
41;2021-07-04;14;36;0;183059;123459;0;64.0;43.2;0.0
41;2021-07-05;540;2822;0;183599;126281;0;64.2;44.1;0.0
41;2021-07-06;825;3475;0;184424;129756;0;64.5;45.4;0.0
41;2021-07-07;742;3155;0;185166;132911;0;64.7;46.5;0.0
41;2021-07-08;1125;3373;0;186291;136284;0;65.1;47.6;0.0
41;2021-07-09;761;3629;0;187052;139913;0;65.4;48.9;0.0
41;2021-07-10;437;2179;0;187489;142092;0;65.5;49.7;0.0
41;2021-07-11;18;287;0;187507;142379;0;65.6;49.8;0.0
41;2021-07-12;992;2585;0;188499;144964;0;65.9;50.7;0.0
41;2021-07-13;1370;3479;0;189869;148443;0;66.4;51.9;0.0
41;2021-07-14;247;1057;0;190116;149500;0;66.5;52.3;0.0
41;2021-07-15;1542;3478;0;191658;152978;0;67.0;53.5;0.0
41;2021-07-16;1328;3490;0;192986;156468;0;67.5;54.7;0.0
41;2021-07-17;602;1106;0;193588;157574;0;67.7;55.1;0.0
41;2021-07-18;55;67;0;193643;157641;0;67.7;55.1;0.0
41;2021-07-19;1365;2536;0;195008;160177;0;68.2;56.0;0.0
41;2021-07-20;1824;2930;0;196832;163107;0;68.8;57.0;0.0
41;2021-07-21;2011;2453;0;198843;165560;0;69.5;57.9;0.0
41;2021-07-22;2494;2591;0;201337;168151;0;70.4;58.8;0.0
41;2021-07-23;2308;2722;0;203645;170873;0;71.2;59.7;0.0
41;2021-07-24;538;1228;0;204183;172101;0;71.4;60.2;0.0
41;2021-07-25;58;50;0;204241;172151;0;71.4;60.2;0.0
41;2021-07-26;1944;2017;0;206185;174168;0;72.1;60.9;0.0
41;2021-07-27;2709;2505;0;208894;176673;0;73.0;61.8;0.0
41;2021-07-28;2445;2067;0;211339;178740;0;73.9;62.5;0.0
41;2021-07-29;2557;2268;0;213896;181008;0;74.8;63.3;0.0
41;2021-07-30;2316;2310;0;216212;183318;0;75.6;64.1;0.0
41;2021-07-31;678;815;0;216890;184133;0;75.8;64.4;0.0
41;2021-08-01;54;30;0;216944;184163;0;75.8;64.4;0.0
41;2021-08-02;1661;1843;0;218605;186006;0;76.4;65.0;0.0
41;2021-08-03;2606;2015;0;221211;188021;0;77.3;65.7;0.0
41;2021-08-04;2537;1403;0;223748;189424;0;78.2;66.2;0.0
41;2021-08-05;2891;1379;0;226639;190803;0;79.2;66.7;0.0
41;2021-08-06;2216;1359;0;228855;192162;0;80.0;67.2;0.0
41;2021-08-07;640;441;0;229495;192603;0;80.2;67.3;0.0
41;2021-08-08;46;39;0;229541;192642;0;80.2;67.3;0.0
41;2021-08-09;1687;1363;0;231228;194005;0;80.8;67.8;0.0
41;2021-08-10;2385;1487;0;233613;195492;0;81.7;68.3;0.0
41;2021-08-11;1554;1539;0;235167;197031;0;82.2;68.9;0.0
41;2021-08-12;1857;1459;0;237024;198490;0;82.9;69.4;0.0
41;2021-08-13;1426;1712;0;238450;200202;0;83.4;70.0;0.0
41;2021-08-14;410;344;0;238860;200546;0;83.5;70.1;0.0
41;2021-08-15;13;28;0;238873;200574;0;83.5;70.1;0.0
41;2021-08-16;888;2058;0;239761;202632;0;83.8;70.8;0.0
41;2021-08-17;1446;1819;0;241207;204451;0;84.3;71.5;0.0
41;2021-08-18;1169;2106;0;242376;206557;0;84.7;72.2;0.0
41;2021-08-19;1208;1735;0;243584;208292;0;85.2;72.8;0.0
41;2021-08-20;943;2382;0;244527;210674;0;85.5;73.7;0.0
41;2021-08-21;233;410;0;244760;211084;0;85.6;73.8;0.0
41;2021-08-22;7;54;0;244767;211138;0;85.6;73.8;0.0
41;2021-08-23;696;2288;0;245463;213426;0;85.8;74.6;0.0
41;2021-08-24;1222;2245;0;246685;215671;0;86.2;75.4;0.0
41;2021-08-25;643;2284;0;247328;217955;0;86.5;76.2;0.0
41;2021-08-26;774;2626;0;248102;220581;0;86.7;77.1;0.0
41;2021-08-27;618;2757;0;248720;223338;0;87.0;78.1;0.0
41;2021-08-28;140;773;0;248860;224111;0;87.0;78.3;0.0
41;2021-08-29;43;44;0;248903;224155;0;87.0;78.4;0.0
41;2021-08-30;711;2191;8;249614;226346;8;87.3;79.1;0.0
41;2021-08-31;706;2457;45;250320;228803;53;87.5;80.0;0.0
41;2021-09-01;570;1859;118;250890;230662;171;87.7;80.6;0.1
41;2021-09-02;514;1923;120;251404;232585;291;87.9;81.3;0.1
41;2021-09-03;630;2056;125;252034;234641;416;88.1;82.0;0.1
41;2021-09-04;232;729;39;252266;235370;455;88.2;82.3;0.2
41;2021-09-05;7;23;7;252273;235393;462;88.2;82.3;0.2
41;2021-09-06;316;1032;145;252589;236425;607;88.3;82.7;0.2
41;2021-09-07;389;1130;174;252978;237555;781;88.4;83.0;0.3
41;2021-09-08;376;1281;116;253354;238836;897;88.6;83.5;0.3
41;2021-09-09;301;1102;143;253655;239938;1040;88.7;83.9;0.4
41;2021-09-10;435;1250;191;254090;241188;1231;88.8;84.3;0.4
41;2021-09-11;155;527;30;254245;241715;1261;88.9;84.5;0.4
41;2021-09-12;5;8;1;254250;241723;1262;88.9;84.5;0.4
41;2021-09-13;235;637;247;254485;242360;1509;89.0;84.7;0.5
41;2021-09-14;332;734;255;254817;243094;1764;89.1;85.0;0.6
41;2021-09-15;298;1126;244;255115;244220;2008;89.2;85.4;0.7
41;2021-09-16;241;800;237;255356;245020;2245;89.3;85.7;0.8
41;2021-09-17;379;738;281;255735;245758;2526;89.4;85.9;0.9
41;2021-09-18;129;262;21;255864;246020;2547;89.5;86.0;0.9
41;2021-09-19;3;19;0;255867;246039;2547;89.5;86.0;0.9
41;2021-09-20;189;562;262;256056;246601;2809;89.5;86.2;1.0
41;2021-09-21;180;487;287;256236;247088;3096;89.6;86.4;1.1
41;2021-09-22;279;875;347;256515;247963;3443;89.7;86.7;1.2
41;2021-09-23;223;611;587;256738;248574;4030;89.8;86.9;1.4
41;2021-09-24;315;648;469;257053;249222;4499;89.9;87.1;1.6
41;2021-09-25;104;321;83;257157;249543;4582;89.9;87.2;1.6
41;2021-09-26;0;9;6;257157;249552;4588;89.9;87.2;1.6
41;2021-09-27;162;379;292;257319;249931;4880;90.0;87.4;1.7
41;2021-09-28;163;395;399;257482;250326;5279;90.0;87.5;1.8
41;2021-09-29;175;529;280;257657;250855;5559;90.1;87.7;1.9
41;2021-09-30;116;325;482;257773;251180;6041;90.1;87.8;2.1
41;2021-10-01;235;405;380;258008;251585;6421;90.2;88.0;2.2
41;2021-10-02;100;196;65;258108;251781;6486;90.2;88.0;2.3
41;2021-10-03;4;5;1;258112;251786;6487;90.2;88.0;2.3
41;2021-10-04;119;259;394;258231;252045;6881;90.3;88.1;2.4
41;2021-10-05;122;262;547;258353;252307;7428;90.3;88.2;2.6
41;2021-10-06;237;431;524;258590;252738;7952;90.4;88.4;2.8
41;2021-10-07;119;178;539;258709;252916;8491;90.4;88.4;3.0
41;2021-10-08;200;475;635;258909;253391;9126;90.5;88.6;3.2
41;2021-10-09;80;219;135;258989;253610;9261;90.5;88.7;3.2
41;2021-10-10;4;13;3;258993;253623;9264;90.5;88.7;3.2
41;2021-10-11;124;218;461;259117;253841;9725;90.6;88.7;3.4
41;2021-10-12;73;168;405;259190;254009;10130;90.6;88.8;3.5
41;2021-10-13;187;315;522;259377;254324;10652;90.7;88.9;3.7
41;2021-10-14;78;133;435;259455;254457;11087;90.7;89.0;3.9
41;2021-10-15;176;458;675;259631;254915;11762;90.8;89.1;4.1
41;2021-10-16;53;114;107;259684;255029;11869;90.8;89.2;4.1
41;2021-10-17;1;3;2;259685;255032;11871;90.8;89.2;4.2
41;2021-10-18;140;221;503;259825;255253;12374;90.8;89.2;4.3
41;2021-10-19;76;146;441;259901;255399;12815;90.9;89.3;4.5
41;2021-10-20;165;267;674;260066;255666;13489;90.9;89.4;4.7
41;2021-10-21;62;72;340;260128;255738;13829;90.9;89.4;4.8
41;2021-10-22;125;314;682;260253;256052;14511;91.0;89.5;5.1
41;2021-10-23;50;69;149;260303;256121;14660;91.0;89.5;5.1
41;2021-10-24;2;5;1;260305;256126;14661;91.0;89.5;5.1
41;2021-10-25;137;157;622;260442;256283;15283;91.1;89.6;5.3
41;2021-10-26;72;88;430;260514;256371;15713;91.1;89.6;5.5
41;2021-10-27;170;235;825;260684;256606;16538;91.1;89.7;5.8
41;2021-10-28;58;136;291;260742;256742;16829;91.2;89.8;5.9
41;2021-10-29;148;232;900;260890;256974;17729;91.2;89.8;6.2
41;2021-10-30;35;55;142;260925;257029;17871;91.2;89.9;6.2
41;2021-10-31;2;7;0;260927;257036;17871;91.2;89.9;6.2
41;2021-11-01;8;10;10;260935;257046;17881;91.2;89.9;6.3
41;2021-11-02;44;81;268;260979;257127;18149;91.2;89.9;6.3
41;2021-11-03;116;179;586;261095;257306;18735;91.3;90.0;6.5
41;2021-11-04;55;78;435;261150;257384;19170;91.3;90.0;6.7
41;2021-11-05;127;204;1225;261277;257588;20395;91.3;90.1;7.1
41;2021-11-06;60;74;317;261337;257662;20712;91.4;90.1;7.2
41;2021-11-07;0;6;8;261337;257668;20720;91.4;90.1;7.2
41;2021-11-08;60;160;1142;261397;257828;21862;91.4;90.1;7.6
41;2021-11-09;76;79;801;261473;257907;22663;91.4;90.2;7.9
41;2021-11-10;102;137;1010;261575;258044;23673;91.4;90.2;8.3
41;2021-11-11;1;11;15;261576;258055;23688;91.4;90.2;8.3
41;2021-11-12;98;122;926;261674;258177;24614;91.5;90.3;8.6
41;2021-11-13;56;84;287;261730;258261;24901;91.5;90.3;8.7
41;2021-11-14;4;6;5;261734;258267;24906;91.5;90.3;8.7
41;2021-11-15;81;85;978;261815;258352;25884;91.5;90.3;9.0
41;2021-11-16;74;70;1175;261889;258422;27059;91.6;90.3;9.5
41;2021-11-17;115;156;1106;262004;258578;28165;91.6;90.4;9.8
41;2021-11-18;98;114;1133;262102;258692;29298;91.6;90.4;10.2
41;2021-11-19;123;125;1527;262225;258817;30825;91.7;90.5;10.8
41;2021-11-20;80;83;498;262305;258900;31323;91.7;90.5;11.0
41;2021-11-21;2;2;28;262307;258902;31351;91.7;90.5;11.0
41;2021-11-22;69;61;1321;262376;258963;32672;91.7;90.5;11.4
41;2021-11-23;81;67;1187;262457;259030;33859;91.8;90.6;11.8
41;2021-11-24;116;112;1476;262573;259142;35335;91.8;90.6;12.4
41;2021-11-25;86;73;1409;262659;259215;36744;91.8;90.6;12.8
41;2021-11-26;139;136;2503;262798;259351;39247;91.9;90.7;13.7
41;2021-11-27;82;78;818;262880;259429;40065;91.9;90.7;14.0
41;2021-11-28;2;5;30;262882;259434;40095;91.9;90.7;14.0
41;2021-11-29;77;65;2338;262959;259499;42433;91.9;90.7;14.8
41;2021-11-30;65;84;1858;263024;259583;44291;92.0;90.8;15.5
41;2021-12-01;88;114;3249;263112;259697;47540;92.0;90.8;16.6
41;2021-12-02;93;73;2899;263205;259770;50439;92.0;90.8;17.6
41;2021-12-03;89;107;3514;263294;259877;53953;92.0;90.9;18.9
41;2021-12-04;57;82;1280;263351;259959;55233;92.1;90.9;19.3
41;2021-12-05;12;8;223;263363;259967;55456;92.1;90.9;19.4
41;2021-12-06;50;61;3562;263413;260028;59018;92.1;90.9;20.6
41;2021-12-07;102;120;4443;263515;260148;63461;92.1;90.9;22.2
41;2021-12-08;94;117;3927;263609;260265;67388;92.2;91.0;23.6
41;2021-12-09;106;106;4243;263715;260371;71631;92.2;91.0;25.0
41;2021-12-10;103;142;4442;263818;260513;76073;92.2;91.1;26.6
41;2021-12-11;54;62;1680;263872;260575;77753;92.3;91.1;27.2
41;2021-12-12;8;7;277;263880;260582;78030;92.3;91.1;27.3
41;2021-12-13;52;85;3665;263932;260667;81695;92.3;91.1;28.6
41;2021-12-14;93;112;5327;264025;260779;87022;92.3;91.2;30.4
41;2021-12-15;100;114;4456;264125;260893;91478;92.3;91.2;32.0
41;2021-12-16;121;131;5004;264246;261024;96482;92.4;91.3;33.7
41;2021-12-17;143;190;5413;264389;261214;101895;92.4;91.3;35.6
41;2021-12-18;108;88;3162;264497;261302;105057;92.5;91.4;36.7
41;2021-12-19;7;8;553;264504;261310;105610;92.5;91.4;36.9
42;2020-12-27;0;0;0;0;0;0;0.0;0.0;0.0
42;2020-12-28;3;0;0;3;0;0;0.0;0.0;0.0
42;2020-12-29;1;0;0;4;0;0;0.0;0.0;0.0
42;2020-12-30;0;0;0;4;0;0;0.0;0.0;0.0
42;2020-12-31;0;0;0;4;0;0;0.0;0.0;0.0
42;2021-01-01;0;0;0;4;0;0;0.0;0.0;0.0
42;2021-01-02;0;0;0;4;0;0;0.0;0.0;0.0
42;2021-01-03;0;0;0;4;0;0;0.0;0.0;0.0
42;2021-01-04;2;0;0;6;0;0;0.0;0.0;0.0
42;2021-01-05;3;0;0;9;0;0;0.0;0.0;0.0
42;2021-01-06;169;1;0;178;1;0;0.0;0.0;0.0
42;2021-01-07;252;0;0;430;1;0;0.1;0.0;0.0
42;2021-01-08;260;4;0;690;5;0;0.1;0.0;0.0
42;2021-01-09;130;1;0;820;6;0;0.1;0.0;0.0
42;2021-01-10;0;0;0;820;6;0;0.1;0.0;0.0
42;2021-01-11;282;2;0;1102;8;0;0.2;0.0;0.0
42;2021-01-12;403;1;0;1505;9;0;0.2;0.0;0.0
42;2021-01-13;501;2;0;2006;11;0;0.3;0.0;0.0
42;2021-01-14;755;5;0;2761;16;0;0.4;0.0;0.0
42;2021-01-15;692;3;0;3453;19;0;0.5;0.0;0.0
42;2021-01-16;281;2;0;3734;21;0;0.6;0.0;0.0
42;2021-01-17;211;0;0;3945;21;0;0.6;0.0;0.0
42;2021-01-18;952;0;0;4897;21;0;0.7;0.0;0.0
42;2021-01-19;1262;10;0;6159;31;0;0.9;0.0;0.0
42;2021-01-20;938;4;0;7097;35;0;1.1;0.0;0.0
42;2021-01-21;992;3;0;8089;38;0;1.2;0.0;0.0
42;2021-01-22;962;6;0;9051;44;0;1.4;0.0;0.0
42;2021-01-23;400;0;0;9451;44;0;1.4;0.0;0.0
42;2021-01-24;346;0;0;9797;44;0;1.5;0.0;0.0
42;2021-01-25;1090;11;0;10887;55;0;1.7;0.0;0.0
42;2021-01-26;1666;18;0;12553;73;0;1.9;0.0;0.0
42;2021-01-27;1410;118;0;13963;191;0;2.1;0.0;0.0
42;2021-01-28;1615;138;0;15578;329;0;2.4;0.1;0.0
42;2021-01-29;929;107;0;16507;436;0;2.5;0.1;0.0
42;2021-01-30;259;108;0;16766;544;0;2.6;0.1;0.0
42;2021-01-31;247;2;0;17013;546;0;2.6;0.1;0.0
42;2021-02-01;709;65;0;17722;611;0;2.7;0.1;0.0
42;2021-02-02;1809;307;0;19531;918;0;3.0;0.1;0.0
42;2021-02-03;1456;470;0;20987;1388;0;3.2;0.2;0.0
42;2021-02-04;1240;595;0;22227;1983;0;3.4;0.3;0.0
42;2021-02-05;694;491;0;22921;2474;0;3.5;0.4;0.0
42;2021-02-06;303;133;0;23224;2607;0;3.5;0.4;0.0
42;2021-02-07;251;143;0;23475;2750;0;3.6;0.4;0.0
42;2021-02-08;511;591;0;23986;3341;0;3.7;0.5;0.0
42;2021-02-09;710;792;0;24696;4133;0;3.8;0.6;0.0
42;2021-02-10;739;683;0;25435;4816;0;3.9;0.7;0.0
42;2021-02-11;754;713;0;26189;5529;0;4.0;0.8;0.0
42;2021-02-12;680;744;0;26869;6273;0;4.1;1.0;0.0
42;2021-02-13;310;258;0;27179;6531;0;4.1;1.0;0.0
42;2021-02-14;178;207;0;27357;6738;0;4.2;1.0;0.0
42;2021-02-15;516;792;0;27873;7530;0;4.2;1.1;0.0
42;2021-02-16;493;1153;0;28366;8683;0;4.3;1.3;0.0
42;2021-02-17;535;1472;0;28901;10155;0;4.4;1.5;0.0
42;2021-02-18;748;1331;0;29649;11486;0;4.5;1.8;0.0
42;2021-02-19;751;951;0;30400;12437;0;4.6;1.9;0.0
42;2021-02-20;228;411;0;30628;12848;0;4.7;2.0;0.0
42;2021-02-21;61;317;0;30689;13165;0;4.7;2.0;0.0
42;2021-02-22;535;906;0;31224;14071;0;4.8;2.1;0.0
42;2021-02-23;1158;1395;0;32382;15466;0;4.9;2.4;0.0
42;2021-02-24;1200;1209;0;33582;16675;0;5.1;2.5;0.0
42;2021-02-25;1583;1337;0;35165;18012;0;5.4;2.7;0.0
42;2021-02-26;1575;940;0;36740;18952;0;5.6;2.9;0.0
42;2021-02-27;520;270;0;37260;19222;0;5.7;2.9;0.0
42;2021-02-28;159;120;0;37419;19342;0;5.7;2.9;0.0
42;2021-03-01;785;808;0;38204;20150;0;5.8;3.1;0.0
42;2021-03-02;1254;812;0;39458;20962;0;6.0;3.2;0.0
42;2021-03-03;1396;822;0;40854;21784;0;6.2;3.3;0.0
42;2021-03-04;1686;742;0;42540;22526;0;6.5;3.4;0.0
42;2021-03-05;2498;673;0;45038;23199;0;6.9;3.5;0.0
42;2021-03-06;1810;282;0;46848;23481;0;7.1;3.6;0.0
42;2021-03-07;1358;95;0;48206;23576;0;7.3;3.6;0.0
42;2021-03-08;1350;530;0;49556;24106;0;7.6;3.7;0.0
42;2021-03-09;1965;481;0;51521;24587;0;7.9;3.7;0.0
42;2021-03-10;2072;541;0;53593;25128;0;8.2;3.8;0.0
42;2021-03-11;2975;646;0;56568;25774;0;8.6;3.9;0.0
42;2021-03-12;3005;833;0;59573;26607;0;9.1;4.1;0.0
42;2021-03-13;1493;350;0;61066;26957;0;9.3;4.1;0.0
42;2021-03-14;454;170;0;61520;27127;0;9.4;4.1;0.0
42;2021-03-15;1592;587;0;63112;27714;0;9.6;4.2;0.0
42;2021-03-16;1459;778;0;64571;28492;0;9.8;4.3;0.0
42;2021-03-17;1682;1021;0;66253;29513;0;10.1;4.5;0.0
42;2021-03-18;1788;978;0;68041;30491;0;10.4;4.6;0.0
42;2021-03-19;2547;689;0;70588;31180;0;10.8;4.8;0.0
42;2021-03-20;1581;230;0;72169;31410;0;11.0;4.8;0.0
42;2021-03-21;496;99;0;72665;31509;0;11.1;4.8;0.0
42;2021-03-22;1457;743;0;74122;32252;0;11.3;4.9;0.0
42;2021-03-23;2488;869;0;76610;33121;0;11.7;5.0;0.0
42;2021-03-24;2756;797;0;79366;33918;0;12.1;5.2;0.0
42;2021-03-25;3732;940;0;83098;34858;0;12.7;5.3;0.0
42;2021-03-26;3774;791;0;86872;35649;0;13.2;5.4;0.0
42;2021-03-27;1819;430;0;88691;36079;0;13.5;5.5;0.0
42;2021-03-28;998;204;0;89689;36283;0;13.7;5.5;0.0
42;2021-03-29;2093;921;0;91782;37204;0;14.0;5.7;0.0
42;2021-03-30;3188;870;0;94970;38074;0;14.5;5.8;0.0
42;2021-03-31;2497;1098;0;97467;39172;0;14.9;6.0;0.0
42;2021-04-01;3386;1050;0;100853;40222;0;15.4;6.1;0.0
42;2021-04-02;2862;1196;0;103715;41418;0;15.8;6.3;0.0
42;2021-04-03;1369;586;0;105084;42004;0;16.0;6.4;0.0
42;2021-04-04;1341;366;0;106425;42370;0;16.2;6.5;0.0
42;2021-04-05;1847;286;0;108272;42656;0;16.5;6.5;0.0
42;2021-04-06;2236;1414;0;110508;44070;0;16.8;6.7;0.0
42;2021-04-07;2692;1832;0;113200;45902;0;17.3;7.0;0.0
42;2021-04-08;3991;1587;0;117191;47489;0;17.9;7.2;0.0
42;2021-04-09;5047;1528;0;122238;49017;0;18.6;7.5;0.0
42;2021-04-10;2566;762;0;124804;49779;0;19.0;7.6;0.0
42;2021-04-11;1844;412;0;126648;50191;0;19.3;7.7;0.0
42;2021-04-12;3571;1546;0;130219;51737;0;19.9;7.9;0.0
42;2021-04-13;4427;1799;0;134646;53536;0;20.5;8.2;0.0
42;2021-04-14;4097;1880;0;138743;55416;0;21.2;8.4;0.0
42;2021-04-15;4616;1824;0;143359;57240;0;21.9;8.7;0.0
42;2021-04-16;4370;1874;0;147729;59114;0;22.5;9.0;0.0
42;2021-04-17;2778;1024;0;150507;60138;0;22.9;9.2;0.0
42;2021-04-18;1619;395;0;152126;60533;0;23.2;9.2;0.0
42;2021-04-19;2830;1521;0;154956;62054;0;23.6;9.5;0.0
42;2021-04-20;3284;1944;0;158240;63998;0;24.1;9.8;0.0
42;2021-04-21;3280;1778;0;161520;65776;0;24.6;10.0;0.0
42;2021-04-22;3521;1933;0;165041;67709;0;25.2;10.3;0.0
42;2021-04-23;3544;2026;0;168585;69735;0;25.7;10.6;0.0
42;2021-04-24;2123;1495;0;170708;71230;0;26.0;10.9;0.0
42;2021-04-25;1372;895;0;172080;72125;0;26.2;11.0;0.0
42;2021-04-26;2956;1733;0;175036;73858;0;26.7;11.3;0.0
42;2021-04-27;2994;2248;0;178030;76106;0;27.1;11.6;0.0
42;2021-04-28;3189;2591;0;181219;78697;0;27.6;12.0;0.0
42;2021-04-29;3598;2747;0;184817;81444;0;28.2;12.4;0.0
42;2021-04-30;3164;2995;0;187981;84439;0;28.7;12.9;0.0
42;2021-05-01;2587;1003;0;190568;85442;0;29.1;13.0;0.0
42;2021-05-02;1728;1218;0;192296;86660;0;29.3;13.2;0.0
42;2021-05-03;2723;2715;0;195019;89375;0;29.7;13.6;0.0
42;2021-05-04;3274;3080;0;198293;92455;0;30.2;14.1;0.0
42;2021-05-05;3178;3263;0;201471;95718;0;30.7;14.6;0.0
42;2021-05-06;3708;3669;0;205179;99387;0;31.3;15.2;0.0
42;2021-05-07;3506;3916;0;208685;103303;0;31.8;15.7;0.0
42;2021-05-08;2799;1005;0;211484;104308;0;32.2;15.9;0.0
42;2021-05-09;1435;2012;0;212919;106320;0;32.5;16.2;0.0
42;2021-05-10;3041;3681;0;215960;110001;0;32.9;16.8;0.0
42;2021-05-11;4964;3738;0;220924;113739;0;33.7;17.3;0.0
42;2021-05-12;4710;3418;0;225634;117157;0;34.4;17.9;0.0
42;2021-05-13;4911;1117;0;230545;118274;0;35.1;18.0;0.0
42;2021-05-14;4750;2770;0;235295;121044;0;35.9;18.5;0.0
42;2021-05-15;4273;1954;0;239568;122998;0;36.5;18.8;0.0
42;2021-05-16;2462;943;0;242030;123941;0;36.9;18.9;0.0
42;2021-05-17;5302;2706;0;247332;126647;0;37.7;19.3;0.0
42;2021-05-18;5606;2863;0;252938;129510;0;38.6;19.7;0.0
42;2021-05-19;5685;2616;0;258623;132126;0;39.4;20.1;0.0
42;2021-05-20;6079;2778;0;264702;134904;0;40.4;20.6;0.0
42;2021-05-21;5350;3070;0;270052;137974;0;41.2;21.0;0.0
42;2021-05-22;4322;1955;0;274374;139929;0;41.8;21.3;0.0
42;2021-05-23;2191;762;0;276565;140691;0;42.2;21.4;0.0
42;2021-05-24;3862;1227;0;280427;141918;0;42.8;21.6;0.0
42;2021-05-25;4329;3677;0;284756;145595;0;43.4;22.2;0.0
42;2021-05-26;4381;3198;0;289137;148793;0;44.1;22.7;0.0
42;2021-05-27;4647;3426;0;293784;152219;0;44.8;23.2;0.0
42;2021-05-28;4367;3947;0;298151;156166;0;45.5;23.8;0.0
42;2021-05-29;3325;2653;0;301476;158819;0;46.0;24.2;0.0
42;2021-05-30;1525;1066;0;303001;159885;0;46.2;24.4;0.0
42;2021-05-31;3653;3139;0;306654;163024;0;46.8;24.9;0.0
42;2021-06-01;4170;3385;0;310824;166409;0;47.4;25.4;0.0
42;2021-06-02;3910;2805;0;314734;169214;0;48.0;25.8;0.0
42;2021-06-03;4397;3634;0;319131;172848;0;48.7;26.4;0.0
42;2021-06-04;4347;3925;0;323478;176773;0;49.3;27.0;0.0
42;2021-06-05;2947;2152;0;326425;178925;0;49.8;27.3;0.0
42;2021-06-06;1206;1100;0;327631;180025;0;50.0;27.4;0.0
42;2021-06-07;3592;3061;0;331223;183086;0;50.5;27.9;0.0
42;2021-06-08;3200;3079;0;334423;186165;0;51.0;28.4;0.0
42;2021-06-09;2856;3005;0;337279;189170;0;51.4;28.8;0.0
42;2021-06-10;3106;2848;0;340385;192018;0;51.9;29.3;0.0
42;2021-06-11;3422;3845;0;343807;195863;0;52.4;29.9;0.0
42;2021-06-12;2507;2629;0;346314;198492;0;52.8;30.3;0.0
42;2021-06-13;884;1155;0;347198;199647;0;52.9;30.4;0.0
42;2021-06-14;2257;3828;0;349455;203475;0;53.3;31.0;0.0
42;2021-06-15;2688;3903;0;352143;207378;0;53.7;31.6;0.0
42;2021-06-16;2817;3379;0;354960;210757;0;54.1;32.1;0.0
42;2021-06-17;2527;3640;0;357487;214397;0;54.5;32.7;0.0
42;2021-06-18;3056;4865;0;360543;219262;0;55.0;33.4;0.0
42;2021-06-19;2505;3711;0;363048;222973;0;55.4;34.0;0.0
42;2021-06-20;809;1667;0;363857;224640;0;55.5;34.2;0.0
42;2021-06-21;1845;5685;0;365702;230325;0;55.8;35.1;0.0
42;2021-06-22;1809;5489;0;367511;235814;0;56.0;36.0;0.0
42;2021-06-23;1815;4954;0;369326;240768;0;56.3;36.7;0.0
42;2021-06-24;1803;4386;0;371129;245154;0;56.6;37.4;0.0
42;2021-06-25;1962;6395;0;373091;251549;0;56.9;38.4;0.0
42;2021-06-26;1294;5047;0;374385;256596;0;57.1;39.1;0.0
42;2021-06-27;689;2500;0;375074;259096;0;57.2;39.5;0.0
42;2021-06-28;1672;6298;0;376746;265394;0;57.4;40.5;0.0
42;2021-06-29;1470;5920;0;378216;271314;0;57.7;41.4;0.0
42;2021-06-30;1850;5170;0;380066;276484;0;57.9;42.2;0.0
42;2021-07-01;1878;4717;0;381944;281201;0;58.2;42.9;0.0
42;2021-07-02;2197;6090;0;384141;287291;0;58.6;43.8;0.0
42;2021-07-03;1579;4825;0;385720;292116;0;58.8;44.5;0.0
42;2021-07-04;812;2084;0;386532;294200;0;58.9;44.9;0.0
42;2021-07-05;1740;5574;0;388272;299774;0;59.2;45.7;0.0
42;2021-07-06;2026;5053;0;390298;304827;0;59.5;46.5;0.0
42;2021-07-07;2295;4272;0;392593;309099;0;59.9;47.1;0.0
42;2021-07-08;2245;3739;0;394838;312838;0;60.2;47.7;0.0
42;2021-07-09;2411;5599;0;397249;318437;0;60.6;48.5;0.0
42;2021-07-10;1545;4685;0;398794;323122;0;60.8;49.3;0.0
42;2021-07-11;875;1932;0;399669;325054;0;60.9;49.6;0.0
42;2021-07-12;1705;5651;0;401374;330705;0;61.2;50.4;0.0
42;2021-07-13;3376;5878;0;404750;336583;0;61.7;51.3;0.0
42;2021-07-14;3785;1825;0;408535;338408;0;62.3;51.6;0.0
42;2021-07-15;4343;5410;0;412878;343818;0;62.9;52.4;0.0
42;2021-07-16;4174;5836;0;417052;349654;0;63.6;53.3;0.0
42;2021-07-17;2998;4168;0;420050;353822;0;64.0;53.9;0.0
42;2021-07-18;1749;1659;0;421799;355481;0;64.3;54.2;0.0
42;2021-07-19;3430;4810;0;425229;360291;0;64.8;54.9;0.0
42;2021-07-20;4326;4679;0;429555;364970;0;65.5;55.6;0.0
42;2021-07-21;4670;4413;0;434225;369383;0;66.2;56.3;0.0
42;2021-07-22;5108;3864;0;439333;373247;0;67.0;56.9;0.0
42;2021-07-23;5019;4943;0;444352;378190;0;67.7;57.7;0.0
42;2021-07-24;3475;3532;0;447827;381722;0;68.3;58.2;0.0
42;2021-07-25;1443;1267;0;449270;382989;0;68.5;58.4;0.0
42;2021-07-26;4330;4101;0;453600;387090;0;69.2;59.0;0.0
42;2021-07-27;5032;3868;0;458632;390958;0;69.9;59.6;0.0
42;2021-07-28;5259;3535;0;463891;394493;0;70.7;60.1;0.0
42;2021-07-29;5290;3320;0;469181;397813;0;71.5;60.7;0.0
42;2021-07-30;4771;3690;0;473952;401503;0;72.3;61.2;0.0
42;2021-07-31;4136;2845;0;478088;404348;0;72.9;61.6;0.0
42;2021-08-01;2267;1209;0;480355;405557;0;73.2;61.8;0.0
42;2021-08-02;4139;2938;0;484494;408495;0;73.9;62.3;0.0
42;2021-08-03;3704;3149;0;488198;411644;0;74.4;62.8;0.0
42;2021-08-04;3447;3062;0;491645;414706;0;75.0;63.2;0.0
42;2021-08-05;3343;3172;0;494988;417878;0;75.5;63.7;0.0
42;2021-08-06;3600;3872;0;498588;421750;0;76.0;64.3;0.0
42;2021-08-07;2706;2777;0;501294;424527;0;76.4;64.7;0.0
42;2021-08-08;1085;1609;0;502379;426136;0;76.6;65.0;0.0
42;2021-08-09;2753;3711;0;505132;429847;0;77.0;65.5;0.0
42;2021-08-10;3045;3591;0;508177;433438;0;77.5;66.1;0.0
42;2021-08-11;2514;3348;0;510691;436786;0;77.9;66.6;0.0
42;2021-08-12;2398;3435;0;513089;440221;0;78.2;67.1;0.0
42;2021-08-13;2283;3693;0;515372;443914;0;78.6;67.7;0.0
42;2021-08-14;1517;2908;0;516889;446822;0;78.8;68.1;0.0
42;2021-08-15;576;943;0;517465;447765;0;78.9;68.3;0.0
42;2021-08-16;2005;4254;0;519470;452019;0;79.2;68.9;0.0
42;2021-08-17;2166;4075;0;521636;456094;0;79.5;69.5;0.0
42;2021-08-18;1909;4029;0;523545;460123;0;79.8;70.2;0.0
42;2021-08-19;1820;3303;0;525365;463426;0;80.1;70.7;0.0
42;2021-08-20;2113;4362;0;527478;467788;0;80.4;71.3;0.0
42;2021-08-21;1013;3423;0;528491;471211;0;80.6;71.8;0.0
42;2021-08-22;434;1769;0;528925;472980;0;80.6;72.1;0.0
42;2021-08-23;1525;4410;0;530450;477390;0;80.9;72.8;0.0
42;2021-08-24;1674;3940;0;532124;481330;0;81.1;73.4;0.0
42;2021-08-25;1652;3782;0;533776;485112;0;81.4;74.0;0.0
42;2021-08-26;1397;3105;0;535173;488217;0;81.6;74.4;0.0
42;2021-08-27;1688;4375;0;536861;492592;0;81.8;75.1;0.0
42;2021-08-28;1168;3275;0;538029;495867;0;82.0;75.6;0.0
42;2021-08-29;339;1331;0;538368;497198;0;82.1;75.8;0.0
42;2021-08-30;1241;3289;90;539609;500487;90;82.3;76.3;0.0
42;2021-08-31;1206;2685;145;540815;503172;235;82.5;76.7;0.0
42;2021-09-01;1357;2724;216;542172;505896;451;82.7;77.1;0.1
42;2021-09-02;1348;2591;331;543520;508487;782;82.9;77.5;0.1
42;2021-09-03;1524;2929;357;545044;511416;1139;83.1;78.0;0.2
42;2021-09-04;995;2559;182;546039;513975;1321;83.2;78.4;0.2
42;2021-09-05;329;701;136;546368;514676;1457;83.3;78.5;0.2
42;2021-09-06;770;1777;387;547138;516453;1844;83.4;78.7;0.3
42;2021-09-07;837;1640;382;547975;518093;2226;83.5;79.0;0.3
42;2021-09-08;856;1850;332;548831;519943;2558;83.7;79.3;0.4
42;2021-09-09;637;1430;349;549468;521373;2907;83.8;79.5;0.4
42;2021-09-10;915;1936;352;550383;523309;3259;83.9;79.8;0.5
42;2021-09-11;683;2142;117;551066;525451;3376;84.0;80.1;0.5
42;2021-09-12;143;446;36;551209;525897;3412;84.0;80.2;0.5
42;2021-09-13;555;1116;584;551764;527013;3996;84.1;80.3;0.6
42;2021-09-14;763;1284;772;552527;528297;4768;84.2;80.5;0.7
42;2021-09-15;716;1557;598;553243;529854;5366;84.3;80.8;0.8
42;2021-09-16;526;871;738;553769;530725;6104;84.4;80.9;0.9
42;2021-09-17;702;1587;668;554471;532312;6772;84.5;81.2;1.0
42;2021-09-18;540;1699;147;555011;534011;6919;84.6;81.4;1.1
42;2021-09-19;88;345;38;555099;534356;6957;84.6;81.5;1.1
42;2021-09-20;406;850;716;555505;535206;7673;84.7;81.6;1.2
42;2021-09-21;343;806;778;555848;536012;8451;84.7;81.7;1.3
42;2021-09-22;482;1354;773;556330;537366;9224;84.8;81.9;1.4
42;2021-09-23;377;814;743;556707;538180;9967;84.9;82.1;1.5
42;2021-09-24;472;1496;610;557179;539676;10577;84.9;82.3;1.6
42;2021-09-25;350;1167;208;557529;540843;10785;85.0;82.5;1.6
42;2021-09-26;58;260;17;557587;541103;10802;85.0;82.5;1.6
42;2021-09-27;297;795;666;557884;541898;11468;85.1;82.6;1.7
42;2021-09-28;370;719;729;558254;542617;12197;85.1;82.7;1.9
42;2021-09-29;394;952;587;558648;543569;12784;85.2;82.9;1.9
42;2021-09-30;330;636;544;558978;544205;13328;85.2;83.0;2.0
42;2021-10-01;541;989;688;559519;545194;14016;85.3;83.1;2.1
42;2021-10-02;369;750;187;559888;545944;14203;85.4;83.2;2.2
42;2021-10-03;81;157;14;559969;546101;14217;85.4;83.3;2.2
42;2021-10-04;272;525;880;560241;546626;15097;85.4;83.3;2.3
42;2021-10-05;290;524;628;560531;547150;15725;85.5;83.4;2.4
42;2021-10-06;436;839;901;560967;547989;16626;85.5;83.5;2.5
42;2021-10-07;304;554;766;561271;548543;17392;85.6;83.6;2.7
42;2021-10-08;440;844;768;561711;549387;18160;85.6;83.8;2.8
42;2021-10-09;364;632;393;562075;550019;18553;85.7;83.9;2.8
42;2021-10-10;69;105;91;562144;550124;18644;85.7;83.9;2.8
42;2021-10-11;253;454;846;562397;550578;19490;85.7;83.9;3.0
42;2021-10-12;230;426;659;562627;551004;20149;85.8;84.0;3.1
42;2021-10-13;442;643;976;563069;551647;21125;85.8;84.1;3.2
42;2021-10-14;300;399;892;563369;552046;22017;85.9;84.2;3.4
42;2021-10-15;412;583;1072;563781;552629;23089;86.0;84.3;3.5
42;2021-10-16;302;444;435;564083;553073;23524;86.0;84.3;3.6
42;2021-10-17;64;96;82;564147;553169;23606;86.0;84.3;3.6
42;2021-10-18;226;457;921;564373;553626;24527;86.0;84.4;3.7
42;2021-10-19;153;336;924;564526;553962;25451;86.1;84.5;3.9
42;2021-10-20;203;461;1100;564729;554423;26551;86.1;84.5;4.0
42;2021-10-21;138;326;874;564867;554749;27425;86.1;84.6;4.2
42;2021-10-22;177;416;1090;565044;555165;28515;86.1;84.6;4.3
42;2021-10-23;180;375;520;565224;555540;29035;86.2;84.7;4.4
42;2021-10-24;31;72;103;565255;555612;29138;86.2;84.7;4.4
42;2021-10-25;159;328;1028;565414;555940;30166;86.2;84.8;4.6
42;2021-10-26;118;239;949;565532;556179;31115;86.2;84.8;4.7
42;2021-10-27;200;433;1496;565732;556612;32611;86.3;84.9;5.0
42;2021-10-28;152;224;936;565884;556836;33547;86.3;84.9;5.1
42;2021-10-29;188;373;1534;566072;557209;35081;86.3;85.0;5.3
42;2021-10-30;107;323;572;566179;557532;35653;86.3;85.0;5.4
42;2021-10-31;30;91;123;566209;557623;35776;86.3;85.0;5.5
42;2021-11-01;34;29;37;566243;557652;35813;86.3;85.0;5.5
42;2021-11-02;140;271;1127;566383;557923;36940;86.4;85.1;5.6
42;2021-11-03;192;435;1871;566575;558358;38811;86.4;85.1;5.9
42;2021-11-04;117;230;1322;566692;558588;40133;86.4;85.2;6.1
42;2021-11-05;167;327;1893;566859;558915;42026;86.4;85.2;6.4
42;2021-11-06;135;271;553;566994;559186;42579;86.4;85.3;6.5
42;2021-11-07;27;68;142;567021;559254;42721;86.4;85.3;6.5
42;2021-11-08;89;223;1939;567110;559477;44660;86.5;85.3;6.8
42;2021-11-09;107;202;1968;567217;559679;46628;86.5;85.3;7.1
42;2021-11-10;216;257;2406;567433;559936;49034;86.5;85.4;7.5
42;2021-11-11;32;27;150;567465;559963;49184;86.5;85.4;7.5
42;2021-11-12;153;272;2486;567618;560235;51670;86.5;85.4;7.9
42;2021-11-13;141;175;1039;567759;560410;52709;86.6;85.4;8.0
42;2021-11-14;45;28;413;567804;560438;53122;86.6;85.4;8.1
42;2021-11-15;97;182;2489;567901;560620;55611;86.6;85.5;8.5
42;2021-11-16;80;140;2401;567981;560760;58012;86.6;85.5;8.8
42;2021-11-17;210;274;2764;568191;561034;60776;86.6;85.5;9.3
42;2021-11-18;125;172;2440;568316;561206;63216;86.6;85.6;9.6
42;2021-11-19;145;200;2709;568461;561406;65925;86.7;85.6;10.1
42;2021-11-20;239;247;1605;568700;561653;67530;86.7;85.6;10.3
42;2021-11-21;12;23;134;568712;561676;67664;86.7;85.6;10.3
42;2021-11-22;131;121;2878;568843;561797;70542;86.7;85.7;10.8
42;2021-11-23;103;130;2730;568946;561927;73272;86.7;85.7;11.2
42;2021-11-24;227;253;3305;569173;562180;76577;86.8;85.7;11.7
42;2021-11-25;124;132;3030;569297;562312;79607;86.8;85.7;12.1
42;2021-11-26;137;234;4079;569434;562546;83686;86.8;85.8;12.8
42;2021-11-27;181;211;2708;569615;562757;86394;86.8;85.8;13.2
42;2021-11-28;17;28;461;569632;562785;86855;86.8;85.8;13.2
42;2021-11-29;96;133;4697;569728;562918;91552;86.9;85.8;14.0
42;2021-11-30;104;139;4754;569832;563057;96306;86.9;85.8;14.7
42;2021-12-01;102;202;5499;569934;563259;101805;86.9;85.9;15.5
42;2021-12-02;89;119;6172;570023;563378;107977;86.9;85.9;16.5
42;2021-12-03;127;161;6856;570150;563539;114833;86.9;85.9;17.5
42;2021-12-04;99;207;3738;570249;563746;118571;86.9;85.9;18.1
42;2021-12-05;12;25;594;570261;563771;119165;86.9;86.0;18.2
42;2021-12-06;104;155;5675;570365;563926;124840;87.0;86.0;19.0
42;2021-12-07;98;125;6015;570463;564051;130855;87.0;86.0;20.0
42;2021-12-08;149;228;6766;570612;564279;137621;87.0;86.0;21.0
42;2021-12-09;118;164;7200;570730;564443;144821;87.0;86.1;22.1
42;2021-12-10;157;193;7625;570887;564636;152446;87.0;86.1;23.2
42;2021-12-11;83;215;5097;570970;564851;157543;87.0;86.1;24.0
42;2021-12-12;34;56;2492;571004;564907;160035;87.1;86.1;24.4
42;2021-12-13;138;186;7603;571142;565093;167638;87.1;86.2;25.6
42;2021-12-14;178;180;10218;571320;565273;177856;87.1;86.2;27.1
42;2021-12-15;163;246;9156;571483;565519;187012;87.1;86.2;28.5
42;2021-12-16;144;140;9544;571627;565659;196556;87.1;86.2;30.0
42;2021-12-17;181;186;10160;571808;565845;206716;87.2;86.3;31.5
42;2021-12-18;123;199;6129;571931;566044;212845;87.2;86.3;32.5
42;2021-12-19;34;33;2810;571965;566077;215655;87.2;86.3;32.9
43;2020-12-27;0;0;0;0;0;0;0.0;0.0;0.0
43;2020-12-28;0;0;0;0;0;0;0.0;0.0;0.0
43;2020-12-29;0;0;0;0;0;0;0.0;0.0;0.0
43;2020-12-30;0;0;0;0;0;0;0.0;0.0;0.0
43;2020-12-31;0;0;0;0;0;0;0.0;0.0;0.0
43;2021-01-01;3;0;0;3;0;0;0.0;0.0;0.0
43;2021-01-02;0;0;0;3;0;0;0.0;0.0;0.0
43;2021-01-03;0;0;0;3;0;0;0.0;0.0;0.0
43;2021-01-04;2;0;0;5;0;0;0.0;0.0;0.0
43;2021-01-05;0;0;0;5;0;0;0.0;0.0;0.0
43;2021-01-06;8;0;0;13;0;0;0.0;0.0;0.0
43;2021-01-07;163;0;0;176;0;0;0.1;0.0;0.0
43;2021-01-08;148;1;0;324;1;0;0.2;0.0;0.0
43;2021-01-09;6;0;0;330;1;0;0.2;0.0;0.0
43;2021-01-10;2;0;0;332;1;0;0.2;0.0;0.0
43;2021-01-11;144;0;0;476;1;0;0.2;0.0;0.0
43;2021-01-12;258;2;0;734;3;0;0.4;0.0;0.0
43;2021-01-13;259;2;0;993;5;0;0.5;0.0;0.0
43;2021-01-14;312;1;0;1305;6;0;0.7;0.0;0.0
43;2021-01-15;312;2;0;1617;8;0;0.8;0.0;0.0
43;2021-01-16;41;0;0;1658;8;0;0.8;0.0;0.0
43;2021-01-17;5;0;0;1663;8;0;0.8;0.0;0.0
43;2021-01-18;737;7;0;2400;15;0;1.2;0.0;0.0
43;2021-01-19;781;4;0;3181;19;0;1.6;0.0;0.0
43;2021-01-20;548;2;0;3729;21;0;1.9;0.0;0.0
43;2021-01-21;491;2;0;4220;23;0;2.1;0.0;0.0
43;2021-01-22;480;7;0;4700;30;0;2.4;0.0;0.0
43;2021-01-23;6;0;0;4706;30;0;2.4;0.0;0.0
43;2021-01-24;9;0;0;4715;30;0;2.4;0.0;0.0
43;2021-01-25;533;0;0;5248;30;0;2.6;0.0;0.0
43;2021-01-26;585;7;0;5833;37;0;2.9;0.0;0.0
43;2021-01-27;712;5;0;6545;42;0;3.3;0.0;0.0
43;2021-01-28;729;34;0;7274;76;0;3.7;0.0;0.0
43;2021-01-29;688;82;0;7962;158;0;4.0;0.1;0.0
43;2021-01-30;111;1;0;8073;159;0;4.1;0.1;0.0
43;2021-01-31;7;0;0;8080;159;0;4.1;0.1;0.0
43;2021-02-01;391;101;0;8471;260;0;4.3;0.1;0.0
43;2021-02-02;689;158;0;9160;418;0;4.6;0.2;0.0
43;2021-02-03;692;67;0;9852;485;0;5.0;0.2;0.0
43;2021-02-04;538;189;0;10390;674;0;5.2;0.3;0.0
43;2021-02-05;539;184;0;10929;858;0;5.5;0.4;0.0
43;2021-02-06;166;32;0;11095;890;0;5.6;0.4;0.0
43;2021-02-07;7;7;0;11102;897;0;5.6;0.5;0.0
43;2021-02-08;397;303;0;11499;1200;0;5.8;0.6;0.0
43;2021-02-09;346;442;0;11845;1642;0;6.0;0.8;0.0
43;2021-02-10;393;360;0;12238;2002;0;6.2;1.0;0.0
43;2021-02-11;364;374;0;12602;2376;0;6.3;1.2;0.0
43;2021-02-12;423;222;0;13025;2598;0;6.6;1.3;0.0
43;2021-02-13;640;62;0;13665;2660;0;6.9;1.3;0.0
43;2021-02-14;5;12;0;13670;2672;0;6.9;1.3;0.0
43;2021-02-15;62;474;0;13732;3146;0;6.9;1.6;0.0
43;2021-02-16;46;386;0;13778;3532;0;6.9;1.8;0.0
43;2021-02-17;84;497;0;13862;4029;0;7.0;2.0;0.0
43;2021-02-18;158;413;0;14020;4442;0;7.1;2.2;0.0
43;2021-02-19;273;488;0;14293;4930;0;7.2;2.5;0.0
43;2021-02-20;29;17;0;14322;4947;0;7.2;2.5;0.0
43;2021-02-21;0;7;0;14322;4954;0;7.2;2.5;0.0
43;2021-02-22;36;501;0;14358;5455;0;7.2;2.7;0.0
43;2021-02-23;226;753;0;14584;6208;0;7.3;3.1;0.0
43;2021-02-24;164;703;0;14748;6911;0;7.4;3.5;0.0
43;2021-02-25;267;701;0;15015;7612;0;7.6;3.8;0.0
43;2021-02-26;260;669;0;15275;8281;0;7.7;4.2;0.0
43;2021-02-27;144;77;0;15419;8358;0;7.8;4.2;0.0
43;2021-02-28;8;5;0;15427;8363;0;7.8;4.2;0.0
43;2021-03-01;230;471;0;15657;8834;0;7.9;4.4;0.0
43;2021-03-02;364;563;0;16021;9397;0;8.1;4.7;0.0
43;2021-03-03;344;559;0;16365;9956;0;8.2;5.0;0.0
43;2021-03-04;536;455;0;16901;10411;0;8.5;5.2;0.0
43;2021-03-05;596;464;0;17497;10875;0;8.8;5.5;0.0
43;2021-03-06;517;180;0;18014;11055;0;9.1;5.6;0.0
43;2021-03-07;59;2;0;18073;11057;0;9.1;5.6;0.0
43;2021-03-08;489;428;0;18562;11485;0;9.3;5.8;0.0
43;2021-03-09;638;347;0;19200;11832;0;9.7;6.0;0.0
43;2021-03-10;658;477;0;19858;12309;0;10.0;6.2;0.0
43;2021-03-11;928;435;0;20786;12744;0;10.5;6.4;0.0
43;2021-03-12;907;424;0;21693;13168;0;10.9;6.6;0.0
43;2021-03-13;698;126;0;22391;13294;0;11.3;6.7;0.0
43;2021-03-14;10;5;0;22401;13299;0;11.3;6.7;0.0
43;2021-03-15;704;146;0;23105;13445;0;11.6;6.8;0.0
43;2021-03-16;817;273;0;23922;13718;0;12.0;6.9;0.0
43;2021-03-17;634;158;0;24556;13876;0;12.4;7.0;0.0
43;2021-03-18;697;164;0;25253;14040;0;12.7;7.1;0.0
43;2021-03-19;849;131;0;26102;14171;0;13.1;7.1;0.0
43;2021-03-20;430;53;0;26532;14224;0;13.3;7.2;0.0
43;2021-03-21;8;1;0;26540;14225;0;13.4;7.2;0.0
43;2021-03-22;683;50;0;27223;14275;0;13.7;7.2;0.0
43;2021-03-23;869;53;0;28092;14328;0;14.1;7.2;0.0
43;2021-03-24;1169;115;0;29261;14443;0;14.7;7.3;0.0
43;2021-03-25;1519;174;0;30780;14617;0;15.5;7.4;0.0
43;2021-03-26;1568;208;0;32348;14825;0;16.3;7.5;0.0
43;2021-03-27;1274;85;0;33622;14910;0;16.9;7.5;0.0
43;2021-03-28;409;31;0;34031;14941;0;17.1;7.5;0.0
43;2021-03-29;1033;181;0;35064;15122;0;17.6;7.6;0.0
43;2021-03-30;1255;259;0;36319;15381;0;18.3;7.7;0.0
43;2021-03-31;1213;274;0;37532;15655;0;18.9;7.9;0.0
43;2021-04-01;1284;328;0;38816;15983;0;19.5;8.0;0.0
43;2021-04-02;1010;338;0;39826;16321;0;20.0;8.2;0.0
43;2021-04-03;315;190;0;40141;16511;0;20.2;8.3;0.0
43;2021-04-04;20;6;0;40161;16517;0;20.2;8.3;0.0
43;2021-04-05;46;6;0;40207;16523;0;20.2;8.3;0.0
43;2021-04-06;620;576;0;40827;17099;0;20.5;8.6;0.0
43;2021-04-07;812;562;0;41639;17661;0;20.9;8.9;0.0
43;2021-04-08;990;446;0;42629;18107;0;21.4;9.1;0.0
43;2021-04-09;1121;632;0;43750;18739;0;22.0;9.4;0.0
43;2021-04-10;585;224;0;44335;18963;0;22.3;9.5;0.0
43;2021-04-11;47;6;0;44382;18969;0;22.3;9.5;0.0
43;2021-04-12;706;622;0;45088;19591;0;22.7;9.9;0.0
43;2021-04-13;914;727;0;46002;20318;0;23.1;10.2;0.0
43;2021-04-14;834;665;0;46836;20983;0;23.6;10.6;0.0
43;2021-04-15;1016;703;0;47852;21686;0;24.1;10.9;0.0
43;2021-04-16;1000;708;0;48852;22394;0;24.6;11.3;0.0
43;2021-04-17;423;293;0;49275;22687;0;24.8;11.4;0.0
43;2021-04-18;91;11;0;49366;22698;0;24.8;11.4;0.0
43;2021-04-19;678;562;0;50044;23260;0;25.2;11.7;0.0
43;2021-04-20;822;654;0;50866;23914;0;25.6;12.0;0.0
43;2021-04-21;410;913;0;51276;24827;0;25.8;12.5;0.0
43;2021-04-22;705;963;0;51981;25790;0;26.2;13.0;0.0
43;2021-04-23;513;1056;0;52494;26846;0;26.4;13.5;0.0
43;2021-04-24;390;914;0;52884;27760;0;26.6;14.0;0.0
43;2021-04-25;111;404;0;52995;28164;0;26.7;14.2;0.0
43;2021-04-26;482;918;0;53477;29082;0;26.9;14.6;0.0
43;2021-04-27;872;965;0;54349;30047;0;27.3;15.1;0.0
43;2021-04-28;908;1066;0;55257;31113;0;27.8;15.7;0.0
43;2021-04-29;1222;1062;0;56479;32175;0;28.4;16.2;0.0
43;2021-04-30;1189;1044;0;57668;33219;0;29.0;16.7;0.0
43;2021-05-01;450;52;0;58118;33271;0;29.2;16.7;0.0
43;2021-05-02;85;40;0;58203;33311;0;29.3;16.8;0.0
43;2021-05-03;1279;403;0;59482;33714;0;29.9;17.0;0.0
43;2021-05-04;1276;864;0;60758;34578;0;30.6;17.4;0.0
43;2021-05-05;1209;817;0;61967;35395;0;31.2;17.8;0.0
43;2021-05-06;1443;937;0;63410;36332;0;31.9;18.3;0.0
43;2021-05-07;1122;1152;0;64532;37484;0;32.5;18.9;0.0
43;2021-05-08;573;156;0;65105;37640;0;32.8;18.9;0.0
43;2021-05-09;58;73;0;65163;37713;0;32.8;19.0;0.0
43;2021-05-10;1118;733;0;66281;38446;0;33.3;19.3;0.0
43;2021-05-11;1643;1007;0;67924;39453;0;34.2;19.8;0.0
43;2021-05-12;1544;853;0;69468;40306;0;34.9;20.3;0.0
43;2021-05-13;989;395;0;70457;40701;0;35.4;20.5;0.0
43;2021-05-14;2122;1087;0;72579;41788;0;36.5;21.0;0.0
43;2021-05-15;1175;310;0;73754;42098;0;37.1;21.2;0.0
43;2021-05-16;348;70;0;74102;42168;0;37.3;21.2;0.0
43;2021-05-17;1704;657;0;75806;42825;0;38.1;21.5;0.0
43;2021-05-18;1947;711;0;77753;43536;0;39.1;21.9;0.0
43;2021-05-19;2043;609;0;79796;44145;0;40.1;22.2;0.0
43;2021-05-20;2295;809;0;82091;44954;0;41.3;22.6;0.0
43;2021-05-21;2352;725;0;84443;45679;0;42.5;23.0;0.0
43;2021-05-22;1065;332;0;85508;46011;0;43.0;23.1;0.0
43;2021-05-23;78;31;0;85586;46042;0;43.1;23.2;0.0
43;2021-05-24;441;146;0;86027;46188;0;43.3;23.2;0.0
43;2021-05-25;1368;691;0;87395;46879;0;44.0;23.6;0.0
43;2021-05-26;1366;610;0;88761;47489;0;44.7;23.9;0.0
43;2021-05-27;1387;752;0;90148;48241;0;45.4;24.3;0.0
43;2021-05-28;1368;810;0;91516;49051;0;46.0;24.7;0.0
43;2021-05-29;1105;607;0;92621;49658;0;46.6;25.0;0.0
43;2021-05-30;193;67;0;92814;49725;0;46.7;25.0;0.0
43;2021-05-31;1203;520;0;94017;50245;0;47.3;25.3;0.0
43;2021-06-01;1256;1001;0;95273;51246;0;47.9;25.8;0.0
43;2021-06-02;1100;759;0;96373;52005;0;48.5;26.2;0.0
43;2021-06-03;1244;852;0;97617;52857;0;49.1;26.6;0.0
43;2021-06-04;1378;912;0;98995;53769;0;49.8;27.1;0.0
43;2021-06-05;729;487;0;99724;54256;0;50.2;27.3;0.0
43;2021-06-06;44;53;0;99768;54309;0;50.2;27.3;0.0
43;2021-06-07;826;624;0;100594;54933;0;50.6;27.6;0.0
43;2021-06-08;716;762;0;101310;55695;0;51.0;28.0;0.0
43;2021-06-09;637;824;0;101947;56519;0;51.3;28.4;0.0
43;2021-06-10;876;1105;0;102823;57624;0;51.7;29.0;0.0
43;2021-06-11;833;1362;0;103656;58986;0;52.1;29.7;0.0
43;2021-06-12;820;517;0;104476;59503;0;52.6;29.9;0.0
43;2021-06-13;32;84;0;104508;59587;0;52.6;30.0;0.0
43;2021-06-14;477;1192;0;104985;60779;0;52.8;30.6;0.0
43;2021-06-15;629;1218;0;105614;61997;0;53.1;31.2;0.0
43;2021-06-16;593;1033;0;106207;63030;0;53.4;31.7;0.0
43;2021-06-17;632;1473;0;106839;64503;0;53.7;32.5;0.0
43;2021-06-18;881;1517;0;107720;66020;0;54.2;33.2;0.0
43;2021-06-19;437;808;0;108157;66828;0;54.4;33.6;0.0
43;2021-06-20;29;85;0;108186;66913;0;54.4;33.7;0.0
43;2021-06-21;446;1378;0;108632;68291;0;54.7;34.4;0.0
43;2021-06-22;511;1962;0;109143;70253;0;54.9;35.3;0.0
43;2021-06-23;397;1741;0;109540;71994;0;55.1;36.2;0.0
43;2021-06-24;516;1477;0;110056;73471;0;55.4;37.0;0.0
43;2021-06-25;582;2298;0;110638;75769;0;55.7;38.1;0.0
43;2021-06-26;483;1199;0;111121;76968;0;55.9;38.7;0.0
43;2021-06-27;57;143;0;111178;77111;0;55.9;38.8;0.0
43;2021-06-28;349;1869;0;111527;78980;0;56.1;39.7;0.0
43;2021-06-29;534;2325;0;112061;81305;0;56.4;40.9;0.0
43;2021-06-30;479;2211;0;112540;83516;0;56.6;42.0;0.0
43;2021-07-01;499;1839;0;113039;85355;0;56.9;42.9;0.0
43;2021-07-02;512;1938;0;113551;87293;0;57.1;43.9;0.0
43;2021-07-03;265;1052;0;113816;88345;0;57.3;44.4;0.0
43;2021-07-04;30;60;0;113846;88405;0;57.3;44.5;0.0
43;2021-07-05;531;1272;0;114377;89677;0;57.5;45.1;0.0
43;2021-07-06;617;1636;0;114994;91313;0;57.9;45.9;0.0
43;2021-07-07;577;1417;0;115571;92730;0;58.1;46.7;0.0
43;2021-07-08;778;1412;0;116349;94142;0;58.5;47.4;0.0
43;2021-07-09;586;1543;0;116935;95685;0;58.8;48.1;0.0
43;2021-07-10;359;1278;0;117294;96963;0;59.0;48.8;0.0
43;2021-07-11;54;167;0;117348;97130;0;59.0;48.9;0.0
43;2021-07-12;581;1730;0;117929;98860;0;59.3;49.7;0.0
43;2021-07-13;1171;1858;0;119100;100718;0;59.9;50.7;0.0
43;2021-07-14;951;254;0;120051;100972;0;60.4;50.8;0.0
43;2021-07-15;1796;1833;0;121847;102805;0;61.3;51.7;0.0
43;2021-07-16;1594;1617;0;123441;104422;0;62.1;52.5;0.0
43;2021-07-17;1357;1061;0;124798;105483;0;62.8;53.1;0.0
43;2021-07-18;82;92;0;124880;105575;0;62.8;53.1;0.0
43;2021-07-19;1372;1303;0;126252;106878;0;63.5;53.8;0.0
43;2021-07-20;1752;1397;0;128004;108275;0;64.4;54.5;0.0
43;2021-07-21;1766;1156;0;129770;109431;0;65.3;55.1;0.0
43;2021-07-22;1951;1298;0;131721;110729;0;66.3;55.7;0.0
43;2021-07-23;1528;1295;0;133249;112024;0;67.0;56.4;0.0
43;2021-07-24;580;913;0;133829;112937;0;67.3;56.8;0.0
43;2021-07-25;77;62;0;133906;112999;0;67.4;56.8;0.0
43;2021-07-26;1499;1053;0;135405;114052;0;68.1;57.4;0.0
43;2021-07-27;1966;1105;0;137371;115157;0;69.1;57.9;0.0
43;2021-07-28;1828;1052;0;139199;116209;0;70.0;58.5;0.0
43;2021-07-29;1830;997;0;141029;117206;0;70.9;59.0;0.0
43;2021-07-30;1724;1260;0;142753;118466;0;71.8;59.6;0.0
43;2021-07-31;706;560;0;143459;119026;0;72.2;59.9;0.0
43;2021-08-01;98;57;0;143557;119083;0;72.2;59.9;0.0
43;2021-08-02;1488;932;0;145045;120015;0;73.0;60.4;0.0
43;2021-08-03;1265;1081;0;146310;121096;0;73.6;60.9;0.0
43;2021-08-04;1188;1121;0;147498;122217;0;74.2;61.5;0.0
43;2021-08-05;1137;1238;0;148635;123455;0;74.8;62.1;0.0
43;2021-08-06;1097;1403;0;149732;124858;0;75.3;62.8;0.0
43;2021-08-07;492;720;0;150224;125578;0;75.6;63.2;0.0
43;2021-08-08;42;66;0;150266;125644;0;75.6;63.2;0.0
43;2021-08-09;792;1526;0;151058;127170;0;76.0;64.0;0.0
43;2021-08-10;955;1465;0;152013;128635;0;76.5;64.7;0.0
43;2021-08-11;698;1293;0;152711;129928;0;76.8;65.4;0.0
43;2021-08-12;820;1451;0;153531;131379;0;77.2;66.1;0.0
43;2021-08-13;674;1171;0;154205;132550;0;77.6;66.7;0.0
43;2021-08-14;326;554;0;154531;133104;0;77.7;67.0;0.0
43;2021-08-15;16;49;0;154547;133153;0;77.7;67.0;0.0
43;2021-08-16;667;1595;0;155214;134748;0;78.1;67.8;0.0
43;2021-08-17;653;1413;0;155867;136161;0;78.4;68.5;0.0
43;2021-08-18;536;1438;0;156403;137599;0;78.7;69.2;0.0
43;2021-08-19;602;1463;0;157005;139062;0;79.0;70.0;0.0
43;2021-08-20;521;1522;0;157526;140584;0;79.2;70.7;0.0
43;2021-08-21;211;514;0;157737;141098;0;79.4;71.0;0.0
43;2021-08-22;14;80;0;157751;141178;0;79.4;71.0;0.0
43;2021-08-23;490;1546;0;158241;142724;0;79.6;71.8;0.0
43;2021-08-24;497;1320;0;158738;144044;0;79.9;72.5;0.0
43;2021-08-25;472;1276;0;159210;145320;0;80.1;73.1;0.0
43;2021-08-26;451;1109;0;159661;146429;0;80.3;73.7;0.0
43;2021-08-27;539;1301;0;160200;147730;0;80.6;74.3;0.0
43;2021-08-28;180;491;0;160380;148221;0;80.7;74.6;0.0
43;2021-08-29;6;55;0;160386;148276;0;80.7;74.6;0.0
43;2021-08-30;489;1089;21;160875;149365;21;80.9;75.1;0.0
43;2021-08-31;382;871;52;161257;150236;73;81.1;75.6;0.0
43;2021-09-01;320;930;72;161577;151166;145;81.3;76.0;0.1
43;2021-09-02;352;844;102;161929;152010;247;81.5;76.5;0.1
43;2021-09-03;526;920;102;162455;152930;349;81.7;76.9;0.2
43;2021-09-04;305;495;22;162760;153425;371;81.9;77.2;0.2
43;2021-09-05;54;34;15;162814;153459;386;81.9;77.2;0.2
43;2021-09-06;257;674;80;163071;154133;466;82.0;77.5;0.2
43;2021-09-07;242;585;101;163313;154718;567;82.2;77.8;0.3
43;2021-09-08;252;551;95;163565;155269;662;82.3;78.1;0.3
43;2021-09-09;259;569;149;163824;155838;811;82.4;78.4;0.4
43;2021-09-10;333;615;106;164157;156453;917;82.6;78.7;0.5
43;2021-09-11;252;369;51;164409;156822;968;82.7;78.9;0.5
43;2021-09-12;3;16;0;164412;156838;968;82.7;78.9;0.5
43;2021-09-13;169;387;162;164581;157225;1130;82.8;79.1;0.6
43;2021-09-14;219;353;298;164800;157578;1428;82.9;79.3;0.7
43;2021-09-15;240;501;251;165040;158079;1679;83.0;79.5;0.8
43;2021-09-16;183;329;282;165223;158408;1961;83.1;79.7;1.0
43;2021-09-17;229;526;351;165452;158934;2312;83.2;80.0;1.2
43;2021-09-18;149;335;68;165601;159269;2380;83.3;80.1;1.2
43;2021-09-19;6;9;1;165607;159278;2381;83.3;80.1;1.2
43;2021-09-20;116;322;264;165723;159600;2645;83.4;80.3;1.3
43;2021-09-21;147;328;462;165870;159928;3107;83.4;80.5;1.6
43;2021-09-22;133;423;261;166003;160351;3368;83.5;80.7;1.7
43;2021-09-23;82;298;269;166085;160649;3637;83.6;80.8;1.8
43;2021-09-24;182;524;204;166267;161173;3841;83.6;81.1;1.9
43;2021-09-25;101;291;65;166368;161464;3906;83.7;81.2;2.0
43;2021-09-26;2;19;0;166370;161483;3906;83.7;81.2;2.0
43;2021-09-27;138;338;324;166508;161821;4230;83.8;81.4;2.1
43;2021-09-28;350;200;251;166858;162021;4481;83.9;81.5;2.3
43;2021-09-29;155;292;132;167013;162313;4613;84.0;81.7;2.3
43;2021-09-30;87;187;284;167100;162500;4897;84.1;81.8;2.5
43;2021-10-01;142;322;248;167242;162822;5145;84.1;81.9;2.6
43;2021-10-02;101;234;58;167343;163056;5203;84.2;82.0;2.6
43;2021-10-03;8;18;0;167351;163074;5203;84.2;82.0;2.6
43;2021-10-04;118;204;280;167469;163278;5483;84.3;82.1;2.8
43;2021-10-05;122;181;338;167591;163459;5821;84.3;82.2;2.9
43;2021-10-06;129;258;250;167720;163717;6071;84.4;82.4;3.1
43;2021-10-07;71;140;281;167791;163857;6352;84.4;82.4;3.2
43;2021-10-08;177;319;311;167968;164176;6663;84.5;82.6;3.4
43;2021-10-09;104;202;111;168072;164378;6774;84.6;82.7;3.4
43;2021-10-10;6;7;3;168078;164385;6777;84.6;82.7;3.4
43;2021-10-11;113;154;325;168191;164539;7102;84.6;82.8;3.6
43;2021-10-12;108;180;325;168299;164719;7427;84.7;82.9;3.7
43;2021-10-13;109;121;187;168408;164840;7614;84.7;82.9;3.8
43;2021-10-14;99;152;270;168507;164992;7884;84.8;83.0;4.0
43;2021-10-15;168;204;543;168675;165196;8427;84.9;83.1;4.2
43;2021-10-16;101;135;109;168776;165331;8536;84.9;83.2;4.3
43;2021-10-17;2;7;1;168778;165338;8537;84.9;83.2;4.3
43;2021-10-18;102;160;351;168880;165498;8888;85.0;83.3;4.5
43;2021-10-19;72;330;428;168952;165828;9316;85.0;83.4;4.7
43;2021-10-20;59;160;260;169011;165988;9576;85.0;83.5;4.8
43;2021-10-21;46;104;367;169057;166092;9943;85.0;83.6;5.0
43;2021-10-22;62;132;478;169119;166224;10421;85.1;83.6;5.2
43;2021-10-23;34;110;148;169153;166334;10569;85.1;83.7;5.3
43;2021-10-24;2;4;0;169155;166338;10569;85.1;83.7;5.3
43;2021-10-25;42;90;529;169197;166428;11098;85.1;83.7;5.6
43;2021-10-26;71;107;665;169268;166535;11763;85.2;83.8;5.9
43;2021-10-27;54;112;535;169322;166647;12298;85.2;83.8;6.2
43;2021-10-28;35;65;321;169357;166712;12619;85.2;83.9;6.3
43;2021-10-29;95;172;657;169452;166884;13276;85.2;84.0;6.7
43;2021-10-30;35;97;157;169487;166981;13433;85.3;84.0;6.8
43;2021-10-31;0;4;1;169487;166985;13434;85.3;84.0;6.8
43;2021-11-01;1;2;5;169488;166987;13439;85.3;84.0;6.8
43;2021-11-02;78;133;585;169566;167120;14024;85.3;84.1;7.1
43;2021-11-03;65;140;506;169631;167260;14530;85.3;84.1;7.3
43;2021-11-04;50;80;544;169681;167340;15074;85.4;84.2;7.6
43;2021-11-05;63;109;641;169744;167449;15715;85.4;84.2;7.9
43;2021-11-06;34;80;226;169778;167529;15941;85.4;84.3;8.0
43;2021-11-07;1;2;1;169779;167531;15942;85.4;84.3;8.0
43;2021-11-08;44;122;635;169823;167653;16577;85.4;84.3;8.3
43;2021-11-09;64;72;910;169887;167725;17487;85.5;84.4;8.8
43;2021-11-10;70;93;647;169957;167818;18134;85.5;84.4;9.1
43;2021-11-11;0;2;3;169957;167820;18137;85.5;84.4;9.1
43;2021-11-12;63;93;1025;170020;167913;19162;85.5;84.5;9.6
43;2021-11-13;20;28;322;170040;167941;19484;85.5;84.5;9.8
43;2021-11-14;1;12;14;170041;167953;19498;85.5;84.5;9.8
43;2021-11-15;36;42;714;170077;167995;20212;85.6;84.5;10.2
43;2021-11-16;80;82;1179;170157;168077;21391;85.6;84.6;10.8
43;2021-11-17;68;66;761;170225;168143;22152;85.6;84.6;11.1
43;2021-11-18;38;38;751;170263;168181;22903;85.7;84.6;11.5
43;2021-11-19;67;81;988;170330;168262;23891;85.7;84.6;12.0
43;2021-11-20;45;50;281;170375;168312;24172;85.7;84.7;12.2
43;2021-11-21;2;1;20;170377;168313;24192;85.7;84.7;12.2
43;2021-11-22;60;35;820;170437;168348;25012;85.7;84.7;12.6
43;2021-11-23;65;48;1136;170502;168396;26148;85.8;84.7;13.2
43;2021-11-24;73;78;773;170575;168474;26921;85.8;84.8;13.5
43;2021-11-25;54;44;1117;170629;168518;28038;85.8;84.8;14.1
43;2021-11-26;86;65;1489;170715;168583;29527;85.9;84.8;14.9
43;2021-11-27;48;47;731;170763;168630;30258;85.9;84.8;15.2
43;2021-11-28;3;1;29;170766;168631;30287;85.9;84.8;15.2
43;2021-11-29;47;47;1449;170813;168678;31736;85.9;84.9;16.0
43;2021-11-30;67;62;2103;170880;168740;33839;86.0;84.9;17.0
43;2021-12-01;45;61;1846;170925;168801;35685;86.0;84.9;18.0
43;2021-12-02;44;38;2176;170969;168839;37861;86.0;84.9;19.0
43;2021-12-03;69;67;2117;171038;168906;39978;86.0;85.0;20.1
43;2021-12-04;51;39;1507;171089;168945;41485;86.1;85.0;20.9
43;2021-12-05;3;0;27;171092;168945;41512;86.1;85.0;20.9
43;2021-12-06;41;44;2156;171133;168989;43668;86.1;85.0;22.0
43;2021-12-07;62;50;2408;171195;169039;46076;86.1;85.0;23.2
43;2021-12-08;56;56;1928;171251;169095;48004;86.2;85.1;24.1
43;2021-12-09;72;65;2536;171323;169160;50540;86.2;85.1;25.4
43;2021-12-10;47;72;2403;171370;169232;52943;86.2;85.1;26.6
43;2021-12-11;37;63;1159;171407;169295;54102;86.2;85.2;27.2
43;2021-12-12;2;6;62;171409;169301;54164;86.2;85.2;27.2
43;2021-12-13;47;67;2377;171456;169368;56541;86.3;85.2;28.4
43;2021-12-14;67;73;3009;171523;169441;59550;86.3;85.2;30.0
43;2021-12-15;32;72;2326;171555;169513;61876;86.3;85.3;31.1
43;2021-12-16;57;67;2935;171612;169580;64811;86.3;85.3;32.6
43;2021-12-17;58;87;2446;171670;169667;67257;86.4;85.4;33.8
43;2021-12-18;54;61;1226;171724;169728;68483;86.4;85.4;34.5
43;2021-12-19;1;6;103;171725;169734;68586;86.4;85.4;34.5
44;2020-12-27;2;0;0;2;0;0;0.0;0.0;0.0
44;2020-12-28;4;1;0;6;1;0;0.0;0.0;0.0
44;2020-12-29;1;0;0;7;1;0;0.0;0.0;0.0
44;2020-12-30;1;0;0;8;1;0;0.0;0.0;0.0
44;2020-12-31;0;0;0;8;1;0;0.0;0.0;0.0
44;2021-01-01;2;1;0;10;2;0;0.0;0.0;0.0
44;2021-01-02;0;0;0;10;2;0;0.0;0.0;0.0
44;2021-01-03;3;0;0;13;2;0;0.0;0.0;0.0
44;2021-01-04;4;0;0;17;2;0;0.0;0.0;0.0
44;2021-01-05;5;0;0;22;2;0;0.0;0.0;0.0
44;2021-01-06;32;1;0;54;3;0;0.0;0.0;0.0
44;2021-01-07;204;0;0;258;3;0;0.0;0.0;0.0
44;2021-01-08;550;0;0;808;3;0;0.1;0.0;0.0
44;2021-01-09;475;0;0;1283;3;0;0.1;0.0;0.0
44;2021-01-10;443;1;0;1726;4;0;0.1;0.0;0.0
44;2021-01-11;811;1;0;2537;5;0;0.2;0.0;0.0
44;2021-01-12;957;1;0;3494;6;0;0.3;0.0;0.0
44;2021-01-13;1074;2;0;4568;8;0;0.4;0.0;0.0
44;2021-01-14;1144;9;0;5712;17;0;0.5;0.0;0.0
44;2021-01-15;1051;5;0;6763;22;0;0.6;0.0;0.0
44;2021-01-16;341;3;0;7104;25;0;0.6;0.0;0.0
44;2021-01-17;307;2;0;7411;27;0;0.6;0.0;0.0
44;2021-01-18;831;4;0;8242;31;0;0.7;0.0;0.0
44;2021-01-19;2613;12;0;10855;43;0;0.9;0.0;0.0
44;2021-01-20;2689;7;0;13544;50;0;1.1;0.0;0.0
44;2021-01-21;4563;12;0;18107;62;0;1.5;0.0;0.0
44;2021-01-22;2480;10;0;20587;72;0;1.7;0.0;0.0
44;2021-01-23;768;0;0;21355;72;0;1.7;0.0;0.0
44;2021-01-24;123;0;0;21478;72;0;1.8;0.0;0.0
44;2021-01-25;858;9;0;22336;81;0;1.8;0.0;0.0
44;2021-01-26;2481;22;0;24817;103;0;2.0;0.0;0.0
44;2021-01-27;2078;69;0;26895;172;0;2.2;0.0;0.0
44;2021-01-28;3604;201;0;30499;373;0;2.5;0.0;0.0
44;2021-01-29;2302;486;0;32801;859;0;2.7;0.1;0.0
44;2021-01-30;623;205;0;33424;1064;0;2.7;0.1;0.0
44;2021-01-31;19;204;0;33443;1268;0;2.7;0.1;0.0
44;2021-02-01;560;544;0;34003;1812;0;2.8;0.1;0.0
44;2021-02-02;888;771;0;34891;2583;0;2.9;0.2;0.0
44;2021-02-03;911;878;0;35802;3461;0;2.9;0.3;0.0
44;2021-02-04;981;744;0;36783;4205;0;3.0;0.3;0.0
44;2021-02-05;913;677;0;37696;4882;0;3.1;0.4;0.0
44;2021-02-06;472;272;0;38168;5154;0;3.1;0.4;0.0
44;2021-02-07;65;194;0;38233;5348;0;3.1;0.4;0.0
44;2021-02-08;541;485;0;38774;5833;0;3.2;0.5;0.0
44;2021-02-09;1000;1276;0;39774;7109;0;3.3;0.6;0.0
44;2021-02-10;1173;1265;0;40947;8374;0;3.3;0.7;0.0
44;2021-02-11;2302;3169;0;43249;11543;0;3.5;0.9;0.0
44;2021-02-12;1679;1769;0;44928;13312;0;3.7;1.1;0.0
44;2021-02-13;447;521;0;45375;13833;0;3.7;1.1;0.0
44;2021-02-14;12;178;0;45387;14011;0;3.7;1.1;0.0
44;2021-02-15;484;1097;0;45871;15108;0;3.7;1.2;0.0
44;2021-02-16;1432;2547;0;47303;17655;0;3.9;1.4;0.0
44;2021-02-17;1137;2152;0;48440;19807;0;4.0;1.6;0.0
44;2021-02-18;1983;3652;0;50423;23459;0;4.1;1.9;0.0
44;2021-02-19;1589;2450;0;52012;25909;0;4.3;2.1;0.0
44;2021-02-20;395;631;0;52407;26540;0;4.3;2.2;0.0
44;2021-02-21;7;181;0;52414;26721;0;4.3;2.2;0.0
44;2021-02-22;740;822;0;53154;27543;0;4.3;2.3;0.0
44;2021-02-23;1183;1126;0;54337;28669;0;4.4;2.3;0.0
44;2021-02-24;1246;1056;0;55583;29725;0;4.5;2.4;0.0
44;2021-02-25;2482;1107;0;58065;30832;0;4.7;2.5;0.0
44;2021-02-26;2331;1000;0;60396;31832;0;4.9;2.6;0.0
44;2021-02-27;954;431;0;61350;32263;0;5.0;2.6;0.0
44;2021-02-28;6;34;0;61356;32297;0;5.0;2.6;0.0
44;2021-03-01;1001;554;0;62357;32851;0;5.1;2.7;0.0
44;2021-03-02;1794;1088;0;64151;33939;0;5.2;2.8;0.0
44;2021-03-03;1876;1159;0;66027;35098;0;5.4;2.9;0.0
44;2021-03-04;2890;1624;0;68917;36722;0;5.6;3.0;0.0
44;2021-03-05;3504;1311;0;72421;38033;0;5.9;3.1;0.0
44;2021-03-06;2496;484;0;74917;38517;0;6.1;3.1;0.0
44;2021-03-07;989;91;0;75906;38608;0;6.2;3.2;0.0
44;2021-03-08;1825;642;0;77731;39250;0;6.4;3.2;0.0
44;2021-03-09;3393;1155;0;81124;40405;0;6.6;3.3;0.0
44;2021-03-10;3095;1147;0;84219;41552;0;6.9;3.4;0.0
44;2021-03-11;4445;1785;0;88664;43337;0;7.2;3.5;0.0
44;2021-03-12;6004;1344;0;94668;44681;0;7.7;3.7;0.0
44;2021-03-13;3580;315;0;98248;44996;0;8.0;3.7;0.0
44;2021-03-14;435;56;0;98683;45052;0;8.1;3.7;0.0
44;2021-03-15;2657;415;0;101340;45467;0;8.3;3.7;0.0
44;2021-03-16;2195;663;0;103535;46130;0;8.5;3.8;0.0
44;2021-03-17;2069;691;0;105604;46821;0;8.6;3.8;0.0
44;2021-03-18;2290;660;0;107894;47481;0;8.8;3.9;0.0
44;2021-03-19;3811;416;0;111705;47897;0;9.1;3.9;0.0
44;2021-03-20;3192;312;0;114897;48209;0;9.4;3.9;0.0
44;2021-03-21;898;23;0;115795;48232;0;9.5;3.9;0.0
44;2021-03-22;2473;497;0;118268;48729;0;9.7;4.0;0.0
44;2021-03-23;3987;696;0;122255;49425;0;10.0;4.0;0.0
44;2021-03-24;4381;663;0;126636;50088;0;10.4;4.1;0.0
44;2021-03-25;5683;959;0;132319;51047;0;10.8;4.2;0.0
44;2021-03-26;6608;764;0;138927;51811;0;11.4;4.2;0.0
44;2021-03-27;3213;442;0;142140;52253;0;11.6;4.3;0.0
44;2021-03-28;1211;46;0;143351;52299;0;11.7;4.3;0.0
44;2021-03-29;3233;841;0;146584;53140;0;12.0;4.3;0.0
44;2021-03-30;5208;1162;0;151792;54302;0;12.4;4.4;0.0
44;2021-03-31;4665;1356;0;156457;55658;0;12.8;4.5;0.0
44;2021-04-01;6289;1047;0;162746;56705;0;13.3;4.6;0.0
44;2021-04-02;5847;1018;0;168593;57723;0;13.8;4.7;0.0
44;2021-04-03;2403;650;0;170996;58373;0;14.0;4.8;0.0
44;2021-04-04;663;22;0;171659;58395;0;14.0;4.8;0.0
44;2021-04-05;675;289;0;172334;58684;0;14.1;4.8;0.0
44;2021-04-06;4322;1451;0;176656;60135;0;14.4;4.9;0.0
44;2021-04-07;5286;1690;0;181942;61825;0;14.9;5.1;0.0
44;2021-04-08;7264;1744;0;189206;63569;0;15.5;5.2;0.0
44;2021-04-09;10176;1896;0;199382;65465;0;16.3;5.4;0.0
44;2021-04-10;4615;1436;0;203997;66901;0;16.7;5.5;0.0
44;2021-04-11;2092;422;0;206089;67323;0;16.8;5.5;0.0
44;2021-04-12;5636;1745;0;211725;69068;0;17.3;5.6;0.0
44;2021-04-13;6896;2338;0;218621;71406;0;17.9;5.8;0.0
44;2021-04-14;6071;2305;0;224692;73711;0;18.4;6.0;0.0
44;2021-04-15;7046;2244;0;231738;75955;0;18.9;6.2;0.0
44;2021-04-16;8019;2124;0;239757;78079;0;19.6;6.4;0.0
44;2021-04-17;4334;1399;0;244091;79478;0;20.0;6.5;0.0
44;2021-04-18;2197;798;0;246288;80276;0;20.1;6.6;0.0
44;2021-04-19;5065;2012;0;251353;82288;0;20.5;6.7;0.0
44;2021-04-20;6267;2688;0;257620;84976;0;21.1;6.9;0.0
44;2021-04-21;6085;2855;0;263705;87831;0;21.6;7.2;0.0
44;2021-04-22;7014;2599;0;270719;90430;0;22.1;7.4;0.0
44;2021-04-23;7332;3243;0;278051;93673;0;22.7;7.7;0.0
44;2021-04-24;4002;2041;0;282053;95714;0;23.1;7.8;0.0
44;2021-04-25;2027;1036;0;284080;96750;0;23.2;7.9;0.0
44;2021-04-26;5658;2863;0;289738;99613;0;23.7;8.1;0.0
44;2021-04-27;7482;4223;0;297220;103836;0;24.3;8.5;0.0
44;2021-04-28;7672;3781;0;304892;107617;0;24.9;8.8;0.0
44;2021-04-29;9063;4371;0;313955;111988;0;25.7;9.2;0.0
44;2021-04-30;9566;4732;0;323521;116720;0;26.4;9.5;0.0
44;2021-05-01;2968;888;0;326489;117608;0;26.7;9.6;0.0
44;2021-05-02;1970;611;0;328459;118219;0;26.8;9.7;0.0
44;2021-05-03;5550;4219;0;334009;122438;0;27.3;10.0;0.0
44;2021-05-04;6325;5319;0;340334;127757;0;27.8;10.4;0.0
44;2021-05-05;6026;4775;0;346360;132532;0;28.3;10.8;0.0
44;2021-05-06;7415;5072;0;353775;137604;0;28.9;11.2;0.0
44;2021-05-07;7397;5959;0;361172;143563;0;29.5;11.7;0.0
44;2021-05-08;2684;1283;0;363856;144846;0;29.7;11.8;0.0
44;2021-05-09;1888;1791;0;365744;146637;0;29.9;12.0;0.0
44;2021-05-10;6347;6015;0;372091;152652;0;30.4;12.5;0.0
44;2021-05-11;7606;6487;0;379697;159139;0;31.0;13.0;0.0
44;2021-05-12;8123;5961;0;387820;165100;0;31.7;13.5;0.0
44;2021-05-13;5769;1215;0;393589;166315;0;32.2;13.6;0.0
44;2021-05-14;7743;4142;0;401332;170457;0;32.8;13.9;0.0
44;2021-05-15;5048;2244;0;406380;172701;0;33.2;14.1;0.0
44;2021-05-16;3063;769;0;409443;173470;0;33.5;14.2;0.0
44;2021-05-17;6850;5247;0;416293;178717;0;34.0;14.6;0.0
44;2021-05-18;8215;5297;0;424508;184014;0;34.7;15.0;0.0
44;2021-05-19;8614;4401;0;433122;188415;0;35.4;15.4;0.0
44;2021-05-20;8979;4703;0;442101;193118;0;36.1;15.8;0.0
44;2021-05-21;9279;5267;0;451380;198385;0;36.9;16.2;0.0
44;2021-05-22;5565;2288;0;456945;200673;0;37.3;16.4;0.0
44;2021-05-23;2159;850;0;459104;201523;0;37.5;16.5;0.0
44;2021-05-24;5493;1638;0;464597;203161;0;38.0;16.6;0.0
44;2021-05-25;8253;5583;0;472850;208744;0;38.6;17.1;0.0
44;2021-05-26;8642;5138;0;481492;213882;0;39.4;17.5;0.0
44;2021-05-27;10199;5354;0;491691;219236;0;40.2;17.9;0.0
44;2021-05-28;9645;6892;0;501336;226128;0;41.0;18.5;0.0
44;2021-05-29;6430;3317;0;507766;229445;0;41.5;18.8;0.0
44;2021-05-30;2279;724;0;510045;230169;0;41.7;18.8;0.0
44;2021-05-31;8520;6122;0;518565;236291;0;42.4;19.3;0.0
44;2021-06-01;10503;6561;0;529068;242852;0;43.2;19.8;0.0
44;2021-06-02;10065;5651;0;539133;248503;0;44.1;20.3;0.0
44;2021-06-03;11345;5874;0;550478;254377;0;45.0;20.8;0.0
44;2021-06-04;10550;8133;0;561028;262510;0;45.9;21.5;0.0
44;2021-06-05;6406;4351;0;567434;266861;0;46.4;21.8;0.0
44;2021-06-06;2699;1109;0;570133;267970;0;46.6;21.9;0.0
44;2021-06-07;9484;6987;0;579617;274957;0;47.4;22.5;0.0
44;2021-06-08;11141;7615;0;590758;282572;0;48.3;23.1;0.0
44;2021-06-09;10771;6518;0;601529;289090;0;49.2;23.6;0.0
44;2021-06-10;11582;6074;0;613111;295164;0;50.1;24.1;0.0
44;2021-06-11;11839;8717;0;624950;303881;0;51.1;24.8;0.0
44;2021-06-12;7839;4059;0;632789;307940;0;51.7;25.2;0.0
44;2021-06-13;3356;1063;0;636145;309003;0;52.0;25.3;0.0
44;2021-06-14;8456;8406;0;644601;317409;0;52.7;25.9;0.0
44;2021-06-15;10955;8313;0;655556;325722;0;53.6;26.6;0.0
44;2021-06-16;10714;7647;0;666270;333369;0;54.5;27.2;0.0
44;2021-06-17;11517;8662;0;677787;342031;0;55.4;28.0;0.0
44;2021-06-18;10495;10011;1;688282;352042;1;56.3;28.8;0.0
44;2021-06-19;5920;4289;0;694202;356331;1;56.7;29.1;0.0
44;2021-06-20;2598;1365;0;696800;357696;1;57.0;29.2;0.0
44;2021-06-21;7025;9896;0;703825;367592;1;57.5;30.0;0.0
44;2021-06-22;8126;10575;0;711951;378167;1;58.2;30.9;0.0
44;2021-06-23;8242;9144;0;720193;387311;1;58.9;31.7;0.0
44;2021-06-24;8952;8638;0;729145;395949;1;59.6;32.4;0.0
44;2021-06-25;7270;10833;0;736415;406782;1;60.2;33.2;0.0
44;2021-06-26;2948;6470;0;739363;413252;1;60.4;33.8;0.0
44;2021-06-27;935;2515;0;740298;415767;1;60.5;34.0;0.0
44;2021-06-28;4959;10170;0;745257;425937;1;60.9;34.8;0.0
44;2021-06-29;5974;12147;0;751231;438084;1;61.4;35.8;0.0
44;2021-06-30;5870;10671;2;757101;448755;3;61.9;36.7;0.0
44;2021-07-01;6593;10706;0;763694;459461;3;62.4;37.6;0.0
44;2021-07-02;6056;12764;2;769750;472225;5;62.9;38.6;0.0
44;2021-07-03;2565;7061;1;772315;479286;6;63.1;39.2;0.0
44;2021-07-04;1068;2328;0;773383;481614;6;63.2;39.4;0.0
44;2021-07-05;4790;11940;2;778173;493554;8;63.6;40.3;0.0
44;2021-07-06;5393;12774;1;783566;506328;9;64.0;41.4;0.0
44;2021-07-07;5961;11245;2;789527;517573;11;64.5;42.3;0.0
44;2021-07-08;6766;12012;1;796293;529585;12;65.1;43.3;0.0
44;2021-07-09;5621;14293;1;801914;543878;13;65.5;44.5;0.0
44;2021-07-10;2272;7180;0;804186;551058;13;65.7;45.0;0.0
44;2021-07-11;868;2650;0;805054;553708;13;65.8;45.3;0.0
44;2021-07-12;3968;14084;0;809022;567792;13;66.1;46.4;0.0
44;2021-07-13;5458;14857;2;814480;582649;15;66.6;47.6;0.0
44;2021-07-14;3633;6120;0;818113;588769;15;66.9;48.1;0.0
44;2021-07-15;6943;14355;0;825056;603124;15;67.4;49.3;0.0
44;2021-07-16;7855;14914;1;832911;618038;16;68.1;50.5;0.0
44;2021-07-17;3283;7751;1;836194;625789;17;68.3;51.1;0.0
44;2021-07-18;1999;2880;0;838193;628669;17;68.5;51.4;0.0
44;2021-07-19;4825;14642;0;843018;643311;17;68.9;52.6;0.0
44;2021-07-20;6366;15615;0;849384;658926;17;69.4;53.9;0.0
44;2021-07-21;6280;14069;1;855664;672995;18;69.9;55.0;0.0
44;2021-07-22;7251;13635;0;862915;686630;18;70.5;56.1;0.0
44;2021-07-23;6633;15413;0;869548;702043;18;71.1;57.4;0.0
44;2021-07-24;3187;8568;0;872735;710611;18;71.3;58.1;0.0
44;2021-07-25;1120;3124;0;873855;713735;18;71.4;58.3;0.0
44;2021-07-26;6718;12515;1;880573;726250;19;72.0;59.4;0.0
44;2021-07-27;10273;12012;2;890846;738262;21;72.8;60.3;0.0
44;2021-07-28;9783;10616;0;900629;748878;21;73.6;61.2;0.0
44;2021-07-29;10906;10649;0;911535;759527;21;74.5;62.1;0.0
44;2021-07-30;9780;10706;1;921315;770233;22;75.3;63.0;0.0
44;2021-07-31;5138;5383;0;926453;775616;22;75.7;63.4;0.0
44;2021-08-01;2696;1454;0;929149;777070;22;75.9;63.5;0.0
44;2021-08-02;7163;9186;0;936312;786256;22;76.5;64.3;0.0
44;2021-08-03;9228;8134;0;945540;794390;22;77.3;64.9;0.0
44;2021-08-04;9789;6773;0;955329;801163;22;78.1;65.5;0.0
44;2021-08-05;11764;7209;0;967093;808372;22;79.0;66.1;0.0
44;2021-08-06;10165;7962;0;977258;816334;22;79.9;66.7;0.0
44;2021-08-07;4735;3679;0;981993;820013;22;80.3;67.0;0.0
44;2021-08-08;2585;1516;0;984578;821529;22;80.5;67.1;0.0
44;2021-08-09;8449;7341;2;993027;828870;24;81.2;67.7;0.0
44;2021-08-10;9766;7075;0;1002793;835945;24;82.0;68.3;0.0
44;2021-08-11;9671;6243;1;1012464;842188;25;82.8;68.8;0.0
44;2021-08-12;9587;6711;0;1022051;848899;25;83.5;69.4;0.0
44;2021-08-13;7838;5954;1;1029889;854853;26;84.2;69.9;0.0
44;2021-08-14;2934;3054;0;1032823;857907;26;84.4;70.1;0.0
44;2021-08-15;830;953;0;1033653;858860;26;84.5;70.2;0.0
44;2021-08-16;5290;7879;0;1038943;866739;26;84.9;70.8;0.0
44;2021-08-17;5358;8149;2;1044301;874888;28;85.4;71.5;0.0
44;2021-08-18;4721;7559;0;1049022;882447;28;85.7;72.1;0.0
44;2021-08-19;4651;8192;0;1053673;890639;28;86.1;72.8;0.0
44;2021-08-20;4281;8867;0;1057954;899506;28;86.5;73.5;0.0
44;2021-08-21;1862;4621;0;1059816;904127;28;86.6;73.9;0.0
44;2021-08-22;804;2536;0;1060620;906663;28;86.7;74.1;0.0
44;2021-08-23;3425;9302;0;1064045;915965;28;87.0;74.9;0.0
44;2021-08-24;3397;8776;0;1067442;924741;28;87.2;75.6;0.0
44;2021-08-25;2965;8532;0;1070407;933273;28;87.5;76.3;0.0
44;2021-08-26;2687;10000;2;1073094;943273;30;87.7;77.1;0.0
44;2021-08-27;2897;10468;1;1075991;953741;31;87.9;78.0;0.0
44;2021-08-28;1329;5709;0;1077320;959450;31;88.1;78.4;0.0
44;2021-08-29;517;2758;0;1077837;962208;31;88.1;78.6;0.0
44;2021-08-30;2380;10395;93;1080217;972603;124;88.3;79.5;0.0
44;2021-08-31;2600;10462;245;1082817;983065;369;88.5;80.3;0.0
44;2021-09-01;2545;8984;419;1085362;992049;788;88.7;81.1;0.1
44;2021-09-02;2171;7636;481;1087533;999685;1269;88.9;81.7;0.1
44;2021-09-03;1997;8987;502;1089530;1008672;1771;89.1;82.4;0.1
44;2021-09-04;1317;5463;194;1090847;1014135;1965;89.2;82.9;0.2
44;2021-09-05;453;1255;131;1091300;1015390;2096;89.2;83.0;0.2
44;2021-09-06;1484;5485;585;1092784;1020875;2681;89.3;83.4;0.2
44;2021-09-07;1384;4791;576;1094168;1025666;3257;89.4;83.8;0.3
44;2021-09-08;1731;5635;485;1095899;1031301;3742;89.6;84.3;0.3
44;2021-09-09;1358;4120;662;1097257;1035421;4404;89.7;84.6;0.4
44;2021-09-10;1746;5549;688;1099003;1040970;5092;89.8;85.1;0.4
44;2021-09-11;1003;3741;224;1100006;1044711;5316;89.9;85.4;0.4
44;2021-09-12;210;862;36;1100216;1045573;5352;89.9;85.5;0.4
44;2021-09-13;1096;3287;900;1101312;1048860;6252;90.0;85.7;0.5
44;2021-09-14;1057;3043;1330;1102369;1051903;7582;90.1;86.0;0.6
44;2021-09-15;1383;4267;1022;1103752;1056170;8604;90.2;86.3;0.7
44;2021-09-16;929;2226;1174;1104681;1058396;9778;90.3;86.5;0.8
44;2021-09-17;1157;3715;1201;1105838;1062111;10979;90.4;86.8;0.9
44;2021-09-18;675;2956;202;1106513;1065067;11181;90.4;87.1;0.9
44;2021-09-19;175;688;53;1106688;1065755;11234;90.5;87.1;0.9
44;2021-09-20;832;2028;1141;1107520;1067783;12375;90.5;87.3;1.0
44;2021-09-21;714;1798;1085;1108234;1069581;13460;90.6;87.4;1.1
44;2021-09-22;879;3279;933;1109113;1072860;14393;90.7;87.7;1.2
44;2021-09-23;796;1835;1443;1109909;1074695;15836;90.7;87.8;1.3
44;2021-09-24;1002;2820;1154;1110911;1077515;16990;90.8;88.1;1.4
44;2021-09-25;462;2155;256;1111373;1079670;17246;90.8;88.2;1.4
44;2021-09-26;165;470;54;1111538;1080140;17300;90.8;88.3;1.4
44;2021-09-27;719;1661;1046;1112257;1081801;18346;90.9;88.4;1.5
44;2021-09-28;587;1507;1413;1112844;1083308;19759;91.0;88.5;1.6
44;2021-09-29;919;2383;1182;1113763;1085691;20941;91.0;88.7;1.7
44;2021-09-30;663;1425;1616;1114426;1087116;22557;91.1;88.9;1.8
44;2021-10-01;888;2061;1346;1115314;1089177;23903;91.2;89.0;2.0
44;2021-10-02;461;1216;241;1115775;1090393;24144;91.2;89.1;2.0
44;2021-10-03;183;323;58;1115958;1090716;24202;91.2;89.1;2.0
44;2021-10-04;486;882;558;1116444;1091598;24760;91.3;89.2;2.0
44;2021-10-05;469;908;1039;1116913;1092506;25799;91.3;89.3;2.1
44;2021-10-06;690;1467;940;1117603;1093973;26739;91.3;89.4;2.2
44;2021-10-07;522;1011;1322;1118125;1094984;28061;91.4;89.5;2.3
44;2021-10-08;793;1457;1255;1118918;1096441;29316;91.5;89.6;2.4
44;2021-10-09;352;840;338;1119270;1097281;29654;91.5;89.7;2.4
44;2021-10-10;97;188;124;1119367;1097469;29778;91.5;89.7;2.4
44;2021-10-11;492;960;1182;1119859;1098429;30960;91.5;89.8;2.5
44;2021-10-12;441;794;1325;1120300;1099223;32285;91.6;89.8;2.6
44;2021-10-13;597;1047;1065;1120897;1100270;33350;91.6;89.9;2.7
44;2021-10-14;535;893;1372;1121432;1101163;34722;91.7;90.0;2.8
44;2021-10-15;667;1225;1558;1122099;1102388;36280;91.7;90.1;3.0
44;2021-10-16;310;586;301;1122409;1102974;36581;91.7;90.1;3.0
44;2021-10-17;81;161;82;1122490;1103135;36663;91.7;90.2;3.0
44;2021-10-18;559;741;1359;1123049;1103876;38022;91.8;90.2;3.1
44;2021-10-19;217;637;1582;1123266;1104513;39604;91.8;90.3;3.2
44;2021-10-20;325;957;1709;1123591;1105470;41313;91.8;90.4;3.4
44;2021-10-21;209;644;1373;1123800;1106114;42686;91.9;90.4;3.5
44;2021-10-22;254;974;1862;1124054;1107088;44548;91.9;90.5;3.6
44;2021-10-23;123;473;451;1124177;1107561;44999;91.9;90.5;3.7
44;2021-10-24;32;183;111;1124209;1107744;45110;91.9;90.5;3.7
44;2021-10-25;236;524;1523;1124445;1108268;46633;91.9;90.6;3.8
44;2021-10-26;180;418;1488;1124625;1108686;48121;91.9;90.6;3.9
44;2021-10-27;266;597;1897;1124891;1109283;50018;91.9;90.7;4.1
44;2021-10-28;199;454;1883;1125090;1109737;51901;92.0;90.7;4.2
44;2021-10-29;256;705;2416;1125346;1110442;54317;92.0;90.8;4.4
44;2021-10-30;77;291;564;1125423;1110733;54881;92.0;90.8;4.5
44;2021-10-31;31;118;174;1125454;1110851;55055;92.0;90.8;4.5
44;2021-11-01;19;32;17;1125473;1110883;55072;92.0;90.8;4.5
44;2021-11-02;193;410;1588;1125666;1111293;56660;92.0;90.8;4.6
44;2021-11-03;208;535;1858;1125874;1111828;58518;92.0;90.9;4.8
44;2021-11-04;213;448;2168;1126087;1112276;60686;92.0;90.9;5.0
44;2021-11-05;235;650;2510;1126322;1112926;63196;92.1;91.0;5.2
44;2021-11-06;85;257;845;1126407;1113183;64041;92.1;91.0;5.2
44;2021-11-07;13;104;42;1126420;1113287;64083;92.1;91.0;5.2
44;2021-11-08;158;507;2274;1126578;1113794;66357;92.1;91.0;5.4
44;2021-11-09;171;482;3654;1126749;1114276;70011;92.1;91.1;5.7
44;2021-11-10;246;530;3518;1126995;1114806;73529;92.1;91.1;6.0
44;2021-11-11;15;23;60;1127010;1114829;73589;92.1;91.1;6.0
44;2021-11-12;249;501;3809;1127259;1115330;77398;92.1;91.2;6.3
44;2021-11-13;97;214;919;1127356;1115544;78317;92.1;91.2;6.4
44;2021-11-14;1;7;8;1127357;1115551;78325;92.1;91.2;6.4
44;2021-11-15;149;288;3467;1127506;1115839;81792;92.2;91.2;6.7
44;2021-11-16;170;290;4805;1127676;1116129;86597;92.2;91.2;7.1
44;2021-11-17;264;373;4271;1127940;1116502;90868;92.2;91.3;7.4
44;2021-11-18;170;302;4844;1128110;1116804;95712;92.2;91.3;7.8
44;2021-11-19;234;353;5181;1128344;1117157;100893;92.2;91.3;8.2
44;2021-11-20;160;170;1241;1128504;1117327;102134;92.2;91.3;8.3
44;2021-11-21;5;16;10;1128509;1117343;102144;92.2;91.3;8.3
44;2021-11-22;152;175;3947;1128661;1117518;106091;92.2;91.3;8.7
44;2021-11-23;218;199;5930;1128879;1117717;112021;92.3;91.4;9.2
44;2021-11-24;360;303;5400;1129239;1118020;117421;92.3;91.4;9.6
44;2021-11-25;202;238;6308;1129441;1118258;123729;92.3;91.4;10.1
44;2021-11-26;257;350;8267;1129698;1118608;131996;92.3;91.4;10.8
44;2021-11-27;128;198;3007;1129826;1118806;135003;92.3;91.4;11.0
44;2021-11-28;6;19;635;1129832;1118825;135638;92.3;91.4;11.1
44;2021-11-29;159;199;6663;1129991;1119024;142301;92.4;91.5;11.6
44;2021-11-30;209;217;9979;1130200;1119241;152280;92.4;91.5;12.4
44;2021-12-01;186;232;8768;1130386;1119473;161048;92.4;91.5;13.2
44;2021-12-02;149;177;11071;1130535;1119650;172119;92.4;91.5;14.1
44;2021-12-03;168;271;12081;1130703;1119921;184200;92.4;91.5;15.1
44;2021-12-04;81;130;4645;1130784;1120051;188845;92.4;91.5;15.4
44;2021-12-05;13;11;1009;1130797;1120062;189854;92.4;91.5;15.5
44;2021-12-06;105;178;10008;1130902;1120240;199862;92.4;91.6;16.3
44;2021-12-07;173;209;13332;1131075;1120449;213194;92.4;91.6;17.4
44;2021-12-08;191;284;11419;1131266;1120733;224613;92.5;91.6;18.4
44;2021-12-09;155;249;13761;1131421;1120982;238374;92.5;91.6;19.5
44;2021-12-10;164;280;14918;1131585;1121262;253292;92.5;91.6;20.7
44;2021-12-11;112;198;6826;1131697;1121460;260118;92.5;91.7;21.3
44;2021-12-12;14;28;2181;1131711;1121488;262299;92.5;91.7;21.4
44;2021-12-13;160;208;12952;1131871;1121696;275251;92.5;91.7;22.5
44;2021-12-14;194;246;17861;1132065;1121942;293112;92.5;91.7;24.0
44;2021-12-15;247;342;14828;1132312;1122284;307940;92.5;91.7;25.2
44;2021-12-16;169;258;17430;1132481;1122542;325370;92.6;91.7;26.6
44;2021-12-17;228;354;19659;1132709;1122896;345029;92.6;91.8;28.2
44;2021-12-18;161;206;8921;1132870;1123102;353950;92.6;91.8;28.9
44;2021-12-19;33;34;3347;1132903;1123136;357297;92.6;91.8;29.2
45;2020-12-27;3;1;0;3;1;0;0.0;0.0;0.0
45;2020-12-28;0;0;0;3;1;0;0.0;0.0;0.0
45;2020-12-29;0;0;0;3;1;0;0.0;0.0;0.0
45;2020-12-30;0;0;0;3;1;0;0.0;0.0;0.0
45;2020-12-31;0;0;0;3;1;0;0.0;0.0;0.0
45;2021-01-01;0;0;0;3;1;0;0.0;0.0;0.0
45;2021-01-02;0;0;0;3;1;0;0.0;0.0;0.0
45;2021-01-03;0;0;0;3;1;0;0.0;0.0;0.0
45;2021-01-04;0;0;0;3;1;0;0.0;0.0;0.0
45;2021-01-05;73;0;0;76;1;0;0.0;0.0;0.0
45;2021-01-06;86;0;0;162;1;0;0.0;0.0;0.0
45;2021-01-07;226;1;0;388;2;0;0.1;0.0;0.0
45;2021-01-08;215;0;0;603;2;0;0.1;0.0;0.0
45;2021-01-09;38;0;0;641;2;0;0.1;0.0;0.0
45;2021-01-10;22;0;0;663;2;0;0.1;0.0;0.0
45;2021-01-11;267;1;0;930;3;0;0.2;0.0;0.0
45;2021-01-12;618;3;0;1548;6;0;0.3;0.0;0.0
45;2021-01-13;506;1;0;2054;7;0;0.4;0.0;0.0
45;2021-01-14;507;37;0;2561;44;0;0.4;0.0;0.0
45;2021-01-15;396;2;0;2957;46;0;0.5;0.0;0.0
45;2021-01-16;48;1;0;3005;47;0;0.5;0.0;0.0
45;2021-01-17;25;0;0;3030;47;0;0.5;0.0;0.0
45;2021-01-18;749;1;0;3779;48;0;0.6;0.0;0.0
45;2021-01-19;1153;6;0;4932;54;0;0.8;0.0;0.0
45;2021-01-20;2030;14;0;6962;68;0;1.2;0.0;0.0
45;2021-01-21;2460;6;0;9422;74;0;1.6;0.0;0.0
45;2021-01-22;1387;6;0;10809;80;0;1.9;0.0;0.0
45;2021-01-23;154;1;0;10963;81;0;1.9;0.0;0.0
45;2021-01-24;34;0;0;10997;81;0;1.9;0.0;0.0
45;2021-01-25;567;4;0;11564;85;0;2.0;0.0;0.0
45;2021-01-26;885;20;0;12449;105;0;2.1;0.0;0.0
45;2021-01-27;889;41;0;13338;146;0;2.3;0.0;0.0
45;2021-01-28;945;205;0;14283;351;0;2.5;0.1;0.0
45;2021-01-29;612;131;0;14895;482;0;2.6;0.1;0.0
45;2021-01-30;61;33;0;14956;515;0;2.6;0.1;0.0
45;2021-01-31;39;23;0;14995;538;0;2.6;0.1;0.0
45;2021-02-01;485;204;0;15480;742;0;2.7;0.1;0.0
45;2021-02-02;764;451;0;16244;1193;0;2.8;0.2;0.0
45;2021-02-03;746;471;0;16990;1664;0;2.9;0.3;0.0
45;2021-02-04;738;275;0;17728;1939;0;3.0;0.3;0.0
45;2021-02-05;438;153;0;18166;2092;0;3.1;0.4;0.0
45;2021-02-06;43;27;0;18209;2119;0;3.1;0.4;0.0
45;2021-02-07;6;29;0;18215;2148;0;3.1;0.4;0.0
45;2021-02-08;459;183;0;18674;2331;0;3.2;0.4;0.0
45;2021-02-09;976;415;0;19650;2746;0;3.4;0.5;0.0
45;2021-02-10;1211;796;0;20861;3542;0;3.6;0.6;0.0
45;2021-02-11;1348;1483;0;22209;5025;0;3.8;0.9;0.0
45;2021-02-12;1033;1120;0;23242;6145;0;4.0;1.1;0.0
45;2021-02-13;89;149;0;23331;6294;0;4.0;1.1;0.0
45;2021-02-14;40;13;0;23371;6307;0;4.0;1.1;0.0
45;2021-02-15;528;617;0;23899;6924;0;4.1;1.2;0.0
45;2021-02-16;773;974;0;24672;7898;0;4.2;1.4;0.0
45;2021-02-17;617;1070;0;25289;8968;0;4.3;1.5;0.0
45;2021-02-18;840;915;0;26129;9883;0;4.5;1.7;0.0
45;2021-02-19;827;804;0;26956;10687;0;4.6;1.8;0.0
45;2021-02-20;59;96;0;27015;10783;0;4.6;1.9;0.0
45;2021-02-21;18;46;0;27033;10829;0;4.6;1.9;0.0
45;2021-02-22;382;630;0;27415;11459;0;4.7;2.0;0.0
45;2021-02-23;768;797;0;28183;12256;0;4.8;2.1;0.0
45;2021-02-24;610;922;0;28793;13178;0;5.0;2.3;0.0
45;2021-02-25;948;830;0;29741;14008;0;5.1;2.4;0.0
45;2021-02-26;1027;704;0;30768;14712;0;5.3;2.5;0.0
45;2021-02-27;295;62;0;31063;14774;0;5.3;2.5;0.0
45;2021-02-28;26;9;0;31089;14783;0;5.3;2.5;0.0
45;2021-03-01;536;360;0;31625;15143;0;5.4;2.6;0.0
45;2021-03-02;713;706;0;32338;15849;0;5.6;2.7;0.0
45;2021-03-03;949;856;0;33287;16705;0;5.7;2.9;0.0
45;2021-03-04;1123;964;0;34410;17669;0;5.9;3.0;0.0
45;2021-03-05;1448;887;0;35858;18556;0;6.2;3.2;0.0
45;2021-03-06;2080;142;0;37938;18698;0;6.5;3.2;0.0
45;2021-03-07;190;67;0;38128;18765;0;6.6;3.2;0.0
45;2021-03-08;779;785;0;38907;19550;0;6.7;3.4;0.0
45;2021-03-09;1300;718;0;40207;20268;0;6.9;3.5;0.0
45;2021-03-10;1607;921;0;41814;21189;0;7.2;3.6;0.0
45;2021-03-11;1767;758;0;43581;21947;0;7.5;3.8;0.0
45;2021-03-12;2093;647;0;45674;22594;0;7.9;3.9;0.0
45;2021-03-13;1071;55;0;46745;22649;0;8.0;3.9;0.0
45;2021-03-14;67;49;0;46812;22698;0;8.1;3.9;0.0
45;2021-03-15;883;552;0;47695;23250;0;8.2;4.0;0.0
45;2021-03-16;1033;808;0;48728;24058;0;8.4;4.1;0.0
45;2021-03-17;1092;627;0;49820;24685;0;8.6;4.2;0.0
45;2021-03-18;1079;575;0;50899;25260;0;8.8;4.3;0.0
45;2021-03-19;1732;425;0;52631;25685;0;9.1;4.4;0.0
45;2021-03-20;581;82;0;53212;25767;0;9.2;4.4;0.0
45;2021-03-21;34;36;0;53246;25803;0;9.2;4.4;0.0
45;2021-03-22;1009;490;0;54255;26293;0;9.3;4.5;0.0
45;2021-03-23;2090;700;0;56345;26993;0;9.7;4.6;0.0
45;2021-03-24;1970;516;0;58315;27509;0;10.0;4.7;0.0
45;2021-03-25;3167;456;0;61482;27965;0;10.6;4.8;0.0
45;2021-03-26;3527;492;0;65009;28457;0;11.2;4.9;0.0
45;2021-03-27;1855;122;0;66864;28579;0;11.5;4.9;0.0
45;2021-03-28;91;38;0;66955;28617;0;11.5;4.9;0.0
45;2021-03-29;1626;556;0;68581;29173;0;11.8;5.0;0.0
45;2021-03-30;2829;822;0;71410;29995;0;12.3;5.2;0.0
45;2021-03-31;2249;594;0;73659;30589;0;12.7;5.3;0.0
45;2021-04-01;3145;596;0;76804;31185;0;13.2;5.4;0.0
45;2021-04-02;2912;541;0;79716;31726;0;13.7;5.5;0.0
45;2021-04-03;853;105;0;80569;31831;0;13.9;5.5;0.0
45;2021-04-04;122;38;0;80691;31869;0;13.9;5.5;0.0
45;2021-04-05;46;2;0;80737;31871;0;13.9;5.5;0.0
45;2021-04-06;1871;813;0;82608;32684;0;14.2;5.6;0.0
45;2021-04-07;1983;1180;0;84591;33864;0;14.5;5.8;0.0
45;2021-04-08;2992;1065;0;87583;34929;0;15.1;6.0;0.0
45;2021-04-09;3778;693;0;91361;35622;0;15.7;6.1;0.0
45;2021-04-10;2409;200;0;93770;35822;0;16.1;6.2;0.0
45;2021-04-11;182;47;0;93952;35869;0;16.2;6.2;0.0
45;2021-04-12;2630;695;0;96582;36564;0;16.6;6.3;0.0
45;2021-04-13;3976;1176;0;100558;37740;0;17.3;6.5;0.0
45;2021-04-14;3050;1286;0;103608;39026;0;17.8;6.7;0.0
45;2021-04-15;3666;1113;0;107274;40139;0;18.4;6.9;0.0
45;2021-04-16;3904;777;0;111178;40916;0;19.1;7.0;0.0
45;2021-04-17;1611;163;0;112789;41079;0;19.4;7.1;0.0
45;2021-04-18;205;47;0;112994;41126;0;19.4;7.1;0.0
45;2021-04-19;1997;992;0;114991;42118;0;19.8;7.2;0.0
45;2021-04-20;3196;1766;0;118187;43884;0;20.3;7.5;0.0
45;2021-04-21;2834;1395;0;121021;45279;0;20.8;7.8;0.0
45;2021-04-22;3489;1990;0;124510;47269;0;21.4;8.1;0.0
45;2021-04-23;3452;1853;0;127962;49122;0;22.0;8.4;0.0
45;2021-04-24;2277;931;0;130239;50053;0;22.4;8.6;0.0
45;2021-04-25;443;97;0;130682;50150;0;22.5;8.6;0.0
45;2021-04-26;2379;1217;0;133061;51367;0;22.9;8.8;0.0
45;2021-04-27;3583;2376;0;136644;53743;0;23.5;9.2;0.0
45;2021-04-28;3002;2072;0;139646;55815;0;24.0;9.6;0.0
45;2021-04-29;4139;2435;0;143785;58250;0;24.7;10.0;0.0
45;2021-04-30;4595;1877;0;148380;60127;0;25.5;10.3;0.0
45;2021-05-01;514;95;0;148894;60222;0;25.6;10.4;0.0
45;2021-05-02;640;126;0;149534;60348;0;25.7;10.4;0.0
45;2021-05-03;3011;1126;0;152545;61474;0;26.2;10.6;0.0
45;2021-05-04;3479;2470;0;156024;63944;0;26.8;11.0;0.0
45;2021-05-05;2987;2259;0;159011;66203;0;27.3;11.4;0.0
45;2021-05-06;3691;2682;0;162702;68885;0;28.0;11.8;0.0
45;2021-05-07;3162;3242;0;165864;72127;0;28.5;12.4;0.0
45;2021-05-08;868;324;0;166732;72451;0;28.7;12.5;0.0
45;2021-05-09;1473;169;0;168205;72620;0;28.9;12.5;0.0
45;2021-05-10;4194;3066;0;172399;75686;0;29.7;13.0;0.0
45;2021-05-11;5118;3154;0;177517;78840;0;30.5;13.6;0.0
45;2021-05-12;6109;2998;0;183626;81838;0;31.6;14.1;0.0
45;2021-05-13;2778;633;0;186404;82471;0;32.1;14.2;0.0
45;2021-05-14;5192;1725;0;191596;84196;0;33.0;14.5;0.0
45;2021-05-15;4358;664;0;195954;84860;0;33.7;14.6;0.0
45;2021-05-16;386;58;0;196340;84918;0;33.8;14.6;0.0
45;2021-05-17;3700;1611;0;200040;86529;0;34.4;14.9;0.0
45;2021-05-18;5634;1811;0;205674;88340;0;35.4;15.2;0.0
45;2021-05-19;5085;2130;0;210759;90470;0;36.2;15.6;0.0
45;2021-05-20;5862;2197;0;216621;92667;0;37.3;15.9;0.0
45;2021-05-21;5663;2337;0;222284;95004;0;38.2;16.3;0.0
45;2021-05-22;3395;668;0;225679;95672;0;38.8;16.5;0.0
45;2021-05-23;225;105;0;225904;95777;0;38.9;16.5;0.0
45;2021-05-24;3193;255;0;229097;96032;0;39.4;16.5;0.0
45;2021-05-25;5544;3066;0;234641;99098;0;40.4;17.0;0.0
45;2021-05-26;5851;2412;0;240492;101510;0;41.4;17.5;0.0
45;2021-05-27;5808;3337;0;246300;104847;0;42.4;18.0;0.0
45;2021-05-28;5943;3574;0;252243;108421;0;43.4;18.6;0.0
45;2021-05-29;3934;1331;0;256177;109752;0;44.1;18.9;0.0
45;2021-05-30;139;185;0;256316;109937;0;44.1;18.9;0.0
45;2021-05-31;4307;2567;0;260623;112504;0;44.8;19.3;0.0
45;2021-06-01;6176;3233;0;266799;115737;0;45.9;19.9;0.0
45;2021-06-02;4976;3247;0;271775;118984;0;46.7;20.5;0.0
45;2021-06-03;5824;3373;0;277599;122357;0;47.7;21.0;0.0
45;2021-06-04;5892;3326;0;283491;125683;0;48.8;21.6;0.0
45;2021-06-05;2421;1601;0;285912;127284;0;49.2;21.9;0.0
45;2021-06-06;275;340;0;286187;127624;0;49.2;21.9;0.0
45;2021-06-07;4025;2850;0;290212;130474;0;49.9;22.4;0.0
45;2021-06-08;4675;4350;0;294887;134824;0;50.7;23.2;0.0
45;2021-06-09;4471;3508;0;299358;138332;0;51.5;23.8;0.0
45;2021-06-10;4839;2997;0;304197;141329;0;52.3;24.3;0.0
45;2021-06-11;4157;3870;0;308354;145199;0;53.0;25.0;0.0
45;2021-06-12;2717;1601;0;311071;146800;0;53.5;25.2;0.0
45;2021-06-13;128;483;0;311199;147283;0;53.5;25.3;0.0
45;2021-06-14;3048;4369;0;314247;151652;0;54.0;26.1;0.0
45;2021-06-15;3409;4667;0;317656;156319;0;54.6;26.9;0.0
45;2021-06-16;3812;3724;1;321468;160043;1;55.3;27.5;0.0
45;2021-06-17;3473;3834;0;324941;163877;1;55.9;28.2;0.0
45;2021-06-18;3818;5188;0;328759;169065;1;56.5;29.1;0.0
45;2021-06-19;2445;2012;0;331204;171077;1;57.0;29.4;0.0
45;2021-06-20;111;183;0;331315;171260;1;57.0;29.5;0.0
45;2021-06-21;2145;5965;0;333460;177225;1;57.4;30.5;0.0
45;2021-06-22;2442;6791;0;335902;184016;1;57.8;31.6;0.0
45;2021-06-23;2296;5811;0;338198;189827;1;58.2;32.6;0.0
45;2021-06-24;2204;3843;0;340402;193670;1;58.5;33.3;0.0
45;2021-06-25;2425;6593;0;342827;200263;1;59.0;34.4;0.0
45;2021-06-26;1858;3408;0;344685;203671;1;59.3;35.0;0.0
45;2021-06-27;92;240;0;344777;203911;1;59.3;35.1;0.0
45;2021-06-28;2024;5205;0;346801;209116;1;59.6;36.0;0.0
45;2021-06-29;2646;7240;0;349447;216356;1;60.1;37.2;0.0
45;2021-06-30;2878;6262;0;352325;222618;1;60.6;38.3;0.0
45;2021-07-01;2424;5466;0;354749;228084;1;61.0;39.2;0.0
45;2021-07-02;2350;6627;0;357099;234711;1;61.4;40.4;0.0
45;2021-07-03;826;3015;0;357925;237726;1;61.6;40.9;0.0
45;2021-07-04;75;197;0;358000;237923;1;61.6;40.9;0.0
45;2021-07-05;2010;5164;0;360010;243087;1;61.9;41.8;0.0
45;2021-07-06;2660;7186;0;362670;250273;1;62.4;43.0;0.0
45;2021-07-07;2298;6591;0;364968;256864;1;62.8;44.2;0.0
45;2021-07-08;2694;5618;0;367662;262482;1;63.2;45.1;0.0
45;2021-07-09;2191;7112;0;369853;269594;1;63.6;46.4;0.0
45;2021-07-10;1549;4196;0;371402;273790;1;63.9;47.1;0.0
45;2021-07-11;94;171;0;371496;273961;1;63.9;47.1;0.0
45;2021-07-12;1609;5935;0;373105;279896;1;64.2;48.1;0.0
45;2021-07-13;3084;8328;0;376189;288224;1;64.7;49.6;0.0
45;2021-07-14;1552;1710;0;377741;289934;1;65.0;49.9;0.0
45;2021-07-15;3929;7416;0;381670;297350;1;65.6;51.1;0.0
45;2021-07-16;3464;7355;0;385134;304705;1;66.2;52.4;0.0
45;2021-07-17;1484;2731;0;386618;307436;1;66.5;52.9;0.0
45;2021-07-18;251;236;0;386869;307672;1;66.5;52.9;0.0
45;2021-07-19;2108;5892;0;388977;313564;1;66.9;53.9;0.0
45;2021-07-20;4797;6832;0;393774;320396;1;67.7;55.1;0.0
45;2021-07-21;5188;5499;0;398962;325895;1;68.6;56.0;0.0
45;2021-07-22;6259;5066;0;405221;330961;1;69.7;56.9;0.0
45;2021-07-23;4457;5654;0;409678;336615;1;70.5;57.9;0.0
45;2021-07-24;2045;2917;0;411723;339532;1;70.8;58.4;0.0
45;2021-07-25;286;159;0;412009;339691;1;70.9;58.4;0.0
45;2021-07-26;3064;4899;0;415073;344590;1;71.4;59.3;0.0
45;2021-07-27;5443;5051;0;420516;349641;1;72.3;60.1;0.0
45;2021-07-28;4838;4053;0;425354;353694;1;73.2;60.8;0.0
45;2021-07-29;5257;3392;0;430611;357086;1;74.1;61.4;0.0
45;2021-07-30;4926;4784;0;435537;361870;1;74.9;62.2;0.0
45;2021-07-31;1301;2253;0;436838;364123;1;75.1;62.6;0.0
45;2021-08-01;281;97;0;437119;364220;1;75.2;62.6;0.0
45;2021-08-02;3679;3233;0;440798;367453;1;75.8;63.2;0.0
45;2021-08-03;4770;3044;0;445568;370497;1;76.6;63.7;0.0
45;2021-08-04;3576;2405;0;449144;372902;1;77.2;64.1;0.0
45;2021-08-05;3280;2718;0;452424;375620;1;77.8;64.6;0.0
45;2021-08-06;3622;3334;0;456046;378954;1;78.4;65.2;0.0
45;2021-08-07;1704;1256;0;457750;380210;1;78.7;65.4;0.0
45;2021-08-08;136;166;0;457886;380376;1;78.8;65.4;0.0
45;2021-08-09;2616;3231;0;460502;383607;1;79.2;66.0;0.0
45;2021-08-10;3334;3890;0;463836;387497;1;79.8;66.6;0.0
45;2021-08-11;2612;3689;0;466448;391186;1;80.2;67.3;0.0
45;2021-08-12;2141;3544;0;468589;394730;1;80.6;67.9;0.0
45;2021-08-13;1786;4178;0;470375;398908;1;80.9;68.6;0.0
45;2021-08-14;755;1266;0;471130;400174;1;81.0;68.8;0.0
45;2021-08-15;85;91;0;471215;400265;1;81.0;68.8;0.0
45;2021-08-16;1191;2607;0;472406;402872;1;81.2;69.3;0.0
45;2021-08-17;1836;3701;0;474242;406573;1;81.6;69.9;0.0
45;2021-08-18;1687;3904;0;475929;410477;1;81.9;70.6;0.0
45;2021-08-19;1479;4144;0;477408;414621;1;82.1;71.3;0.0
45;2021-08-20;1429;3624;0;478837;418245;1;82.4;71.9;0.0
45;2021-08-21;873;1437;0;479710;419682;1;82.5;72.2;0.0
45;2021-08-22;50;242;0;479760;419924;1;82.5;72.2;0.0
45;2021-08-23;1195;4293;0;480955;424217;1;82.7;73.0;0.0
45;2021-08-24;1669;4630;0;482624;428847;1;83.0;73.8;0.0
45;2021-08-25;1496;3643;0;484120;432490;1;83.3;74.4;0.0
45;2021-08-26;1042;3527;0;485162;436017;1;83.4;75.0;0.0
45;2021-08-27;1389;4800;0;486551;440817;1;83.7;75.8;0.0
45;2021-08-28;843;2116;0;487394;442933;1;83.8;76.2;0.0
45;2021-08-29;117;228;0;487511;443161;1;83.8;76.2;0.0
45;2021-08-30;1132;3973;73;488643;447134;74;84.0;76.9;0.0
45;2021-08-31;1069;4262;133;489712;451396;207;84.2;77.6;0.0
45;2021-09-01;1115;3306;169;490827;454702;376;84.4;78.2;0.1
45;2021-09-02;948;3037;250;491775;457739;626;84.6;78.7;0.1
45;2021-09-03;1040;3521;253;492815;461260;879;84.8;79.3;0.2
45;2021-09-04;549;1431;54;493364;462691;933;84.9;79.6;0.2
45;2021-09-05;23;72;1;493387;462763;934;84.9;79.6;0.2
45;2021-09-06;843;2310;463;494230;465073;1397;85.0;80.0;0.2
45;2021-09-07;719;1732;497;494949;466805;1894;85.1;80.3;0.3
45;2021-09-08;829;2132;395;495778;468937;2289;85.3;80.7;0.4
45;2021-09-09;761;1460;257;496539;470397;2546;85.4;80.9;0.4
45;2021-09-10;772;1601;299;497311;471998;2845;85.5;81.2;0.5
45;2021-09-11;427;1545;108;497738;473543;2953;85.6;81.4;0.5
45;2021-09-12;342;207;179;498080;473750;3132;85.7;81.5;0.5
45;2021-09-13;442;920;340;498522;474670;3472;85.7;81.6;0.6
45;2021-09-14;763;1450;717;499285;476120;4189;85.9;81.9;0.7
45;2021-09-15;736;1702;604;500021;477822;4793;86.0;82.2;0.8
45;2021-09-16;761;990;506;500782;478812;5299;86.1;82.3;0.9
45;2021-09-17;743;1585;535;501525;480397;5834;86.3;82.6;1.0
45;2021-09-18;448;985;188;501973;481382;6022;86.3;82.8;1.0
45;2021-09-19;12;60;1;501985;481442;6023;86.3;82.8;1.0
45;2021-09-20;392;930;671;502377;482372;6694;86.4;83.0;1.2
45;2021-09-21;454;761;642;502831;483133;7336;86.5;83.1;1.3
45;2021-09-22;414;1570;738;503245;484703;8074;86.6;83.4;1.4
45;2021-09-23;503;874;748;503748;485577;8822;86.6;83.5;1.5
45;2021-09-24;537;1287;483;504285;486864;9305;86.7;83.7;1.6
45;2021-09-25;307;761;178;504592;487625;9483;86.8;83.9;1.6
45;2021-09-26;12;30;6;504604;487655;9489;86.8;83.9;1.6
45;2021-09-27;414;729;550;505018;488384;10039;86.9;84.0;1.7
45;2021-09-28;421;765;741;505439;489149;10780;86.9;84.1;1.9
45;2021-09-29;468;935;751;505907;490084;11531;87.0;84.3;2.0
45;2021-09-30;391;810;594;506298;490894;12125;87.1;84.4;2.1
45;2021-10-01;398;747;355;506696;491641;12480;87.1;84.6;2.1
45;2021-10-02;308;559;259;507004;492200;12739;87.2;84.7;2.2
45;2021-10-03;86;333;148;507090;492533;12887;87.2;84.7;2.2
45;2021-10-04;222;366;457;507312;492899;13344;87.3;84.8;2.3
45;2021-10-05;395;681;830;507707;493580;14174;87.3;84.9;2.4
45;2021-10-06;442;714;690;508149;494294;14864;87.4;85.0;2.6
45;2021-10-07;282;703;730;508431;494997;15594;87.4;85.1;2.7
45;2021-10-08;375;726;677;508806;495723;16271;87.5;85.3;2.8
45;2021-10-09;380;630;332;509186;496353;16603;87.6;85.4;2.9
45;2021-10-10;13;14;5;509199;496367;16608;87.6;85.4;2.9
45;2021-10-11;243;399;479;509442;496766;17087;87.6;85.4;2.9
45;2021-10-12;323;552;1011;509765;497318;18098;87.7;85.5;3.1
45;2021-10-13;320;569;886;510085;497887;18984;87.7;85.6;3.3
45;2021-10-14;254;394;621;510339;498281;19605;87.8;85.7;3.4
45;2021-10-15;398;658;858;510737;498939;20463;87.8;85.8;3.5
45;2021-10-16;333;441;309;511070;499380;20772;87.9;85.9;3.6
45;2021-10-17;3;13;9;511073;499393;20781;87.9;85.9;3.6
45;2021-10-18;224;345;475;511297;499738;21256;87.9;85.9;3.7
45;2021-10-19;202;529;844;511499;500267;22100;88.0;86.0;3.8
45;2021-10-20;305;464;923;511804;500731;23023;88.0;86.1;4.0
45;2021-10-21;240;420;956;512044;501151;23979;88.1;86.2;4.1
45;2021-10-22;269;522;902;512313;501673;24881;88.1;86.3;4.3
45;2021-10-23;240;376;383;512553;502049;25264;88.2;86.3;4.3
45;2021-10-24;5;19;3;512558;502068;25267;88.2;86.3;4.3
45;2021-10-25;197;294;716;512755;502362;25983;88.2;86.4;4.5
45;2021-10-26;224;386;1110;512979;502748;27093;88.2;86.5;4.7
45;2021-10-27;242;472;1079;513221;503220;28172;88.3;86.5;4.8
45;2021-10-28;183;251;889;513404;503471;29061;88.3;86.6;5.0
45;2021-10-29;227;351;890;513631;503822;29951;88.3;86.7;5.2
45;2021-10-30;151;276;441;513782;504098;30392;88.4;86.7;5.2
45;2021-10-31;3;6;2;513785;504104;30394;88.4;86.7;5.2
45;2021-11-01;24;30;17;513809;504134;30411;88.4;86.7;5.2
45;2021-11-02;236;429;1095;514045;504563;31506;88.4;86.8;5.4
45;2021-11-03;231;378;1161;514276;504941;32667;88.4;86.8;5.6
45;2021-11-04;179;205;1292;514455;505146;33959;88.5;86.9;5.8
45;2021-11-05;237;357;1267;514692;505503;35226;88.5;86.9;6.1
45;2021-11-06;163;316;553;514855;505819;35779;88.5;87.0;6.2
45;2021-11-07;5;23;19;514860;505842;35798;88.5;87.0;6.2
45;2021-11-08;176;265;1258;515036;506107;37056;88.6;87.0;6.4
45;2021-11-09;154;285;1857;515190;506392;38913;88.6;87.1;6.7
45;2021-11-10;272;411;2031;515462;506803;40944;88.7;87.2;7.0
45;2021-11-11;48;50;184;515510;506853;41128;88.7;87.2;7.1
45;2021-11-12;284;369;2072;515794;507222;43200;88.7;87.2;7.4
45;2021-11-13;197;258;814;515991;507480;44014;88.7;87.3;7.6
45;2021-11-14;6;24;12;515997;507504;44026;88.7;87.3;7.6
45;2021-11-15;159;233;1745;516156;507737;45771;88.8;87.3;7.9
45;2021-11-16;202;249;2319;516358;507986;48090;88.8;87.4;8.3
45;2021-11-17;285;290;2206;516643;508276;50296;88.9;87.4;8.7
45;2021-11-18;173;183;2095;516816;508459;52391;88.9;87.4;9.0
45;2021-11-19;256;333;2154;517072;508792;54545;88.9;87.5;9.4
45;2021-11-20;277;308;963;517349;509100;55508;89.0;87.6;9.5
45;2021-11-21;3;3;29;517352;509103;55537;89.0;87.6;9.6
45;2021-11-22;176;152;2120;517528;509255;57657;89.0;87.6;9.9
45;2021-11-23;230;228;2901;517758;509483;60558;89.0;87.6;10.4
45;2021-11-24;299;283;2637;518057;509766;63195;89.1;87.7;10.9
45;2021-11-25;189;243;3314;518246;510009;66509;89.1;87.7;11.4
45;2021-11-26;227;239;3949;518473;510248;70458;89.2;87.8;12.1
45;2021-11-27;196;222;2198;518669;510470;72656;89.2;87.8;12.5
45;2021-11-28;30;49;1781;518699;510519;74437;89.2;87.8;12.8
45;2021-11-29;108;188;3738;518807;510707;78175;89.2;87.8;13.4
45;2021-11-30;149;172;5037;518956;510879;83212;89.3;87.9;14.3
45;2021-12-01;126;221;5128;519082;511100;88340;89.3;87.9;15.2
45;2021-12-02;120;164;5363;519202;511264;93703;89.3;87.9;16.1
45;2021-12-03;134;251;5040;519336;511515;98743;89.3;88.0;17.0
45;2021-12-04;112;187;2914;519448;511702;101657;89.3;88.0;17.5
45;2021-12-05;11;20;575;519459;511722;102232;89.3;88.0;17.6
45;2021-12-06;90;191;5627;519549;511913;107859;89.4;88.0;18.6
45;2021-12-07;192;236;7914;519741;512149;115773;89.4;88.1;19.9
45;2021-12-08;182;291;7245;519923;512440;123018;89.4;88.1;21.2
45;2021-12-09;147;222;7772;520070;512662;130790;89.4;88.2;22.5
45;2021-12-10;207;277;7475;520277;512939;138265;89.5;88.2;23.8
45;2021-12-11;152;229;4685;520429;513168;142950;89.5;88.3;24.6
45;2021-12-12;57;49;2876;520486;513217;145826;89.5;88.3;25.1
45;2021-12-13;119;208;7069;520605;513425;152895;89.5;88.3;26.3
45;2021-12-14;193;268;10299;520798;513693;163194;89.6;88.3;28.1
45;2021-12-15;178;314;8874;520976;514007;172068;89.6;88.4;29.6
45;2021-12-16;177;272;9548;521153;514279;181616;89.6;88.4;31.2
45;2021-12-17;183;283;8693;521336;514562;190309;89.7;88.5;32.7
45;2021-12-18;160;207;5551;521496;514769;195860;89.7;88.5;33.7
45;2021-12-19;35;35;1023;521531;514804;196883;89.7;88.5;33.9
46;2020-12-27;1;0;0;1;0;0;0.0;0.0;0.0
46;2020-12-28;0;0;0;1;0;0;0.0;0.0;0.0
46;2020-12-29;0;0;0;1;0;0;0.0;0.0;0.0
46;2020-12-30;0;0;0;1;0;0;0.0;0.0;0.0
46;2020-12-31;0;0;0;1;0;0;0.0;0.0;0.0
46;2021-01-01;0;0;0;1;0;0;0.0;0.0;0.0
46;2021-01-02;0;0;0;1;0;0;0.0;0.0;0.0
46;2021-01-03;0;0;0;1;0;0;0.0;0.0;0.0
46;2021-01-04;0;0;0;1;0;0;0.0;0.0;0.0
46;2021-01-05;0;0;0;1;0;0;0.0;0.0;0.0
46;2021-01-06;3;0;0;4;0;0;0.0;0.0;0.0
46;2021-01-07;127;1;0;131;1;0;0.1;0.0;0.0
46;2021-01-08;169;0;0;300;1;0;0.2;0.0;0.0
46;2021-01-09;1;0;0;301;1;0;0.2;0.0;0.0
46;2021-01-10;2;0;0;303;1;0;0.2;0.0;0.0
46;2021-01-11;95;0;0;398;1;0;0.3;0.0;0.0
46;2021-01-12;137;0;0;535;1;0;0.3;0.0;0.0
46;2021-01-13;221;2;0;756;3;0;0.5;0.0;0.0
46;2021-01-14;236;1;0;992;4;0;0.6;0.0;0.0
46;2021-01-15;292;2;0;1284;6;0;0.8;0.0;0.0
46;2021-01-16;17;0;0;1301;6;0;0.8;0.0;0.0
46;2021-01-17;1;0;0;1302;6;0;0.8;0.0;0.0
46;2021-01-18;277;3;0;1579;9;0;1.0;0.0;0.0
46;2021-01-19;390;0;0;1969;9;0;1.3;0.0;0.0
46;2021-01-20;916;3;0;2885;12;0;1.9;0.0;0.0
46;2021-01-21;917;1;0;3802;13;0;2.5;0.0;0.0
46;2021-01-22;409;1;0;4211;14;0;2.7;0.0;0.0
46;2021-01-23;17;0;0;4228;14;0;2.7;0.0;0.0
46;2021-01-24;1;0;0;4229;14;0;2.7;0.0;0.0
46;2021-01-25;225;2;0;4454;16;0;2.9;0.0;0.0
46;2021-01-26;299;2;0;4753;18;0;3.1;0.0;0.0
46;2021-01-27;277;1;0;5030;19;0;3.2;0.0;0.0
46;2021-01-28;308;44;0;5338;63;0;3.4;0.0;0.0
46;2021-01-29;255;83;0;5593;146;0;3.6;0.1;0.0
46;2021-01-30;9;2;0;5602;148;0;3.6;0.1;0.0
46;2021-01-31;0;0;0;5602;148;0;3.6;0.1;0.0
46;2021-02-01;207;149;0;5809;297;0;3.7;0.2;0.0
46;2021-02-02;205;209;0;6014;506;0;3.9;0.3;0.0
46;2021-02-03;251;91;0;6265;597;0;4.0;0.4;0.0
46;2021-02-04;342;87;0;6607;684;0;4.3;0.4;0.0
46;2021-02-05;205;169;0;6812;853;0;4.4;0.5;0.0
46;2021-02-06;16;3;0;6828;856;0;4.4;0.6;0.0
46;2021-02-07;34;0;0;6862;856;0;4.4;0.6;0.0
46;2021-02-08;192;146;0;7054;1002;0;4.5;0.6;0.0
46;2021-02-09;251;224;0;7305;1226;0;4.7;0.8;0.0
46;2021-02-10;324;524;0;7629;1750;0;4.9;1.1;0.0
46;2021-02-11;576;531;0;8205;2281;0;5.3;1.5;0.0
46;2021-02-12;306;341;0;8511;2622;0;5.5;1.7;0.0
46;2021-02-13;8;8;0;8519;2630;0;5.5;1.7;0.0
46;2021-02-14;0;57;0;8519;2687;0;5.5;1.7;0.0
46;2021-02-15;184;299;0;8703;2986;0;5.6;1.9;0.0
46;2021-02-16;211;279;0;8914;3265;0;5.7;2.1;0.0
46;2021-02-17;227;342;0;9141;3607;0;5.9;2.3;0.0
46;2021-02-18;355;296;0;9496;3903;0;6.1;2.5;0.0
46;2021-02-19;244;240;0;9740;4143;0;6.3;2.7;0.0
46;2021-02-20;3;11;0;9743;4154;0;6.3;2.7;0.0
46;2021-02-21;0;0;0;9743;4154;0;6.3;2.7;0.0
46;2021-02-22;153;212;0;9896;4366;0;6.4;2.8;0.0
46;2021-02-23;243;242;0;10139;4608;0;6.5;3.0;0.0
46;2021-02-24;199;356;0;10338;4964;0;6.7;3.2;0.0
46;2021-02-25;255;300;0;10593;5264;0;6.8;3.4;0.0
46;2021-02-26;380;327;0;10973;5591;0;7.1;3.6;0.0
46;2021-02-27;114;6;0;11087;5597;0;7.1;3.6;0.0
46;2021-02-28;7;3;0;11094;5600;0;7.2;3.6;0.0
46;2021-03-01;175;161;0;11269;5761;0;7.3;3.7;0.0
46;2021-03-02;383;203;0;11652;5964;0;7.5;3.8;0.0
46;2021-03-03;436;292;0;12088;6256;0;7.8;4.0;0.0
46;2021-03-04;571;408;0;12659;6664;0;8.2;4.3;0.0
46;2021-03-05;727;346;0;13386;7010;0;8.6;4.5;0.0
46;2021-03-06;467;20;0;13853;7030;0;8.9;4.5;0.0
46;2021-03-07;107;18;0;13960;7048;0;9.0;4.5;0.0
46;2021-03-08;331;237;0;14291;7285;0;9.2;4.7;0.0
46;2021-03-09;704;241;0;14995;7526;0;9.7;4.9;0.0
46;2021-03-10;643;238;0;15638;7764;0;10.1;5.0;0.0
46;2021-03-11;787;243;0;16425;8007;0;10.6;5.2;0.0
46;2021-03-12;852;225;0;17277;8232;0;11.1;5.3;0.0
46;2021-03-13;503;8;0;17780;8240;0;11.5;5.3;0.0
46;2021-03-14;16;0;0;17796;8240;0;11.5;5.3;0.0
46;2021-03-15;474;158;0;18270;8398;0;11.8;5.4;0.0
46;2021-03-16;667;162;0;18937;8560;0;12.2;5.5;0.0
46;2021-03-17;602;189;0;19539;8749;0;12.6;5.6;0.0
46;2021-03-18;684;202;0;20223;8951;0;13.0;5.8;0.0
46;2021-03-19;733;149;0;20956;9100;0;13.5;5.9;0.0
46;2021-03-20;262;4;0;21218;9104;0;13.7;5.9;0.0
46;2021-03-21;6;1;0;21224;9105;0;13.7;5.9;0.0
46;2021-03-22;497;243;0;21721;9348;0;14.0;6.0;0.0
46;2021-03-23;652;221;0;22373;9569;0;14.4;6.2;0.0
46;2021-03-24;627;230;0;23000;9799;0;14.8;6.3;0.0
46;2021-03-25;1041;183;0;24041;9982;0;15.5;6.4;0.0
46;2021-03-26;934;319;0;24975;10301;0;16.1;6.6;0.0
46;2021-03-27;390;67;0;25365;10368;0;16.4;6.7;0.0
46;2021-03-28;126;1;0;25491;10369;0;16.4;6.7;0.0
46;2021-03-29;660;251;0;26151;10620;0;16.9;6.8;0.0
46;2021-03-30;733;341;0;26884;10961;0;17.3;7.1;0.0
46;2021-03-31;825;380;0;27709;11341;0;17.9;7.3;0.0
46;2021-04-01;1104;337;0;28813;11678;0;18.6;7.5;0.0
46;2021-04-02;834;360;0;29647;12038;0;19.1;7.8;0.0
46;2021-04-03;171;151;0;29818;12189;0;19.2;7.9;0.0
46;2021-04-04;2;62;0;29820;12251;0;19.2;7.9;0.0
46;2021-04-05;12;1;0;29832;12252;0;19.2;7.9;0.0
46;2021-04-06;524;469;0;30356;12721;0;19.6;8.2;0.0
46;2021-04-07;740;593;0;31096;13314;0;20.0;8.6;0.0
46;2021-04-08;933;486;0;32029;13800;0;20.6;8.9;0.0
46;2021-04-09;951;464;0;32980;14264;0;21.3;9.2;0.0
46;2021-04-10;490;180;0;33470;14444;0;21.6;9.3;0.0
46;2021-04-11;242;2;0;33712;14446;0;21.7;9.3;0.0
46;2021-04-12;779;512;0;34491;14958;0;22.2;9.6;0.0
46;2021-04-13;1079;649;0;35570;15607;0;22.9;10.1;0.0
46;2021-04-14;1352;555;0;36922;16162;0;23.8;10.4;0.0
46;2021-04-15;1340;603;0;38262;16765;0;24.7;10.8;0.0
46;2021-04-16;1388;489;0;39650;17254;0;25.6;11.1;0.0
46;2021-04-17;846;124;0;40496;17378;0;26.1;11.2;0.0
46;2021-04-18;430;11;0;40926;17389;0;26.4;11.2;0.0
46;2021-04-19;928;518;0;41854;17907;0;27.0;11.5;0.0
46;2021-04-20;1016;651;0;42870;18558;0;27.6;12.0;0.0
46;2021-04-21;1008;623;0;43878;19181;0;28.3;12.4;0.0
46;2021-04-22;1164;617;0;45042;19798;0;29.0;12.8;0.0
46;2021-04-23;941;645;0;45983;20443;0;29.6;13.2;0.0
46;2021-04-24;447;37;0;46430;20480;0;29.9;13.2;0.0
46;2021-04-25;266;10;0;46696;20490;0;30.1;13.2;0.0
46;2021-04-26;684;636;0;47380;21126;0;30.5;13.6;0.0
46;2021-04-27;1050;592;0;48430;21718;0;31.2;14.0;0.0
46;2021-04-28;1095;659;0;49525;22377;0;31.9;14.4;0.0
46;2021-04-29;1234;530;0;50759;22907;0;32.7;14.8;0.0
46;2021-04-30;1253;527;0;52012;23434;0;33.5;15.1;0.0
46;2021-05-01;588;60;0;52600;23494;0;33.9;15.1;0.0
46;2021-05-02;217;1;0;52817;23495;0;34.0;15.1;0.0
46;2021-05-03;690;525;0;53507;24020;0;34.5;15.5;0.0
46;2021-05-04;816;985;0;54323;25005;0;35.0;16.1;0.0
46;2021-05-05;1038;745;0;55361;25750;0;35.7;16.6;0.0
46;2021-05-06;1081;744;0;56442;26494;0;36.4;17.1;0.0
46;2021-05-07;1119;735;0;57561;27229;0;37.1;17.6;0.0
46;2021-05-08;264;373;0;57825;27602;0;37.3;17.8;0.0
46;2021-05-09;42;234;0;57867;27836;0;37.3;17.9;0.0
46;2021-05-10;450;1006;0;58317;28842;0;37.6;18.6;0.0
46;2021-05-11;940;1136;0;59257;29978;0;38.2;19.3;0.0
46;2021-05-12;851;1340;0;60108;31318;0;38.7;20.2;0.0
46;2021-05-13;488;116;0;60596;31434;0;39.1;20.3;0.0
46;2021-05-14;758;932;0;61354;32366;0;39.5;20.9;0.0
46;2021-05-15;273;504;0;61627;32870;0;39.7;21.2;0.0
46;2021-05-16;114;219;0;61741;33089;0;39.8;21.3;0.0
46;2021-05-17;641;825;0;62382;33914;0;40.2;21.9;0.0
46;2021-05-18;1168;854;0;63550;34768;0;41.0;22.4;0.0
46;2021-05-19;1096;772;0;64646;35540;0;41.7;22.9;0.0
46;2021-05-20;1182;697;0;65828;36237;0;42.4;23.4;0.0
46;2021-05-21;865;958;0;66693;37195;0;43.0;24.0;0.0
46;2021-05-22;179;350;0;66872;37545;0;43.1;24.2;0.0
46;2021-05-23;409;28;0;67281;37573;0;43.4;24.2;0.0
46;2021-05-24;376;115;0;67657;37688;0;43.6;24.3;0.0
46;2021-05-25;839;1061;0;68496;38749;0;44.2;25.0;0.0
46;2021-05-26;1043;983;0;69539;39732;0;44.8;25.6;0.0
46;2021-05-27;1213;1048;0;70752;40780;0;45.6;26.3;0.0
46;2021-05-28;1180;1013;0;71932;41793;0;46.4;26.9;0.0
46;2021-05-29;867;384;0;72799;42177;0;46.9;27.2;0.0
46;2021-05-30;293;49;0;73092;42226;0;47.1;27.2;0.0
46;2021-05-31;829;884;0;73921;43110;0;47.6;27.8;0.0
46;2021-06-01;1077;879;0;74998;43989;0;48.3;28.4;0.0
46;2021-06-02;1106;961;0;76104;44950;0;49.1;29.0;0.0
46;2021-06-03;1184;911;0;77288;45861;0;49.8;29.6;0.0
46;2021-06-04;1121;849;0;78409;46710;0;50.5;30.1;0.0
46;2021-06-05;387;395;0;78796;47105;0;50.8;30.4;0.0
46;2021-06-06;169;76;0;78965;47181;0;50.9;30.4;0.0
46;2021-06-07;721;522;0;79686;47703;0;51.4;30.7;0.0
46;2021-06-08;894;811;0;80580;48514;0;51.9;31.3;0.0
46;2021-06-09;1229;861;0;81809;49375;0;52.7;31.8;0.0
46;2021-06-10;903;784;0;82712;50159;0;53.3;32.3;0.0
46;2021-06-11;861;1172;0;83573;51331;0;53.9;33.1;0.0
46;2021-06-12;434;481;0;84007;51812;0;54.2;33.4;0.0
46;2021-06-13;49;73;0;84056;51885;0;54.2;33.4;0.0
46;2021-06-14;519;890;0;84575;52775;0;54.5;34.0;0.0
46;2021-06-15;661;987;0;85236;53762;0;54.9;34.7;0.0
46;2021-06-16;833;892;0;86069;54654;0;55.5;35.2;0.0
46;2021-06-17;505;803;0;86574;55457;0;55.8;35.7;0.0
46;2021-06-18;569;1072;0;87143;56529;0;56.2;36.4;0.0
46;2021-06-19;397;255;0;87540;56784;0;56.4;36.6;0.0
46;2021-06-20;47;164;0;87587;56948;0;56.5;36.7;0.0
46;2021-06-21;387;789;0;87974;57737;0;56.7;37.2;0.0
46;2021-06-22;327;1051;0;88301;58788;0;56.9;37.9;0.0
46;2021-06-23;438;964;0;88739;59752;0;57.2;38.5;0.0
46;2021-06-24;264;753;0;89003;60505;0;57.4;39.0;0.0
46;2021-06-25;447;988;0;89450;61493;0;57.7;39.6;0.0
46;2021-06-26;353;511;0;89803;62004;0;57.9;40.0;0.0
46;2021-06-27;11;41;0;89814;62045;0;57.9;40.0;0.0
46;2021-06-28;286;1147;0;90100;63192;0;58.1;40.7;0.0
46;2021-06-29;328;1453;0;90428;64645;0;58.3;41.7;0.0
46;2021-06-30;461;1316;0;90889;65961;0;58.6;42.5;0.0
46;2021-07-01;329;1065;0;91218;67026;0;58.8;43.2;0.0
46;2021-07-02;424;992;0;91642;68018;0;59.1;43.8;0.0
46;2021-07-03;138;436;0;91780;68454;0;59.2;44.1;0.0
46;2021-07-04;54;127;0;91834;68581;0;59.2;44.2;0.0
46;2021-07-05;302;1033;0;92136;69614;0;59.4;44.9;0.0
46;2021-07-06;316;1249;0;92452;70863;0;59.6;45.7;0.0
46;2021-07-07;530;1482;0;92982;72345;0;59.9;46.6;0.0
46;2021-07-08;341;1021;0;93323;73366;0;60.2;47.3;0.0
46;2021-07-09;373;1450;0;93696;74816;0;60.4;48.2;0.0
46;2021-07-10;312;919;0;94008;75735;0;60.6;48.8;0.0
46;2021-07-11;17;278;0;94025;76013;0;60.6;49.0;0.0
46;2021-07-12;220;1099;0;94245;77112;0;60.8;49.7;0.0
46;2021-07-13;581;1408;0;94826;78520;0;61.1;50.6;0.0
46;2021-07-14;95;169;0;94921;78689;0;61.2;50.7;0.0
46;2021-07-15;783;1267;0;95704;79956;0;61.7;51.5;0.0
46;2021-07-16;651;1218;0;96355;81174;0;62.1;52.3;0.0
46;2021-07-17;333;548;0;96688;81722;0;62.3;52.7;0.0
46;2021-07-18;38;33;0;96726;81755;0;62.3;52.7;0.0
46;2021-07-19;590;1054;0;97316;82809;0;62.7;53.4;0.0
46;2021-07-20;850;1277;0;98166;84086;0;63.3;54.2;0.0
46;2021-07-21;780;1171;0;98946;85257;0;63.8;55.0;0.0
46;2021-07-22;1051;947;0;99997;86204;0;64.5;55.6;0.0
46;2021-07-23;673;1210;0;100670;87414;0;64.9;56.3;0.0
46;2021-07-24;809;633;0;101479;88047;0;65.4;56.8;0.0
46;2021-07-25;140;43;0;101619;88090;0;65.5;56.8;0.0
46;2021-07-26;762;753;0;102381;88843;0;66.0;57.3;0.0
46;2021-07-27;998;790;0;103379;89633;0;66.6;57.8;0.0
46;2021-07-28;1023;880;0;104402;90513;0;67.3;58.3;0.0
46;2021-07-29;1293;713;0;105695;91226;0;68.1;58.8;0.0
46;2021-07-30;1515;759;0;107210;91985;0;69.1;59.3;0.0
46;2021-07-31;777;585;0;107987;92570;0;69.6;59.7;0.0
46;2021-08-01;67;26;0;108054;92596;0;69.7;59.7;0.0
46;2021-08-02;856;511;0;108910;93107;0;70.2;60.0;0.0
46;2021-08-03;1052;505;0;109962;93612;0;70.9;60.3;0.0
46;2021-08-04;1231;409;0;111193;94021;0;71.7;60.6;0.0
46;2021-08-05;1106;680;0;112299;94701;0;72.4;61.0;0.0
46;2021-08-06;1071;615;0;113370;95316;0;73.1;61.4;0.0
46;2021-08-07;533;420;0;113903;95736;0;73.4;61.7;0.0
46;2021-08-08;116;53;0;114019;95789;0;73.5;61.7;0.0
46;2021-08-09;774;555;0;114793;96344;0;74.0;62.1;0.0
46;2021-08-10;966;726;0;115759;97070;0;74.6;62.6;0.0
46;2021-08-11;950;717;0;116709;97787;0;75.2;63.0;0.0
46;2021-08-12;795;596;0;117504;98383;0;75.7;63.4;0.0
46;2021-08-13;758;736;0;118262;99119;0;76.2;63.9;0.0
46;2021-08-14;459;624;0;118721;99743;0;76.5;64.3;0.0
46;2021-08-15;41;53;0;118762;99796;0;76.6;64.3;0.0
46;2021-08-16;634;658;0;119396;100454;0;77.0;64.8;0.0
46;2021-08-17;744;989;0;120140;101443;0;77.4;65.4;0.0
46;2021-08-18;581;840;0;120721;102283;0;77.8;65.9;0.0
46;2021-08-19;529;1076;0;121250;103359;0;78.2;66.6;0.0
46;2021-08-20;439;1199;0;121689;104558;0;78.4;67.4;0.0
46;2021-08-21;304;521;0;121993;105079;0;78.6;67.7;0.0
46;2021-08-22;19;48;0;122012;105127;0;78.6;67.8;0.0
46;2021-08-23;361;1023;0;122373;106150;0;78.9;68.4;0.0
46;2021-08-24;460;1135;0;122833;107285;0;79.2;69.2;0.0
46;2021-08-25;396;1053;0;123229;108338;0;79.4;69.8;0.0
46;2021-08-26;353;904;0;123582;109242;0;79.7;70.4;0.0
46;2021-08-27;378;1305;0;123960;110547;0;79.9;71.3;0.0
46;2021-08-28;232;550;0;124192;111097;0;80.1;71.6;0.0
46;2021-08-29;14;42;0;124206;111139;0;80.1;71.6;0.0
46;2021-08-30;276;958;17;124482;112097;17;80.2;72.3;0.0
46;2021-08-31;300;1078;33;124782;113175;50;80.4;73.0;0.0
46;2021-09-01;377;948;50;125159;114123;100;80.7;73.6;0.1
46;2021-09-02;246;839;41;125405;114962;141;80.8;74.1;0.1
46;2021-09-03;291;965;100;125696;115927;241;81.0;74.7;0.2
46;2021-09-04;196;542;32;125892;116469;273;81.1;75.1;0.2
46;2021-09-05;12;40;3;125904;116509;276;81.2;75.1;0.2
46;2021-09-06;201;586;82;126105;117095;358;81.3;75.5;0.2
46;2021-09-07;225;677;93;126330;117772;451;81.4;75.9;0.3
46;2021-09-08;239;678;91;126569;118450;542;81.6;76.4;0.3
46;2021-09-09;190;458;101;126759;118908;643;81.7;76.6;0.4
46;2021-09-10;269;729;151;127028;119637;794;81.9;77.1;0.5
46;2021-09-11;153;338;34;127181;119975;828;82.0;77.3;0.5
46;2021-09-12;8;31;4;127189;120006;832;82.0;77.4;0.5
46;2021-09-13;166;435;163;127355;120441;995;82.1;77.6;0.6
46;2021-09-14;253;385;340;127608;120826;1335;82.3;77.9;0.9
46;2021-09-15;229;545;183;127837;121371;1518;82.4;78.2;1.0
46;2021-09-16;126;240;119;127963;121611;1637;82.5;78.4;1.1
46;2021-09-17;217;444;207;128180;122055;1844;82.6;78.7;1.2
46;2021-09-18;96;357;31;128276;122412;1875;82.7;78.9;1.2
46;2021-09-19;4;21;0;128280;122433;1875;82.7;78.9;1.2
46;2021-09-20;65;324;141;128345;122757;2016;82.7;79.1;1.3
46;2021-09-21;81;212;210;128426;122969;2226;82.8;79.3;1.4
46;2021-09-22;114;443;269;128540;123412;2495;82.9;79.6;1.6
46;2021-09-23;81;203;384;128621;123615;2879;82.9;79.7;1.9
46;2021-09-24;90;364;225;128711;123979;3104;83.0;79.9;2.0
46;2021-09-25;74;223;41;128785;124202;3145;83.0;80.1;2.0
46;2021-09-26;5;11;4;128790;124213;3149;83.0;80.1;2.0
46;2021-09-27;74;214;200;128864;124427;3349;83.1;80.2;2.2
46;2021-09-28;52;215;149;128916;124642;3498;83.1;80.3;2.3
46;2021-09-29;74;270;182;128990;124912;3680;83.1;80.5;2.4
46;2021-09-30;62;138;206;129052;125050;3886;83.2;80.6;2.5
46;2021-10-01;111;265;142;129163;125315;4028;83.3;80.8;2.6
46;2021-10-02;85;191;57;129248;125506;4085;83.3;80.9;2.6
46;2021-10-03;0;1;0;129248;125507;4085;83.3;80.9;2.6
46;2021-10-04;67;171;204;129315;125678;4289;83.4;81.0;2.8
46;2021-10-05;64;215;202;129379;125893;4491;83.4;81.2;2.9
46;2021-10-06;67;195;197;129446;126088;4688;83.4;81.3;3.0
46;2021-10-07;65;165;275;129511;126253;4963;83.5;81.4;3.2
46;2021-10-08;115;259;321;129626;126512;5284;83.6;81.5;3.4
46;2021-10-09;72;139;111;129698;126651;5395;83.6;81.6;3.5
46;2021-10-10;0;7;0;129698;126658;5395;83.6;81.6;3.5
46;2021-10-11;65;131;233;129763;126789;5628;83.6;81.7;3.6
46;2021-10-12;45;82;266;129808;126871;5894;83.7;81.8;3.8
46;2021-10-13;68;146;292;129876;127017;6186;83.7;81.9;4.0
46;2021-10-14;59;120;321;129935;127137;6507;83.8;82.0;4.2
46;2021-10-15;96;188;293;130031;127325;6800;83.8;82.1;4.4
46;2021-10-16;56;99;108;130087;127424;6908;83.9;82.1;4.5
46;2021-10-17;1;7;1;130088;127431;6909;83.9;82.1;4.5
46;2021-10-18;33;69;251;130121;127500;7160;83.9;82.2;4.6
46;2021-10-19;43;54;264;130164;127554;7424;83.9;82.2;4.8
46;2021-10-20;53;95;356;130217;127649;7780;83.9;82.3;5.0
46;2021-10-21;37;64;211;130254;127713;7991;84.0;82.3;5.2
46;2021-10-22;80;118;433;130334;127831;8424;84.0;82.4;5.4
46;2021-10-23;43;68;126;130377;127899;8550;84.0;82.4;5.5
46;2021-10-24;4;6;3;130381;127905;8553;84.0;82.4;5.5
46;2021-10-25;41;49;250;130422;127954;8803;84.1;82.5;5.7
46;2021-10-26;41;49;286;130463;128003;9089;84.1;82.5;5.9
46;2021-10-27;56;104;357;130519;128107;9446;84.1;82.6;6.1
46;2021-10-28;58;66;195;130577;128173;9641;84.2;82.6;6.2
46;2021-10-29;59;105;315;130636;128278;9956;84.2;82.7;6.4
46;2021-10-30;41;71;188;130677;128349;10144;84.2;82.7;6.5
46;2021-10-31;4;0;5;130681;128349;10149;84.2;82.7;6.5
46;2021-11-01;4;2;18;130685;128351;10167;84.2;82.7;6.6
46;2021-11-02;39;75;358;130724;128426;10525;84.3;82.8;6.8
46;2021-11-03;43;94;414;130767;128520;10939;84.3;82.8;7.1
46;2021-11-04;21;47;218;130788;128567;11157;84.3;82.9;7.2
46;2021-11-05;53;103;440;130841;128670;11597;84.3;82.9;7.5
46;2021-11-06;52;78;328;130893;128748;11925;84.4;83.0;7.7
46;2021-11-07;3;1;11;130896;128749;11936;84.4;83.0;7.7
46;2021-11-08;21;52;398;130917;128801;12334;84.4;83.0;8.0
46;2021-11-09;51;59;573;130968;128860;12907;84.4;83.1;8.3
46;2021-11-10;65;66;655;131033;128926;13562;84.5;83.1;8.7
46;2021-11-11;4;2;19;131037;128928;13581;84.5;83.1;8.8
46;2021-11-12;41;70;505;131078;128998;14086;84.5;83.2;9.1
46;2021-11-13;37;55;242;131115;129053;14328;84.5;83.2;9.2
46;2021-11-14;4;3;18;131119;129056;14346;84.5;83.2;9.2
46;2021-11-15;36;41;442;131155;129097;14788;84.5;83.2;9.5
46;2021-11-16;49;40;644;131204;129137;15432;84.6;83.2;9.9
46;2021-11-17;73;77;739;131277;129214;16171;84.6;83.3;10.4
46;2021-11-18;33;48;524;131310;129262;16695;84.6;83.3;10.8
46;2021-11-19;58;70;760;131368;129332;17455;84.7;83.4;11.3
46;2021-11-20;60;51;409;131428;129383;17864;84.7;83.4;11.5
46;2021-11-21;6;6;15;131434;129389;17879;84.7;83.4;11.5
46;2021-11-22;22;36;561;131456;129425;18440;84.7;83.4;11.9
46;2021-11-23;57;33;730;131513;129458;19170;84.8;83.4;12.4
46;2021-11-24;42;56;840;131555;129514;20010;84.8;83.5;12.9
46;2021-11-25;70;42;1169;131625;129556;21179;84.8;83.5;13.7
46;2021-11-26;62;57;1224;131687;129613;22403;84.9;83.5;14.4
46;2021-11-27;64;59;984;131751;129672;23387;84.9;83.6;15.1
46;2021-11-28;18;10;456;131769;129682;23843;84.9;83.6;15.4
46;2021-11-29;33;28;840;131802;129710;24683;85.0;83.6;15.9
46;2021-11-30;50;33;1568;131852;129743;26251;85.0;83.6;16.9
46;2021-12-01;68;67;1320;131920;129810;27571;85.0;83.7;17.8
46;2021-12-02;44;41;1525;131964;129851;29096;85.1;83.7;18.8
46;2021-12-03;62;67;1713;132026;129918;30809;85.1;83.7;19.9
46;2021-12-04;48;47;1292;132074;129965;32101;85.1;83.8;20.7
46;2021-12-05;24;3;455;132098;129968;32556;85.2;83.8;21.0
46;2021-12-06;56;62;1704;132154;130030;34260;85.2;83.8;22.1
46;2021-12-07;42;53;1998;132196;130083;36258;85.2;83.9;23.4
46;2021-12-08;58;77;1788;132254;130160;38046;85.3;83.9;24.5
46;2021-12-09;50;46;1866;132304;130206;39912;85.3;83.9;25.7
46;2021-12-10;58;55;2287;132362;130261;42199;85.3;84.0;27.2
46;2021-12-11;50;58;1105;132412;130319;43304;85.4;84.0;27.9
46;2021-12-12;9;8;252;132421;130327;43556;85.4;84.0;28.1
46;2021-12-13;64;50;1798;132485;130377;45354;85.4;84.0;29.2
46;2021-12-14;75;64;2736;132560;130441;48090;85.4;84.1;31.0
46;2021-12-15;61;67;2301;132621;130508;50391;85.5;84.1;32.5
46;2021-12-16;87;80;2480;132708;130588;52871;85.5;84.2;34.1
46;2021-12-17;96;81;2517;132804;130669;55388;85.6;84.2;35.7
46;2021-12-18;50;58;1324;132854;130727;56712;85.6;84.3;36.6
46;2021-12-19;15;6;264;132869;130733;56976;85.6;84.3;36.7
47;2020-12-27;0;0;0;0;0;0;0.0;0.0;0.0
47;2020-12-28;0;0;0;0;0;0;0.0;0.0;0.0
47;2020-12-29;0;0;0;0;0;0;0.0;0.0;0.0
47;2020-12-30;0;0;0;0;0;0;0.0;0.0;0.0
47;2020-12-31;0;0;0;0;0;0;0.0;0.0;0.0
47;2021-01-01;4;0;0;4;0;0;0.0;0.0;0.0
47;2021-01-02;0;0;0;4;0;0;0.0;0.0;0.0
47;2021-01-03;0;0;0;4;0;0;0.0;0.0;0.0
47;2021-01-04;2;0;0;6;0;0;0.0;0.0;0.0
47;2021-01-05;2;0;0;8;0;0;0.0;0.0;0.0
47;2021-01-06;1;0;0;9;0;0;0.0;0.0;0.0
47;2021-01-07;74;1;0;83;1;0;0.0;0.0;0.0
47;2021-01-08;304;0;0;387;1;0;0.1;0.0;0.0
47;2021-01-09;113;0;0;500;1;0;0.2;0.0;0.0
47;2021-01-10;1;0;0;501;1;0;0.2;0.0;0.0
47;2021-01-11;231;0;0;732;1;0;0.3;0.0;0.0
47;2021-01-12;311;0;0;1043;1;0;0.4;0.0;0.0
47;2021-01-13;343;0;0;1386;1;0;0.5;0.0;0.0
47;2021-01-14;365;5;0;1751;6;0;0.6;0.0;0.0
47;2021-01-15;269;1;0;2020;7;0;0.7;0.0;0.0
47;2021-01-16;169;4;0;2189;11;0;0.8;0.0;0.0
47;2021-01-17;2;0;0;2191;11;0;0.8;0.0;0.0
47;2021-01-18;478;3;0;2669;14;0;0.9;0.0;0.0
47;2021-01-19;479;3;0;3148;17;0;1.1;0.0;0.0
47;2021-01-20;520;2;0;3668;19;0;1.3;0.0;0.0
47;2021-01-21;576;2;0;4244;21;0;1.5;0.0;0.0
47;2021-01-22;449;1;0;4693;22;0;1.6;0.0;0.0
47;2021-01-23;375;0;0;5068;22;0;1.8;0.0;0.0
47;2021-01-24;0;0;0;5068;22;0;1.8;0.0;0.0
47;2021-01-25;426;0;0;5494;22;0;1.9;0.0;0.0
47;2021-01-26;743;6;0;6237;28;0;2.2;0.0;0.0
47;2021-01-27;743;2;0;6980;30;0;2.4;0.0;0.0
47;2021-01-28;526;65;0;7506;95;0;2.6;0.0;0.0
47;2021-01-29;436;164;0;7942;259;0;2.7;0.1;0.0
47;2021-01-30;289;40;0;8231;299;0;2.8;0.1;0.0
47;2021-01-31;0;0;0;8231;299;0;2.8;0.1;0.0
47;2021-02-01;349;111;0;8580;410;0;3.0;0.1;0.0
47;2021-02-02;700;307;0;9280;717;0;3.2;0.2;0.0
47;2021-02-03;417;164;0;9697;881;0;3.3;0.3;0.0
47;2021-02-04;384;312;0;10081;1193;0;3.5;0.4;0.0
47;2021-02-05;309;290;0;10390;1483;0;3.6;0.5;0.0
47;2021-02-06;284;96;0;10674;1579;0;3.7;0.5;0.0
47;2021-02-07;1;2;0;10675;1581;0;3.7;0.5;0.0
47;2021-02-08;184;277;0;10859;1858;0;3.8;0.6;0.0
47;2021-02-09;224;274;0;11083;2132;0;3.8;0.7;0.0
47;2021-02-10;262;225;0;11345;2357;0;3.9;0.8;0.0
47;2021-02-11;340;325;0;11685;2682;0;4.0;0.9;0.0
47;2021-02-12;264;390;0;11949;3072;0;4.1;1.1;0.0
47;2021-02-13;223;102;0;12172;3174;0;4.2;1.1;0.0
47;2021-02-14;6;0;0;12178;3174;0;4.2;1.1;0.0
47;2021-02-15;176;377;0;12354;3551;0;4.3;1.2;0.0
47;2021-02-16;298;540;0;12652;4091;0;4.4;1.4;0.0
47;2021-02-17;295;456;0;12947;4547;0;4.5;1.6;0.0
47;2021-02-18;210;557;0;13157;5104;0;4.5;1.8;0.0
47;2021-02-19;212;357;0;13369;5461;0;4.6;1.9;0.0
47;2021-02-20;118;249;0;13487;5710;0;4.7;2.0;0.0
47;2021-02-21;1;0;0;13488;5710;0;4.7;2.0;0.0
47;2021-02-22;76;405;0;13564;6115;0;4.7;2.1;0.0
47;2021-02-23;165;598;0;13729;6713;0;4.7;2.3;0.0
47;2021-02-24;259;561;0;13988;7274;0;4.8;2.5;0.0
47;2021-02-25;356;444;0;14344;7718;0;5.0;2.7;0.0
47;2021-02-26;482;316;0;14826;8034;0;5.1;2.8;0.0
47;2021-02-27;318;212;0;15144;8246;0;5.2;2.8;0.0
47;2021-02-28;0;2;0;15144;8248;0;5.2;2.8;0.0
47;2021-03-01;143;394;0;15287;8642;0;5.3;3.0;0.0
47;2021-03-02;237;368;0;15524;9010;0;5.4;3.1;0.0
47;2021-03-03;265;355;0;15789;9365;0;5.5;3.2;0.0
47;2021-03-04;643;334;0;16432;9699;0;5.7;3.4;0.0
47;2021-03-05;874;288;0;17306;9987;0;6.0;3.5;0.0
47;2021-03-06;509;187;0;17815;10174;0;6.2;3.5;0.0
47;2021-03-07;318;9;0;18133;10183;0;6.3;3.5;0.0
47;2021-03-08;482;222;0;18615;10405;0;6.4;3.6;0.0
47;2021-03-09;523;460;0;19138;10865;0;6.6;3.8;0.0
47;2021-03-10;673;308;0;19811;11173;0;6.8;3.9;0.0
47;2021-03-11;963;386;0;20774;11559;0;7.2;4.0;0.0
47;2021-03-12;1409;316;0;22183;11875;0;7.7;4.1;0.0
47;2021-03-13;914;107;0;23097;11982;0;8.0;4.1;0.0
47;2021-03-14;48;0;0;23145;11982;0;8.0;4.1;0.0
47;2021-03-15;629;154;0;23774;12136;0;8.2;4.2;0.0
47;2021-03-16;782;202;0;24556;12338;0;8.5;4.3;0.0
47;2021-03-17;864;223;0;25420;12561;0;8.8;4.3;0.0
47;2021-03-18;930;190;0;26350;12751;0;9.1;4.4;0.0
47;2021-03-19;1283;135;0;27633;12886;0;9.5;4.5;0.0
47;2021-03-20;1055;58;0;28688;12944;0;9.9;4.5;0.0
47;2021-03-21;335;1;0;29023;12945;0;10.0;4.5;0.0
47;2021-03-22;1027;120;0;30050;13065;0;10.4;4.5;0.0
47;2021-03-23;1186;183;0;31236;13248;0;10.8;4.6;0.0
47;2021-03-24;1232;162;0;32468;13410;0;11.2;4.6;0.0
47;2021-03-25;1555;164;0;34023;13574;0;11.8;4.7;0.0
47;2021-03-26;1887;222;0;35910;13796;0;12.4;4.8;0.0
47;2021-03-27;967;127;0;36877;13923;0;12.7;4.8;0.0
47;2021-03-28;671;7;0;37548;13930;0;13.0;4.8;0.0
47;2021-03-29;1489;114;0;39037;14044;0;13.5;4.9;0.0
47;2021-03-30;1645;149;0;40682;14193;0;14.1;4.9;0.0
47;2021-03-31;1627;185;0;42309;14378;0;14.6;5.0;0.0
47;2021-04-01;1749;278;0;44058;14656;0;15.2;5.1;0.0
47;2021-04-02;1969;451;0;46027;15107;0;15.9;5.2;0.0
47;2021-04-03;1203;183;0;47230;15290;0;16.3;5.3;0.0
47;2021-04-04;467;14;0;47697;15304;0;16.5;5.3;0.0
47;2021-04-05;1190;54;0;48887;15358;0;16.9;5.3;0.0
47;2021-04-06;1427;404;0;50314;15762;0;17.4;5.4;0.0
47;2021-04-07;1698;630;0;52012;16392;0;18.0;5.7;0.0
47;2021-04-08;1866;515;0;53878;16907;0;18.6;5.8;0.0
47;2021-04-09;2230;549;0;56108;17456;0;19.4;6.0;0.0
47;2021-04-10;1581;326;0;57689;17782;0;19.9;6.1;0.0
47;2021-04-11;522;13;0;58211;17795;0;20.1;6.1;0.0
47;2021-04-12;1495;636;0;59706;18431;0;20.6;6.4;0.0
47;2021-04-13;1876;795;0;61582;19226;0;21.3;6.6;0.0
47;2021-04-14;1812;734;0;63394;19960;0;21.9;6.9;0.0
47;2021-04-15;2030;862;0;65424;20822;0;22.6;7.2;0.0
47;2021-04-16;1817;897;0;67241;21719;0;23.2;7.5;0.0
47;2021-04-17;1457;945;0;68698;22664;0;23.7;7.8;0.0
47;2021-04-18;29;5;0;68727;22669;0;23.7;7.8;0.0
47;2021-04-19;1336;946;0;70063;23615;0;24.2;8.2;0.0
47;2021-04-20;1743;914;0;71806;24529;0;24.8;8.5;0.0
47;2021-04-21;1634;806;0;73440;25335;0;25.4;8.8;0.0
47;2021-04-22;1877;1025;0;75317;26360;0;26.0;9.1;0.0
47;2021-04-23;1723;1102;0;77040;27462;0;26.6;9.5;0.0
47;2021-04-24;1518;781;0;78558;28243;0;27.1;9.8;0.0
47;2021-04-25;259;335;0;78817;28578;0;27.2;9.9;0.0
47;2021-04-26;1435;1352;0;80252;29930;0;27.7;10.3;0.0
47;2021-04-27;1889;1465;0;82141;31395;0;28.4;10.8;0.0
47;2021-04-28;2008;1602;0;84149;32997;0;29.1;11.4;0.0
47;2021-04-29;2445;1514;0;86594;34511;0;29.9;11.9;0.0
47;2021-04-30;1982;1776;0;88576;36287;0;30.6;12.5;0.0
47;2021-05-01;2138;940;0;90714;37227;0;31.3;12.9;0.0
47;2021-05-02;40;357;0;90754;37584;0;31.4;13.0;0.0
47;2021-05-03;1520;1393;0;92274;38977;0;31.9;13.5;0.0
47;2021-05-04;1586;1744;0;93860;40721;0;32.4;14.1;0.0
47;2021-05-05;1833;1632;0;95693;42353;0;33.1;14.6;0.0
47;2021-05-06;1962;1518;0;97655;43871;0;33.7;15.2;0.0
47;2021-05-07;1923;1687;0;99578;45558;0;34.4;15.7;0.0
47;2021-05-08;1960;545;0;101538;46103;0;35.1;15.9;0.0
47;2021-05-09;32;362;0;101570;46465;0;35.1;16.1;0.0
47;2021-05-10;1104;1718;0;102674;48183;0;35.5;16.6;0.0
47;2021-05-11;1996;2024;0;104670;50207;0;36.2;17.3;0.0
47;2021-05-12;2342;1476;0;107012;51683;0;37.0;17.9;0.0
47;2021-05-13;1961;604;0;108973;52287;0;37.6;18.1;0.0
47;2021-05-14;1760;841;0;110733;53128;0;38.3;18.4;0.0
47;2021-05-15;1666;850;0;112399;53978;0;38.8;18.6;0.0
47;2021-05-16;310;11;0;112709;53989;0;38.9;18.7;0.0
47;2021-05-17;1679;1163;0;114388;55152;0;39.5;19.1;0.0
47;2021-05-18;2076;1209;0;116464;56361;0;40.2;19.5;0.0
47;2021-05-19;2123;761;0;118587;57122;0;41.0;19.7;0.0
47;2021-05-20;2367;999;0;120954;58121;0;41.8;20.1;0.0
47;2021-05-21;1411;1163;0;122365;59284;0;42.3;20.5;0.0
47;2021-05-22;2145;823;0;124510;60107;0;43.0;20.8;0.0
47;2021-05-23;46;186;0;124556;60293;0;43.0;20.8;0.0
47;2021-05-24;1356;254;0;125912;60547;0;43.5;20.9;0.0
47;2021-05-25;1389;1327;0;127301;61874;0;44.0;21.4;0.0
47;2021-05-26;1519;1117;0;128820;62991;0;44.5;21.8;0.0
47;2021-05-27;1840;1279;0;130660;64270;0;45.1;22.2;0.0
47;2021-05-28;1411;1563;0;132071;65833;0;45.6;22.7;0.0
47;2021-05-29;1054;1110;0;133125;66943;0;46.0;23.1;0.0
47;2021-05-30;27;50;0;133152;66993;0;46.0;23.1;0.0
47;2021-05-31;1769;1395;0;134921;68388;0;46.6;23.6;0.0
47;2021-06-01;1818;1386;0;136739;69774;0;47.2;24.1;0.0
47;2021-06-02;1934;1311;0;138673;71085;0;47.9;24.6;0.0
47;2021-06-03;2307;1592;0;140980;72677;0;48.7;25.1;0.0
47;2021-06-04;1843;2076;0;142823;74753;0;49.3;25.8;0.0
47;2021-06-05;1480;1444;0;144303;76197;0;49.9;26.3;0.0
47;2021-06-06;223;80;0;144526;76277;0;49.9;26.4;0.0
47;2021-06-07;1542;2140;0;146068;78417;0;50.5;27.1;0.0
47;2021-06-08;1547;1826;0;147615;80243;0;51.0;27.7;0.0
47;2021-06-09;1661;2034;0;149276;82277;0;51.6;28.4;0.0
47;2021-06-10;2207;1604;0;151483;83881;0;52.3;29.0;0.0
47;2021-06-11;1731;2036;0;153214;85917;0;52.9;29.7;0.0
47;2021-06-12;1174;2021;0;154388;87938;0;53.3;30.4;0.0
47;2021-06-13;39;26;0;154427;87964;0;53.3;30.4;0.0
47;2021-06-14;1195;2321;0;155622;90285;0;53.8;31.2;0.0
47;2021-06-15;1380;1967;0;157002;92252;0;54.2;31.9;0.0
47;2021-06-16;1111;2068;0;158113;94320;0;54.6;32.6;0.0
47;2021-06-17;1528;1484;0;159641;95804;0;55.1;33.1;0.0
47;2021-06-18;1353;2433;0;160994;98237;0;55.6;33.9;0.0
47;2021-06-19;1349;2202;0;162343;100439;0;56.1;34.7;0.0
47;2021-06-20;22;50;0;162365;100489;0;56.1;34.7;0.0
47;2021-06-21;996;2274;0;163361;102763;0;56.4;35.5;0.0
47;2021-06-22;767;2339;0;164128;105102;0;56.7;36.3;0.0
47;2021-06-23;967;1898;0;165095;107000;0;57.0;37.0;0.0
47;2021-06-24;1163;1858;0;166258;108858;0;57.4;37.6;0.0
47;2021-06-25;941;2445;0;167199;111303;0;57.8;38.5;0.0
47;2021-06-26;878;2422;0;168077;113725;0;58.1;39.3;0.0
47;2021-06-27;24;300;0;168101;114025;0;58.1;39.4;0.0
47;2021-06-28;763;2202;0;168864;116227;0;58.3;40.2;0.0
47;2021-06-29;770;2195;0;169634;118422;0;58.6;40.9;0.0
47;2021-06-30;735;2126;0;170369;120548;0;58.9;41.6;0.0
47;2021-07-01;816;2000;0;171185;122548;0;59.1;42.3;0.0
47;2021-07-02;837;2123;0;172022;124671;0;59.4;43.1;0.0
47;2021-07-03;662;2761;0;172684;127432;0;59.7;44.0;0.0
47;2021-07-04;46;32;0;172730;127464;0;59.7;44.0;0.0
47;2021-07-05;874;2017;0;173604;129481;0;60.0;44.7;0.0
47;2021-07-06;867;1913;0;174471;131394;0;60.3;45.4;0.0
47;2021-07-07;1253;1948;0;175724;133342;0;60.7;46.1;0.0
47;2021-07-08;1066;2091;0;176790;135433;0;61.1;46.8;0.0
47;2021-07-09;969;2277;0;177759;137710;0;61.4;47.6;0.0
47;2021-07-10;830;1896;0;178589;139606;0;61.7;48.2;0.0
47;2021-07-11;13;43;0;178602;139649;0;61.7;48.2;0.0
47;2021-07-12;558;2364;0;179160;142013;0;61.9;49.1;0.0
47;2021-07-13;1046;2396;0;180206;144409;0;62.3;49.9;0.0
47;2021-07-14;974;1395;0;181180;145804;0;62.6;50.4;0.0
47;2021-07-15;1574;2924;0;182754;148728;0;63.1;51.4;0.0
47;2021-07-16;1604;2501;0;184358;151229;0;63.7;52.2;0.0
47;2021-07-17;1134;2212;0;185492;153441;0;64.1;53.0;0.0
47;2021-07-18;71;221;0;185563;153662;0;64.1;53.1;0.0
47;2021-07-19;979;2316;0;186542;155978;0;64.4;53.9;0.0
47;2021-07-20;1503;2244;0;188045;158222;0;65.0;54.7;0.0
47;2021-07-21;1931;2128;0;189976;160350;0;65.6;55.4;0.0
47;2021-07-22;2076;2196;0;192052;162546;0;66.3;56.2;0.0
47;2021-07-23;1975;2063;0;194027;164609;0;67.0;56.9;0.0
47;2021-07-24;1029;1647;0;195056;166256;0;67.4;57.4;0.0
47;2021-07-25;78;47;0;195134;166303;0;67.4;57.5;0.0
47;2021-07-26;1240;1782;0;196374;168085;0;67.8;58.1;0.0
47;2021-07-27;2052;1528;0;198426;169613;0;68.5;58.6;0.0
47;2021-07-28;1797;1616;0;200223;171229;0;69.2;59.2;0.0
47;2021-07-29;2230;1591;0;202453;172820;0;69.9;59.7;0.0
47;2021-07-30;1859;1567;0;204312;174387;0;70.6;60.2;0.0
47;2021-07-31;1322;1444;0;205634;175831;0;71.0;60.7;0.0
47;2021-08-01;66;36;0;205700;175867;0;71.1;60.8;0.0
47;2021-08-02;1853;1127;0;207553;176994;0;71.7;61.1;0.0
47;2021-08-03;1953;1053;0;209506;178047;0;72.4;61.5;0.0
47;2021-08-04;2056;1291;0;211562;179338;0;73.1;62.0;0.0
47;2021-08-05;2216;1323;0;213778;180661;0;73.9;62.4;0.0
47;2021-08-06;1836;1684;0;215614;182345;0;74.5;63.0;0.0
47;2021-08-07;1372;1180;0;216986;183525;0;75.0;63.4;0.0
47;2021-08-08;56;42;0;217042;183567;0;75.0;63.4;0.0
47;2021-08-09;1730;1130;0;218772;184697;0;75.6;63.8;0.0
47;2021-08-10;1753;1195;0;220525;185892;0;76.2;64.2;0.0
47;2021-08-11;1670;1321;0;222195;187213;0;76.8;64.7;0.0
47;2021-08-12;1793;1226;0;223988;188439;0;77.4;65.1;0.0
47;2021-08-13;1295;1514;0;225283;189953;0;77.8;65.6;0.0
47;2021-08-14;1160;1255;0;226443;191208;0;78.2;66.1;0.0
47;2021-08-15;29;43;0;226472;191251;0;78.2;66.1;0.0
47;2021-08-16;1259;1303;0;227731;192554;0;78.7;66.5;0.0
47;2021-08-17;1065;1597;0;228796;194151;0;79.0;67.1;0.0
47;2021-08-18;1143;1678;0;229939;195829;0;79.4;67.7;0.0
47;2021-08-19;942;1645;0;230881;197474;0;79.8;68.2;0.0
47;2021-08-20;926;1658;0;231807;199132;0;80.1;68.8;0.0
47;2021-08-21;748;1193;0;232555;200325;0;80.3;69.2;0.0
47;2021-08-22;23;54;0;232578;200379;0;80.3;69.2;0.0
47;2021-08-23;593;1760;0;233171;202139;0;80.6;69.8;0.0
47;2021-08-24;793;1605;0;233964;203744;0;80.8;70.4;0.0
47;2021-08-25;747;1779;0;234711;205523;0;81.1;71.0;0.0
47;2021-08-26;703;2042;0;235414;207565;0;81.3;71.7;0.0
47;2021-08-27;681;1844;0;236095;209409;0;81.6;72.3;0.0
47;2021-08-28;507;1497;0;236602;210906;0;81.7;72.9;0.0
47;2021-08-29;19;66;0;236621;210972;0;81.7;72.9;0.0
47;2021-08-30;447;1798;19;237068;212770;19;81.9;73.5;0.0
47;2021-08-31;531;1740;27;237599;214510;46;82.1;74.1;0.0
47;2021-09-01;446;1843;64;238045;216353;110;82.2;74.7;0.0
47;2021-09-02;466;1811;81;238511;218164;191;82.4;75.4;0.1
47;2021-09-03;507;1699;114;239018;219863;305;82.6;76.0;0.1
47;2021-09-04;440;1484;76;239458;221347;381;82.7;76.5;0.1
47;2021-09-05;19;58;2;239477;221405;383;82.7;76.5;0.1
47;2021-09-06;346;1211;171;239823;222616;554;82.8;76.9;0.2
47;2021-09-07;452;1073;159;240275;223689;713;83.0;77.3;0.2
47;2021-09-08;420;1406;142;240695;225095;855;83.2;77.8;0.3
47;2021-09-09;418;1017;249;241113;226112;1104;83.3;78.1;0.4
47;2021-09-10;455;1147;183;241568;227259;1287;83.5;78.5;0.4
47;2021-09-11;380;1233;57;241948;228492;1344;83.6;78.9;0.5
47;2021-09-12;6;18;2;241954;228510;1346;83.6;78.9;0.5
47;2021-09-13;253;772;267;242207;229282;1613;83.7;79.2;0.6
47;2021-09-14;389;764;357;242596;230046;1970;83.8;79.5;0.7
47;2021-09-15;329;868;192;242925;230914;2162;83.9;79.8;0.7
47;2021-09-16;333;559;396;243258;231473;2558;84.0;80.0;0.9
47;2021-09-17;377;652;224;243635;232125;2782;84.2;80.2;1.0
47;2021-09-18;237;881;78;243872;233006;2860;84.2;80.5;1.0
47;2021-09-19;7;14;6;243879;233020;2866;84.3;80.5;1.0
47;2021-09-20;181;498;365;244060;233518;3231;84.3;80.7;1.1
47;2021-09-21;250;397;358;244310;233915;3589;84.4;80.8;1.2
47;2021-09-22;202;607;269;244512;234522;3858;84.5;81.0;1.3
47;2021-09-23;192;387;423;244704;234909;4281;84.5;81.2;1.5
47;2021-09-24;270;606;324;244974;235515;4605;84.6;81.4;1.6
47;2021-09-25;181;561;80;245155;236076;4685;84.7;81.6;1.6
47;2021-09-26;3;9;3;245158;236085;4688;84.7;81.6;1.6
47;2021-09-27;111;375;161;245269;236460;4849;84.7;81.7;1.7
47;2021-09-28;129;358;227;245398;236818;5076;84.8;81.8;1.8
47;2021-09-29;158;443;211;245556;237261;5287;84.8;82.0;1.8
47;2021-09-30;161;354;386;245717;237615;5673;84.9;82.1;2.0
47;2021-10-01;227;520;207;245944;238135;5880;85.0;82.3;2.0
47;2021-10-02;191;433;120;246135;238568;6000;85.0;82.4;2.1
47;2021-10-03;0;6;0;246135;238574;6000;85.0;82.4;2.1
47;2021-10-04;134;327;291;246269;238901;6291;85.1;82.5;2.2
47;2021-10-05;114;309;226;246383;239210;6517;85.1;82.6;2.3
47;2021-10-06;217;415;275;246600;239625;6792;85.2;82.8;2.3
47;2021-10-07;144;358;343;246744;239983;7135;85.2;82.9;2.5
47;2021-10-08;179;397;315;246923;240380;7450;85.3;83.0;2.6
47;2021-10-09;214;327;193;247137;240707;7643;85.4;83.2;2.6
47;2021-10-10;1;9;14;247138;240716;7657;85.4;83.2;2.6
47;2021-10-11;127;214;296;247265;240930;7953;85.4;83.2;2.7
47;2021-10-12;124;262;381;247389;241192;8334;85.5;83.3;2.9
47;2021-10-13;139;262;255;247528;241454;8589;85.5;83.4;3.0
47;2021-10-14;92;209;311;247620;241663;8900;85.5;83.5;3.1
47;2021-10-15;162;353;409;247782;242016;9309;85.6;83.6;3.2
47;2021-10-16;175;223;246;247957;242239;9555;85.7;83.7;3.3
47;2021-10-17;1;7;4;247958;242246;9559;85.7;83.7;3.3
47;2021-10-18;125;200;445;248083;242446;10004;85.7;83.8;3.5
47;2021-10-19;114;180;393;248197;242626;10397;85.7;83.8;3.6
47;2021-10-20;134;174;432;248331;242800;10829;85.8;83.9;3.7
47;2021-10-21;107;135;435;248438;242935;11264;85.8;83.9;3.9
47;2021-10-22;117;188;494;248555;243123;11758;85.9;84.0;4.1
47;2021-10-23;158;221;311;248713;243344;12069;85.9;84.1;4.2
47;2021-10-24;2;7;4;248715;243351;12073;85.9;84.1;4.2
47;2021-10-25;116;149;488;248831;243500;12561;86.0;84.1;4.3
47;2021-10-26;83;140;618;248914;243640;13179;86.0;84.2;4.6
47;2021-10-27;132;179;520;249046;243819;13699;86.0;84.2;4.7
47;2021-10-28;88;154;477;249134;243973;14176;86.1;84.3;4.9
47;2021-10-29;89;177;640;249223;244150;14816;86.1;84.3;5.1
47;2021-10-30;83;200;328;249306;244350;15144;86.1;84.4;5.2
47;2021-10-31;0;4;5;249306;244354;15149;86.1;84.4;5.2
47;2021-11-01;21;15;105;249327;244369;15254;86.1;84.4;5.3
47;2021-11-02;117;147;635;249444;244516;15889;86.2;84.5;5.5
47;2021-11-03;96;176;709;249540;244692;16598;86.2;84.5;5.7
47;2021-11-04;89;117;781;249629;244809;17379;86.2;84.6;6.0
47;2021-11-05;118;163;783;249747;244972;18162;86.3;84.6;6.3
47;2021-11-06;115;208;484;249862;245180;18646;86.3;84.7;6.4
47;2021-11-07;2;13;16;249864;245193;18662;86.3;84.7;6.4
47;2021-11-08;64;139;846;249928;245332;19508;86.3;84.8;6.7
47;2021-11-09;99;150;1101;250027;245482;20609;86.4;84.8;7.1
47;2021-11-10;113;175;987;250140;245657;21596;86.4;84.9;7.5
47;2021-11-11;39;29;283;250179;245686;21879;86.4;84.9;7.6
47;2021-11-12;90;144;1075;250269;245830;22954;86.5;84.9;7.9
47;2021-11-13;114;169;560;250383;245999;23514;86.5;85.0;8.1
47;2021-11-14;1;6;17;250384;246005;23531;86.5;85.0;8.1
47;2021-11-15;82;104;1469;250466;246109;25000;86.5;85.0;8.6
47;2021-11-16;97;130;1592;250563;246239;26592;86.6;85.1;9.2
47;2021-11-17;139;143;1176;250702;246382;27768;86.6;85.1;9.6
47;2021-11-18;88;89;1146;250790;246471;28914;86.6;85.1;10.0
47;2021-11-19;126;125;1398;250916;246596;30312;86.7;85.2;10.5
47;2021-11-20;144;148;844;251060;246744;31156;86.7;85.2;10.8
47;2021-11-21;8;10;20;251068;246754;31176;86.7;85.2;10.8
47;2021-11-22;69;59;1052;251137;246813;32228;86.8;85.3;11.1
47;2021-11-23;117;88;1704;251254;246901;33932;86.8;85.3;11.7
47;2021-11-24;154;154;1362;251408;247055;35294;86.9;85.3;12.2
47;2021-11-25;127;98;1524;251535;247153;36818;86.9;85.4;12.7
47;2021-11-26;128;130;1855;251663;247283;38673;86.9;85.4;13.4
47;2021-11-27;140;140;1553;251803;247423;40226;87.0;85.5;13.9
47;2021-11-28;9;9;168;251812;247432;40394;87.0;85.5;14.0
47;2021-11-29;84;91;2321;251896;247523;42715;87.0;85.5;14.8
47;2021-11-30;131;127;3115;252027;247650;45830;87.1;85.6;15.8
47;2021-12-01;111;132;2782;252138;247782;48612;87.1;85.6;16.8
47;2021-12-02;116;92;2970;252254;247874;51582;87.1;85.6;17.8
47;2021-12-03;123;119;3325;252377;247993;54907;87.2;85.7;19.0
47;2021-12-04;86;127;2195;252463;248120;57102;87.2;85.7;19.7
47;2021-12-05;62;23;1212;252525;248143;58314;87.2;85.7;20.1
47;2021-12-06;87;90;2842;252612;248233;61156;87.3;85.8;21.1
47;2021-12-07;122;118;4164;252734;248351;65320;87.3;85.8;22.6
47;2021-12-08;124;135;3474;252858;248486;68794;87.4;85.8;23.8
47;2021-12-09;121;105;3609;252979;248591;72403;87.4;85.9;25.0
47;2021-12-10;133;145;3744;253112;248736;76147;87.4;85.9;26.3
47;2021-12-11;109;141;2990;253221;248877;79137;87.5;86.0;27.3
47;2021-12-12;9;9;344;253230;248886;79481;87.5;86.0;27.5
47;2021-12-13;96;108;3162;253326;248994;82643;87.5;86.0;28.5
47;2021-12-14;118;136;4084;253444;249130;86727;87.6;86.1;30.0
47;2021-12-15;125;171;3184;253569;249301;89911;87.6;86.1;31.1
47;2021-12-16;134;132;3921;253703;249433;93832;87.6;86.2;32.4
47;2021-12-17;138;176;4218;253841;249609;98050;87.7;86.2;33.9
47;2021-12-18;159;175;2823;254000;249784;100873;87.7;86.3;34.8
47;2021-12-19;50;24;1017;254050;249808;101890;87.8;86.3;35.2
48;2020-12-27;0;0;0;0;0;0;0.0;0.0;0.0
48;2020-12-28;0;0;0;0;0;0;0.0;0.0;0.0
48;2020-12-29;1;0;0;1;0;0;0.0;0.0;0.0
48;2020-12-30;0;0;0;1;0;0;0.0;0.0;0.0
48;2020-12-31;0;0;0;1;0;0;0.0;0.0;0.0
48;2021-01-01;1;0;0;2;0;0;0.0;0.0;0.0
48;2021-01-02;0;0;0;2;0;0;0.0;0.0;0.0
48;2021-01-03;0;0;0;2;0;0;0.0;0.0;0.0
48;2021-01-04;1;0;0;3;0;0;0.0;0.0;0.0
48;2021-01-05;0;0;0;3;0;0;0.0;0.0;0.0
48;2021-01-06;0;0;0;3;0;0;0.0;0.0;0.0
48;2021-01-07;53;0;0;56;0;0;0.1;0.0;0.0
48;2021-01-08;88;1;0;144;1;0;0.2;0.0;0.0
48;2021-01-09;1;0;0;145;1;0;0.2;0.0;0.0
48;2021-01-10;0;0;0;145;1;0;0.2;0.0;0.0
48;2021-01-11;14;0;0;159;1;0;0.2;0.0;0.0
48;2021-01-12;24;1;0;183;2;0;0.3;0.0;0.0
48;2021-01-13;89;0;0;272;2;0;0.4;0.0;0.0
48;2021-01-14;94;1;0;366;3;0;0.5;0.0;0.0
48;2021-01-15;62;0;0;428;3;0;0.6;0.0;0.0
48;2021-01-16;0;0;0;428;3;0;0.6;0.0;0.0
48;2021-01-17;0;0;0;428;3;0;0.6;0.0;0.0
48;2021-01-18;116;0;0;544;3;0;0.8;0.0;0.0
48;2021-01-19;297;2;0;841;5;0;1.2;0.0;0.0
48;2021-01-20;260;0;0;1101;5;0;1.6;0.0;0.0
48;2021-01-21;437;1;0;1538;6;0;2.3;0.0;0.0
48;2021-01-22;236;0;0;1774;6;0;2.6;0.0;0.0
48;2021-01-23;45;0;0;1819;6;0;2.7;0.0;0.0
48;2021-01-24;2;0;0;1821;6;0;2.7;0.0;0.0
48;2021-01-25;119;2;0;1940;8;0;2.9;0.0;0.0
48;2021-01-26;254;0;0;2194;8;0;3.2;0.0;0.0
48;2021-01-27;243;2;0;2437;10;0;3.6;0.0;0.0
48;2021-01-28;220;10;0;2657;20;0;3.9;0.0;0.0
48;2021-01-29;180;59;0;2837;79;0;4.2;0.1;0.0
48;2021-01-30;11;7;0;2848;86;0;4.2;0.1;0.0
48;2021-01-31;0;7;0;2848;93;0;4.2;0.1;0.0
48;2021-02-01;89;45;0;2937;138;0;4.3;0.2;0.0
48;2021-02-02;191;38;0;3128;176;0;4.6;0.3;0.0
48;2021-02-03;186;73;0;3314;249;0;4.9;0.4;0.0
48;2021-02-04;211;14;0;3525;263;0;5.2;0.4;0.0
48;2021-02-05;150;40;0;3675;303;0;5.4;0.4;0.0
48;2021-02-06;31;1;0;3706;304;0;5.5;0.4;0.0
48;2021-02-07;0;0;0;3706;304;0;5.5;0.4;0.0
48;2021-02-08;49;60;0;3755;364;0;5.6;0.5;0.0
48;2021-02-09;84;135;0;3839;499;0;5.7;0.7;0.0
48;2021-02-10;85;183;0;3924;682;0;5.8;1.0;0.0
48;2021-02-11;153;371;0;4077;1053;0;6.0;1.6;0.0
48;2021-02-12;125;148;0;4202;1201;0;6.2;1.8;0.0
48;2021-02-13;20;54;0;4222;1255;0;6.2;1.9;0.0
48;2021-02-14;0;0;0;4222;1255;0;6.2;1.9;0.0
48;2021-02-15;57;103;0;4279;1358;0;6.3;2.0;0.0
48;2021-02-16;65;150;0;4344;1508;0;6.4;2.2;0.0
48;2021-02-17;58;217;0;4402;1725;0;6.5;2.6;0.0
48;2021-02-18;221;118;0;4623;1843;0;6.8;2.7;0.0
48;2021-02-19;81;178;0;4704;2021;0;7.0;3.0;0.0
48;2021-02-20;1;5;0;4705;2026;0;7.0;3.0;0.0
48;2021-02-21;0;14;0;4705;2040;0;7.0;3.0;0.0
48;2021-02-22;29;118;0;4734;2158;0;7.0;3.2;0.0
48;2021-02-23;52;225;0;4786;2383;0;7.1;3.5;0.0
48;2021-02-24;66;284;0;4852;2667;0;7.2;3.9;0.0
48;2021-02-25;143;239;0;4995;2906;0;7.4;4.3;0.0
48;2021-02-26;57;228;0;5052;3134;0;7.5;4.6;0.0
48;2021-02-27;28;4;0;5080;3138;0;7.5;4.6;0.0
48;2021-02-28;3;13;0;5083;3151;0;7.5;4.7;0.0
48;2021-03-01;108;98;0;5191;3249;0;7.7;4.8;0.0
48;2021-03-02;198;90;0;5389;3339;0;8.0;4.9;0.0
48;2021-03-03;152;109;0;5541;3448;0;8.2;5.1;0.0
48;2021-03-04;211;176;0;5752;3624;0;8.5;5.4;0.0
48;2021-03-05;156;133;0;5908;3757;0;8.7;5.6;0.0
48;2021-03-06;200;53;0;6108;3810;0;9.0;5.6;0.0
48;2021-03-07;57;1;0;6165;3811;0;9.1;5.6;0.0
48;2021-03-08;244;115;0;6409;3926;0;9.5;5.8;0.0
48;2021-03-09;354;94;0;6763;4020;0;10.0;5.9;0.0
48;2021-03-10;228;60;0;6991;4080;0;10.3;6.0;0.0
48;2021-03-11;320;88;0;7311;4168;0;10.8;6.2;0.0
48;2021-03-12;271;131;0;7582;4299;0;11.2;6.4;0.0
48;2021-03-13;311;10;0;7893;4309;0;11.7;6.4;0.0
48;2021-03-14;9;0;0;7902;4309;0;11.7;6.4;0.0
48;2021-03-15;172;68;0;8074;4377;0;11.9;6.5;0.0
48;2021-03-16;179;70;0;8253;4447;0;12.2;6.6;0.0
48;2021-03-17;176;103;0;8429;4550;0;12.5;6.7;0.0
48;2021-03-18;178;97;0;8607;4647;0;12.7;6.9;0.0
48;2021-03-19;140;87;0;8747;4734;0;12.9;7.0;0.0
48;2021-03-20;141;5;0;8888;4739;0;13.2;7.0;0.0
48;2021-03-21;2;0;0;8890;4739;0;13.2;7.0;0.0
48;2021-03-22;172;23;0;9062;4762;0;13.4;7.0;0.0
48;2021-03-23;341;98;0;9403;4860;0;13.9;7.2;0.0
48;2021-03-24;363;99;0;9766;4959;0;14.5;7.3;0.0
48;2021-03-25;731;115;0;10497;5074;0;15.5;7.5;0.0
48;2021-03-26;291;65;0;10788;5139;0;16.0;7.6;0.0
48;2021-03-27;108;2;0;10896;5141;0;16.1;7.6;0.0
48;2021-03-28;69;12;0;10965;5153;0;16.2;7.6;0.0
48;2021-03-29;310;86;0;11275;5239;0;16.7;7.8;0.0
48;2021-03-30;361;151;0;11636;5390;0;17.2;8.0;0.0
48;2021-03-31;484;96;0;12120;5486;0;17.9;8.1;0.0
48;2021-04-01;736;85;0;12856;5571;0;19.0;8.2;0.0
48;2021-04-02;508;133;0;13364;5704;0;19.8;8.4;0.0
48;2021-04-03;153;93;0;13517;5797;0;20.0;8.6;0.0
48;2021-04-04;2;1;0;13519;5798;0;20.0;8.6;0.0
48;2021-04-05;54;1;0;13573;5799;0;20.1;8.6;0.0
48;2021-04-06;473;165;0;14046;5964;0;20.8;8.8;0.0
48;2021-04-07;435;146;0;14481;6110;0;21.4;9.0;0.0
48;2021-04-08;628;188;0;15109;6298;0;22.4;9.3;0.0
48;2021-04-09;470;138;0;15579;6436;0;23.1;9.5;0.0
48;2021-04-10;127;71;0;15706;6507;0;23.2;9.6;0.0
48;2021-04-11;3;0;0;15709;6507;0;23.2;9.6;0.0
48;2021-04-12;389;79;0;16098;6586;0;23.8;9.7;0.0
48;2021-04-13;358;120;0;16456;6706;0;24.3;9.9;0.0
48;2021-04-14;594;207;0;17050;6913;0;25.2;10.2;0.0
48;2021-04-15;638;352;0;17688;7265;0;26.2;10.7;0.0
48;2021-04-16;489;210;0;18177;7475;0;26.9;11.1;0.0
48;2021-04-17;92;83;0;18269;7558;0;27.0;11.2;0.0
48;2021-04-18;4;0;0;18273;7558;0;27.0;11.2;0.0
48;2021-04-19;223;110;0;18496;7668;0;27.4;11.3;0.0
48;2021-04-20;224;203;0;18720;7871;0;27.7;11.6;0.0
48;2021-04-21;302;280;0;19022;8151;0;28.1;12.1;0.0
48;2021-04-22;302;485;0;19324;8636;0;28.6;12.8;0.0
48;2021-04-23;251;274;0;19575;8910;0;29.0;13.2;0.0
48;2021-04-24;117;104;0;19692;9014;0;29.1;13.3;0.0
48;2021-04-25;6;13;0;19698;9027;0;29.1;13.4;0.0
48;2021-04-26;129;237;0;19827;9264;0;29.3;13.7;0.0
48;2021-04-27;200;309;0;20027;9573;0;29.6;14.2;0.0
48;2021-04-28;171;446;0;20198;10019;0;29.9;14.8;0.0
48;2021-04-29;220;509;0;20418;10528;0;30.2;15.6;0.0
48;2021-04-30;206;259;0;20624;10787;0;30.5;16.0;0.0
48;2021-05-01;77;9;0;20701;10796;0;30.6;16.0;0.0
48;2021-05-02;1;0;0;20702;10796;0;30.6;16.0;0.0
48;2021-05-03;136;400;0;20838;11196;0;30.8;16.6;0.0
48;2021-05-04;223;410;0;21061;11606;0;31.2;17.2;0.0
48;2021-05-05;119;494;0;21180;12100;0;31.3;17.9;0.0
48;2021-05-06;751;613;0;21931;12713;0;32.5;18.8;0.0
48;2021-05-07;141;511;0;22072;13224;0;32.7;19.6;0.0
48;2021-05-08;325;51;0;22397;13275;0;33.1;19.6;0.0
48;2021-05-09;262;11;0;22659;13286;0;33.5;19.7;0.0
48;2021-05-10;137;349;0;22796;13635;0;33.7;20.2;0.0
48;2021-05-11;259;294;0;23055;13929;0;34.1;20.6;0.0
48;2021-05-12;308;299;0;23363;14228;0;34.6;21.1;0.0
48;2021-05-13;452;155;0;23815;14383;0;35.2;21.3;0.0
48;2021-05-14;283;242;0;24098;14625;0;35.7;21.6;0.0
48;2021-05-15;143;59;0;24241;14684;0;35.9;21.7;0.0
48;2021-05-16;30;7;0;24271;14691;0;35.9;21.7;0.0
48;2021-05-17;490;270;0;24761;14961;0;36.6;22.1;0.0
48;2021-05-18;318;256;0;25079;15217;0;37.1;22.5;0.0
48;2021-05-19;294;304;0;25373;15521;0;37.5;23.0;0.0
48;2021-05-20;400;265;0;25773;15786;0;38.1;23.4;0.0
48;2021-05-21;238;276;0;26011;16062;0;38.5;23.8;0.0
48;2021-05-22;87;54;0;26098;16116;0;38.6;23.8;0.0
48;2021-05-23;7;7;0;26105;16123;0;38.6;23.9;0.0
48;2021-05-24;71;24;0;26176;16147;0;38.7;23.9;0.0
48;2021-05-25;247;291;0;26423;16438;0;39.1;24.3;0.0
48;2021-05-26;476;286;0;26899;16724;0;39.8;24.7;0.0
48;2021-05-27;1238;353;0;28137;17077;0;41.6;25.3;0.0
48;2021-05-28;365;335;0;28502;17412;0;42.2;25.8;0.0
48;2021-05-29;204;100;0;28706;17512;0;42.5;25.9;0.0
48;2021-05-30;7;8;0;28713;17520;0;42.5;25.9;0.0
48;2021-05-31;658;222;0;29371;17742;0;43.5;26.3;0.0
48;2021-06-01;316;288;0;29687;18030;0;43.9;26.7;0.0
48;2021-06-02;444;381;0;30131;18411;0;44.6;27.2;0.0
48;2021-06-03;638;379;0;30769;18790;0;45.5;27.8;0.0
48;2021-06-04;324;286;0;31093;19076;0;46.0;28.2;0.0
48;2021-06-05;160;100;0;31253;19176;0;46.2;28.4;0.0
48;2021-06-06;13;1;0;31266;19177;0;46.3;28.4;0.0
48;2021-06-07;397;159;0;31663;19336;0;46.9;28.6;0.0
48;2021-06-08;650;336;0;32313;19672;0;47.8;29.1;0.0
48;2021-06-09;381;232;0;32694;19904;0;48.4;29.5;0.0
48;2021-06-10;926;230;0;33620;20134;0;49.7;29.8;0.0
48;2021-06-11;382;192;0;34002;20326;0;50.3;30.1;0.0
48;2021-06-12;110;80;0;34112;20406;0;50.5;30.2;0.0
48;2021-06-13;12;6;0;34124;20412;0;50.5;30.2;0.0
48;2021-06-14;140;153;0;34264;20565;0;50.7;30.4;0.0
48;2021-06-15;402;393;0;34666;20958;0;51.3;31.0;0.0
48;2021-06-16;253;179;0;34919;21137;0;51.7;31.3;0.0
48;2021-06-17;453;561;0;35372;21698;0;52.3;32.1;0.0
48;2021-06-18;268;319;0;35640;22017;0;52.7;32.6;0.0
48;2021-06-19;65;321;0;35705;22338;0;52.8;33.1;0.0
48;2021-06-20;111;214;0;35816;22552;0;53.0;33.4;0.0
48;2021-06-21;140;226;0;35956;22778;0;53.2;33.7;0.0
48;2021-06-22;246;379;0;36202;23157;0;53.6;34.3;0.0
48;2021-06-23;110;583;0;36312;23740;0;53.7;35.1;0.0
48;2021-06-24;316;557;0;36628;24297;0;54.2;36.0;0.0
48;2021-06-25;130;279;0;36758;24576;0;54.4;36.4;0.0
48;2021-06-26;29;91;0;36787;24667;0;54.4;36.5;0.0
48;2021-06-27;1;20;0;36788;24687;0;54.4;36.5;0.0
48;2021-06-28;91;262;0;36879;24949;0;54.6;36.9;0.0
48;2021-06-29;297;479;0;37176;25428;0;55.0;37.6;0.0
48;2021-06-30;116;530;0;37292;25958;0;55.2;38.4;0.0
48;2021-07-01;192;631;0;37484;26589;0;55.5;39.3;0.0
48;2021-07-02;161;385;0;37645;26974;0;55.7;39.9;0.0
48;2021-07-03;56;146;0;37701;27120;0;55.8;40.1;0.0
48;2021-07-04;10;7;0;37711;27127;0;55.8;40.1;0.0
48;2021-07-05;78;245;0;37789;27372;0;55.9;40.5;0.0
48;2021-07-06;298;626;0;38087;27998;0;56.4;41.4;0.0
48;2021-07-07;210;523;0;38297;28521;0;56.7;42.2;0.0
48;2021-07-08;227;1171;0;38524;29692;0;57.0;43.9;0.0
48;2021-07-09;165;564;0;38689;30256;0;57.2;44.8;0.0
48;2021-07-10;90;212;0;38779;30468;0;57.4;45.1;0.0
48;2021-07-11;2;19;0;38781;30487;0;57.4;45.1;0.0
48;2021-07-12;152;710;0;38933;31197;0;57.6;46.2;0.0
48;2021-07-13;214;464;0;39147;31661;0;57.9;46.8;0.0
48;2021-07-14;152;126;0;39299;31787;0;58.2;47.0;0.0
48;2021-07-15;232;463;0;39531;32250;0;58.5;47.7;0.0
48;2021-07-16;323;372;0;39854;32622;0;59.0;48.3;0.0
48;2021-07-17;180;165;0;40034;32787;0;59.2;48.5;0.0
48;2021-07-18;10;16;0;40044;32803;0;59.3;48.5;0.0
48;2021-07-19;186;324;0;40230;33127;0;59.5;49.0;0.0
48;2021-07-20;695;1004;0;40925;34131;0;60.6;50.5;0.0
48;2021-07-21;155;341;0;41080;34472;0;60.8;51.0;0.0
48;2021-07-22;749;1008;0;41829;35480;0;61.9;52.5;0.0
48;2021-07-23;432;456;0;42261;35936;0;62.5;53.2;0.0
48;2021-07-24;490;200;0;42751;36136;0;63.3;53.5;0.0
48;2021-07-25;145;51;0;42896;36187;0;63.5;53.5;0.0
48;2021-07-26;238;267;0;43134;36454;0;63.8;53.9;0.0
48;2021-07-27;1094;613;0;44228;37067;0;65.4;54.8;0.0
48;2021-07-28;253;314;0;44481;37381;0;65.8;55.3;0.0
48;2021-07-29;691;594;0;45172;37975;0;66.8;56.2;0.0
48;2021-07-30;290;303;0;45462;38278;0;67.3;56.6;0.0
48;2021-07-31;325;167;0;45787;38445;0;67.8;56.9;0.0
48;2021-08-01;34;37;0;45821;38482;0;67.8;56.9;0.0
48;2021-08-02;262;189;0;46083;38671;0;68.2;57.2;0.0
48;2021-08-03;782;483;0;46865;39154;0;69.3;57.9;0.0
48;2021-08-04;312;185;0;47177;39339;0;69.8;58.2;0.0
48;2021-08-05;527;404;0;47704;39743;0;70.6;58.8;0.0
48;2021-08-06;436;315;0;48140;40058;0;71.2;59.3;0.0
48;2021-08-07;242;132;0;48382;40190;0;71.6;59.5;0.0
48;2021-08-08;11;20;0;48393;40210;0;71.6;59.5;0.0
48;2021-08-09;185;191;0;48578;40401;0;71.9;59.8;0.0
48;2021-08-10;589;477;0;49167;40878;0;72.8;60.5;0.0
48;2021-08-11;276;234;0;49443;41112;0;73.2;60.8;0.0
48;2021-08-12;343;389;0;49786;41501;0;73.7;61.4;0.0
48;2021-08-13;237;267;0;50023;41768;0;74.0;61.8;0.0
48;2021-08-14;130;188;0;50153;41956;0;74.2;62.1;0.0
48;2021-08-15;89;49;0;50242;42005;0;74.3;62.2;0.0
48;2021-08-16;125;271;0;50367;42276;0;74.5;62.6;0.0
48;2021-08-17;310;1072;0;50677;43348;0;75.0;64.1;0.0
48;2021-08-18;176;246;0;50853;43594;0;75.2;64.5;0.0
48;2021-08-19;222;342;0;51075;43936;0;75.6;65.0;0.0
48;2021-08-20;211;300;0;51286;44236;0;75.9;65.5;0.0
48;2021-08-21;75;255;0;51361;44491;0;76.0;65.8;0.0
48;2021-08-22;5;17;0;51366;44508;0;76.0;65.9;0.0
48;2021-08-23;76;241;0;51442;44749;0;76.1;66.2;0.0
48;2021-08-24;281;859;0;51723;45608;0;76.5;67.5;0.0
48;2021-08-25;160;369;0;51883;45977;0;76.8;68.0;0.0
48;2021-08-26;168;439;0;52051;46416;0;77.0;68.7;0.0
48;2021-08-27;147;369;0;52198;46785;0;77.2;69.2;0.0
48;2021-08-28;121;306;0;52319;47091;0;77.4;69.7;0.0
48;2021-08-29;0;6;0;52319;47097;0;77.4;69.7;0.0
48;2021-08-30;71;188;5;52390;47285;5;77.5;70.0;0.0
48;2021-08-31;245;957;15;52635;48242;20;77.9;71.4;0.0
48;2021-09-01;129;345;15;52764;48587;35;78.1;71.9;0.1
48;2021-09-02;132;352;15;52896;48939;50;78.3;72.4;0.1
48;2021-09-03;125;328;30;53021;49267;80;78.5;72.9;0.1
48;2021-09-04;113;204;33;53134;49471;113;78.6;73.2;0.2
48;2021-09-05;7;68;0;53141;49539;113;78.6;73.3;0.2
48;2021-09-06;36;147;19;53177;49686;132;78.7;73.5;0.2
48;2021-09-07;136;319;39;53313;50005;171;78.9;74.0;0.3
48;2021-09-08;94;182;29;53407;50187;200;79.0;74.3;0.3
48;2021-09-09;89;216;63;53496;50403;263;79.2;74.6;0.4
48;2021-09-10;127;252;126;53623;50655;389;79.3;75.0;0.6
48;2021-09-11;89;188;26;53712;50843;415;79.5;75.2;0.6
48;2021-09-12;3;2;1;53715;50845;416;79.5;75.2;0.6
48;2021-09-13;77;79;80;53792;50924;496;79.6;75.4;0.7
48;2021-09-14;157;240;98;53949;51164;594;79.8;75.7;0.9
48;2021-09-15;68;178;60;54017;51342;654;79.9;76.0;1.0
48;2021-09-16;104;193;72;54121;51535;726;80.1;76.3;1.1
48;2021-09-17;102;181;79;54223;51716;805;80.2;76.5;1.2
48;2021-09-18;32;93;13;54255;51809;818;80.3;76.7;1.2
48;2021-09-19;0;2;4;54255;51811;822;80.3;76.7;1.2
48;2021-09-20;36;87;126;54291;51898;948;80.3;76.8;1.4
48;2021-09-21;56;170;135;54347;52068;1083;80.4;77.0;1.6
48;2021-09-22;51;153;57;54398;52221;1140;80.5;77.3;1.7
48;2021-09-23;32;95;58;54430;52316;1198;80.5;77.4;1.8
48;2021-09-24;45;116;80;54475;52432;1278;80.6;77.6;1.9
48;2021-09-25;23;82;15;54498;52514;1293;80.6;77.7;1.9
48;2021-09-26;1;6;0;54499;52520;1293;80.6;77.7;1.9
48;2021-09-27;15;44;59;54514;52564;1352;80.7;77.8;2.0
48;2021-09-28;61;137;156;54575;52701;1508;80.8;78.0;2.2
48;2021-09-29;48;124;69;54623;52825;1577;80.8;78.2;2.3
48;2021-09-30;29;81;127;54652;52906;1704;80.9;78.3;2.5
48;2021-10-01;53;128;78;54705;53034;1782;80.9;78.5;2.6
48;2021-10-02;34;50;27;54739;53084;1809;81.0;78.5;2.7
48;2021-10-03;0;1;0;54739;53085;1809;81.0;78.5;2.7
48;2021-10-04;14;63;36;54753;53148;1845;81.0;78.6;2.7
48;2021-10-05;42;119;59;54795;53267;1904;81.1;78.8;2.8
48;2021-10-06;57;82;196;54852;53349;2100;81.2;78.9;3.1
48;2021-10-07;29;99;162;54881;53448;2262;81.2;79.1;3.3
48;2021-10-08;42;127;114;54923;53575;2376;81.3;79.3;3.5
48;2021-10-09;16;64;42;54939;53639;2418;81.3;79.4;3.6
48;2021-10-10;0;1;0;54939;53640;2418;81.3;79.4;3.6
48;2021-10-11;7;28;55;54946;53668;2473;81.3;79.4;3.7
48;2021-10-12;24;70;126;54970;53738;2599;81.3;79.5;3.8
48;2021-10-13;37;85;146;55007;53823;2745;81.4;79.6;4.1
48;2021-10-14;39;60;75;55046;53883;2820;81.5;79.7;4.2
48;2021-10-15;28;50;148;55074;53933;2968;81.5;79.8;4.4
48;2021-10-16;10;19;27;55084;53952;2995;81.5;79.8;4.4
48;2021-10-17;3;3;3;55087;53955;2998;81.5;79.8;4.4
48;2021-10-18;9;20;83;55096;53975;3081;81.5;79.9;4.6
48;2021-10-19;33;49;121;55129;54024;3202;81.6;79.9;4.7
48;2021-10-20;43;43;168;55172;54067;3370;81.6;80.0;5.0
48;2021-10-21;17;38;178;55189;54105;3548;81.7;80.1;5.2
48;2021-10-22;30;63;130;55219;54168;3678;81.7;80.2;5.4
48;2021-10-23;26;30;42;55245;54198;3720;81.7;80.2;5.5
48;2021-10-24;0;0;0;55245;54198;3720;81.7;80.2;5.5
48;2021-10-25;16;16;79;55261;54214;3799;81.8;80.2;5.6
48;2021-10-26;35;38;145;55296;54252;3944;81.8;80.3;5.8
48;2021-10-27;36;66;199;55332;54318;4143;81.9;80.4;6.1
48;2021-10-28;31;29;294;55363;54347;4437;81.9;80.4;6.6
48;2021-10-29;21;28;148;55384;54375;4585;82.0;80.5;6.8
48;2021-10-30;7;18;30;55391;54393;4615;82.0;80.5;6.8
48;2021-10-31;0;2;0;55391;54395;4615;82.0;80.5;6.8
48;2021-11-01;3;1;2;55394;54396;4617;82.0;80.5;6.8
48;2021-11-02;27;32;124;55421;54428;4741;82.0;80.5;7.0
48;2021-11-03;20;38;142;55441;54466;4883;82.0;80.6;7.2
48;2021-11-04;28;36;165;55469;54502;5048;82.1;80.6;7.5
48;2021-11-05;15;25;119;55484;54527;5167;82.1;80.7;7.6
48;2021-11-06;16;19;66;55500;54546;5233;82.1;80.7;7.7
48;2021-11-07;2;1;0;55502;54547;5233;82.1;80.7;7.7
48;2021-11-08;8;17;53;55510;54564;5286;82.1;80.7;7.8
48;2021-11-09;37;55;277;55547;54619;5563;82.2;80.8;8.2
48;2021-11-10;25;51;305;55572;54670;5868;82.2;80.9;8.7
48;2021-11-11;1;4;41;55573;54674;5909;82.2;80.9;8.7
48;2021-11-12;17;41;220;55590;54715;6129;82.3;81.0;9.1
48;2021-11-13;14;20;74;55604;54735;6203;82.3;81.0;9.2
48;2021-11-14;0;0;3;55604;54735;6206;82.3;81.0;9.2
48;2021-11-15;7;10;154;55611;54745;6360;82.3;81.0;9.4
48;2021-11-16;29;37;367;55640;54782;6727;82.3;81.1;10.0
48;2021-11-17;24;30;348;55664;54812;7075;82.4;81.1;10.5
48;2021-11-18;20;29;440;55684;54841;7515;82.4;81.1;11.1
48;2021-11-19;25;28;318;55709;54869;7833;82.4;81.2;11.6
48;2021-11-20;33;16;118;55742;54885;7951;82.5;81.2;11.8
48;2021-11-21;0;1;1;55742;54886;7952;82.5;81.2;11.8
48;2021-11-22;7;11;235;55749;54897;8187;82.5;81.2;12.1
48;2021-11-23;34;20;321;55783;54917;8508;82.5;81.3;12.6
48;2021-11-24;36;32;322;55819;54949;8830;82.6;81.3;13.1
48;2021-11-25;27;27;441;55846;54976;9271;82.6;81.3;13.7
48;2021-11-26;35;27;498;55881;55003;9769;82.7;81.4;14.5
48;2021-11-27;29;24;295;55910;55027;10064;82.7;81.4;14.9
48;2021-11-28;1;1;6;55911;55028;10070;82.7;81.4;14.9
48;2021-11-29;15;8;475;55926;55036;10545;82.8;81.4;15.6
48;2021-11-30;20;38;513;55946;55074;11058;82.8;81.5;16.4
48;2021-12-01;22;28;410;55968;55102;11468;82.8;81.5;17.0
48;2021-12-02;12;21;442;55980;55123;11910;82.8;81.6;17.6
48;2021-12-03;35;23;664;56015;55146;12574;82.9;81.6;18.6
48;2021-12-04;21;25;358;56036;55171;12932;82.9;81.6;19.1
48;2021-12-05;2;1;10;56038;55172;12942;82.9;81.6;19.2
48;2021-12-06;13;17;590;56051;55189;13532;82.9;81.7;20.0
48;2021-12-07;22;17;872;56073;55206;14404;83.0;81.7;21.3
48;2021-12-08;29;29;632;56102;55235;15036;83.0;81.7;22.2
48;2021-12-09;18;20;671;56120;55255;15707;83.0;81.8;23.2
48;2021-12-10;28;50;1000;56148;55305;16707;83.1;81.8;24.7
48;2021-12-11;30;38;636;56178;55343;17343;83.1;81.9;25.7
48;2021-12-12;1;0;20;56179;55343;17363;83.1;81.9;25.7
48;2021-12-13;21;19;718;56200;55362;18081;83.2;81.9;26.8
48;2021-12-14;35;33;973;56235;55395;19054;83.2;82.0;28.2
48;2021-12-15;39;31;693;56274;55426;19747;83.3;82.0;29.2
48;2021-12-16;26;25;698;56300;55451;20445;83.3;82.0;30.3
48;2021-12-17;27;50;1058;56327;55501;21503;83.3;82.1;31.8
48;2021-12-18;17;24;386;56344;55525;21889;83.4;82.2;32.4
48;2021-12-19;2;1;30;56346;55526;21919;83.4;82.2;32.4
49;2020-12-27;1;0;0;1;0;0;0.0;0.0;0.0
49;2020-12-28;1;0;0;2;0;0;0.0;0.0;0.0
49;2020-12-29;0;0;0;2;0;0;0.0;0.0;0.0
49;2020-12-30;0;0;0;2;0;0;0.0;0.0;0.0
49;2020-12-31;0;0;0;2;0;0;0.0;0.0;0.0
49;2021-01-01;2;0;0;4;0;0;0.0;0.0;0.0
49;2021-01-02;1;1;0;5;1;0;0.0;0.0;0.0
49;2021-01-03;0;0;0;5;1;0;0.0;0.0;0.0
49;2021-01-04;9;0;0;14;1;0;0.0;0.0;0.0
49;2021-01-05;66;0;0;80;1;0;0.0;0.0;0.0
49;2021-01-06;200;0;0;280;1;0;0.0;0.0;0.0
49;2021-01-07;350;1;0;630;2;0;0.1;0.0;0.0
49;2021-01-08;316;1;0;946;3;0;0.1;0.0;0.0
49;2021-01-09;123;0;0;1069;3;0;0.2;0.0;0.0
49;2021-01-10;113;0;0;1182;3;0;0.2;0.0;0.0
49;2021-01-11;297;0;0;1479;3;0;0.2;0.0;0.0
49;2021-01-12;596;2;0;2075;5;0;0.3;0.0;0.0
49;2021-01-13;603;2;0;2678;7;0;0.4;0.0;0.0
49;2021-01-14;611;9;0;3289;16;0;0.5;0.0;0.0
49;2021-01-15;739;1;0;4028;17;0;0.6;0.0;0.0
49;2021-01-16;145;0;0;4173;17;0;0.6;0.0;0.0
49;2021-01-17;112;2;0;4285;19;0;0.6;0.0;0.0
49;2021-01-18;683;0;0;4968;19;0;0.7;0.0;0.0
49;2021-01-19;1237;7;0;6205;26;0;0.9;0.0;0.0
49;2021-01-20;1505;6;0;7710;32;0;1.1;0.0;0.0
49;2021-01-21;1951;13;0;9661;45;0;1.4;0.0;0.0
49;2021-01-22;1307;5;0;10968;50;0;1.6;0.0;0.0
49;2021-01-23;268;2;0;11236;52;0;1.6;0.0;0.0
49;2021-01-24;0;0;0;11236;52;0;1.6;0.0;0.0
49;2021-01-25;577;5;0;11813;57;0;1.7;0.0;0.0
49;2021-01-26;1018;55;0;12831;112;0;1.8;0.0;0.0
49;2021-01-27;1834;46;0;14665;158;0;2.1;0.0;0.0
49;2021-01-28;2813;81;0;17478;239;0;2.5;0.0;0.0
49;2021-01-29;1637;97;0;19115;336;0;2.7;0.0;0.0
49;2021-01-30;294;47;0;19409;383;0;2.8;0.1;0.0
49;2021-01-31;52;52;0;19461;435;0;2.8;0.1;0.0
49;2021-02-01;662;168;0;20123;603;0;2.9;0.1;0.0
49;2021-02-02;747;348;0;20870;951;0;3.0;0.1;0.0
49;2021-02-03;714;367;0;21584;1318;0;3.1;0.2;0.0
49;2021-02-04;781;444;0;22365;1762;0;3.2;0.3;0.0
49;2021-02-05;743;571;0;23108;2333;0;3.3;0.3;0.0
49;2021-02-06;234;108;0;23342;2441;0;3.3;0.3;0.0
49;2021-02-07;66;83;0;23408;2524;0;3.3;0.4;0.0
49;2021-02-08;542;474;0;23950;2998;0;3.4;0.4;0.0
49;2021-02-09;765;661;0;24715;3659;0;3.5;0.5;0.0
49;2021-02-10;847;945;0;25562;4604;0;3.6;0.7;0.0
49;2021-02-11;1066;1415;0;26628;6019;0;3.8;0.9;0.0
49;2021-02-12;877;987;0;27505;7006;0;3.9;1.0;0.0
49;2021-02-13;261;129;0;27766;7135;0;4.0;1.0;0.0
49;2021-02-14;9;90;0;27775;7225;0;4.0;1.0;0.0
49;2021-02-15;704;688;0;28479;7913;0;4.1;1.1;0.0
49;2021-02-16;1123;1076;0;29602;8989;0;4.2;1.3;0.0
49;2021-02-17;1126;1856;0;30728;10845;0;4.4;1.5;0.0
49;2021-02-18;1792;2340;0;32520;13185;0;4.6;1.9;0.0
49;2021-02-19;1344;1161;0;33864;14346;0;4.8;2.0;0.0
49;2021-02-20;218;370;0;34082;14716;0;4.9;2.1;0.0
49;2021-02-21;1;59;0;34083;14775;0;4.9;2.1;0.0
49;2021-02-22;624;613;0;34707;15388;0;4.9;2.2;0.0
49;2021-02-23;711;850;0;35418;16238;0;5.0;2.3;0.0
49;2021-02-24;818;687;0;36236;16925;0;5.2;2.4;0.0
49;2021-02-25;1194;853;0;37430;17778;0;5.3;2.5;0.0
49;2021-02-26;1606;839;0;39036;18617;0;5.6;2.6;0.0
49;2021-02-27;421;287;0;39457;18904;0;5.6;2.7;0.0
49;2021-02-28;46;33;0;39503;18937;0;5.6;2.7;0.0
49;2021-03-01;750;620;0;40253;19557;0;5.7;2.8;0.0
49;2021-03-02;1055;725;0;41308;20282;0;5.9;2.9;0.0
49;2021-03-03;1512;725;0;42820;21007;0;6.1;3.0;0.0
49;2021-03-04;1755;969;0;44575;21976;0;6.3;3.1;0.0
49;2021-03-05;2226;740;0;46801;22716;0;6.7;3.2;0.0
49;2021-03-06;731;199;0;47532;22915;0;6.8;3.3;0.0
49;2021-03-07;639;15;0;48171;22930;0;6.9;3.3;0.0
49;2021-03-08;1406;717;0;49577;23647;0;7.1;3.4;0.0
49;2021-03-09;2019;755;0;51596;24402;0;7.3;3.5;0.0
49;2021-03-10;2454;923;0;54050;25325;0;7.7;3.6;0.0
49;2021-03-11;3129;1553;0;57179;26878;0;8.1;3.8;0.0
49;2021-03-12;3687;1011;0;60866;27889;0;8.7;4.0;0.0
49;2021-03-13;1511;214;0;62377;28103;0;8.9;4.0;0.0
49;2021-03-14;13;2;0;62390;28105;0;8.9;4.0;0.0
49;2021-03-15;2079;533;0;64469;28638;0;9.2;4.1;0.0
49;2021-03-16;1700;960;0;66169;29598;0;9.4;4.2;0.0
49;2021-03-17;1757;681;0;67926;30279;0;9.7;4.3;0.0
49;2021-03-18;2182;716;0;70108;30995;0;10.0;4.4;0.0
49;2021-03-19;3303;564;0;73411;31559;0;10.4;4.5;0.0
49;2021-03-20;1710;211;0;75121;31770;0;10.7;4.5;0.0
49;2021-03-21;487;21;0;75608;31791;0;10.8;4.5;0.0
49;2021-03-22;2211;554;0;77819;32345;0;11.1;4.6;0.0
49;2021-03-23;3371;663;0;81190;33008;0;11.6;4.7;0.0
49;2021-03-24;3493;480;0;84683;33488;0;12.1;4.8;0.0
49;2021-03-25;4202;647;0;88885;34135;0;12.6;4.9;0.0
49;2021-03-26;4791;505;0;93676;34640;0;13.3;4.9;0.0
49;2021-03-27;1694;109;0;95370;34749;0;13.6;4.9;0.0
49;2021-03-28;380;26;0;95750;34775;0;13.6;4.9;0.0
49;2021-03-29;2475;606;0;98225;35381;0;14.0;5.0;0.0
49;2021-03-30;3340;932;0;101565;36313;0;14.5;5.2;0.0
49;2021-03-31;3005;757;0;104570;37070;0;14.9;5.3;0.0
49;2021-04-01;4115;882;0;108685;37952;0;15.5;5.4;0.0
49;2021-04-02;4275;961;0;112960;38913;0;16.1;5.5;0.0
49;2021-04-03;986;206;0;113946;39119;0;16.2;5.6;0.0
49;2021-04-04;328;6;0;114274;39125;0;16.3;5.6;0.0
49;2021-04-05;900;28;0;115174;39153;0;16.4;5.6;0.0
49;2021-04-06;2442;1328;0;117616;40481;0;16.7;5.8;0.0
49;2021-04-07;3354;1383;0;120970;41864;0;17.2;6.0;0.0
49;2021-04-08;5131;1404;0;126101;43268;0;17.9;6.2;0.0
49;2021-04-09;6183;1423;0;132284;44691;0;18.8;6.4;0.0
49;2021-04-10;2020;502;0;134304;45193;0;19.1;6.4;0.0
49;2021-04-11;389;12;0;134693;45205;0;19.2;6.4;0.0
49;2021-04-12;3983;1544;0;138676;46749;0;19.7;6.7;0.0
49;2021-04-13;5210;1886;0;143886;48635;0;20.5;6.9;0.0
49;2021-04-14;4338;1856;0;148224;50491;0;21.1;7.2;0.0
49;2021-04-15;5114;1881;0;153338;52372;0;21.8;7.5;0.0
49;2021-04-16;5383;2149;0;158721;54521;0;22.6;7.8;0.0
49;2021-04-17;2976;816;0;161697;55337;0;23.0;7.9;0.0
49;2021-04-18;386;468;0;162083;55805;0;23.1;7.9;0.0
49;2021-04-19;3418;2024;0;165501;57829;0;23.6;8.2;0.0
49;2021-04-20;4058;2078;0;169559;59907;0;24.1;8.5;0.0
49;2021-04-21;3562;2127;0;173121;62034;0;24.6;8.8;0.0
49;2021-04-22;4493;2103;0;177614;64137;0;25.3;9.1;0.0
49;2021-04-23;4384;2282;0;181998;66419;0;25.9;9.5;0.0
49;2021-04-24;2612;1189;0;184610;67608;0;26.3;9.6;0.0
49;2021-04-25;59;294;0;184669;67902;0;26.3;9.7;0.0
49;2021-04-26;3399;2179;0;188068;70081;0;26.8;10.0;0.0
49;2021-04-27;3999;2546;0;192067;72627;0;27.3;10.3;0.0
49;2021-04-28;4132;2455;0;196199;75082;0;27.9;10.7;0.0
49;2021-04-29;4713;3041;0;200912;78123;0;28.6;11.1;0.0
49;2021-04-30;4993;3119;0;205905;81242;0;29.3;11.6;0.0
49;2021-05-01;2182;670;0;208087;81912;0;29.6;11.7;0.0
49;2021-05-02;45;51;0;208132;81963;0;29.6;11.7;0.0
49;2021-05-03;4560;2348;0;212692;84311;0;30.3;12.0;0.0
49;2021-05-04;4615;3139;0;217307;87450;0;30.9;12.4;0.0
49;2021-05-05;4429;3025;0;221736;90475;0;31.6;12.9;0.0
49;2021-05-06;4903;3098;0;226639;93573;0;32.3;13.3;0.0
49;2021-05-07;4007;4955;0;230646;98528;0;32.8;14.0;0.0
49;2021-05-08;3372;477;0;234018;99005;0;33.3;14.1;0.0
49;2021-05-09;58;67;0;234076;99072;0;33.3;14.1;0.0
49;2021-05-10;4426;4032;0;238502;103104;0;33.9;14.7;0.0
49;2021-05-11;4990;4774;0;243492;107878;0;34.7;15.4;0.0
49;2021-05-12;4390;4308;0;247882;112186;0;35.3;16.0;0.0
49;2021-05-13;4438;649;0;252320;112835;0;35.9;16.1;0.0
49;2021-05-14;4605;3063;0;256925;115898;0;36.6;16.5;0.0
49;2021-05-15;3735;1651;0;260660;117549;0;37.1;16.7;0.0
49;2021-05-16;2401;92;0;263061;117641;0;37.4;16.7;0.0
49;2021-05-17;4399;3334;0;267460;120975;0;38.1;17.2;0.0
49;2021-05-18;4850;3529;0;272310;124504;0;38.8;17.7;0.0
49;2021-05-19;5174;2977;0;277484;127481;0;39.5;18.1;0.0
49;2021-05-20;5979;2755;0;283463;130236;0;40.3;18.5;0.0
49;2021-05-21;5797;3394;0;289260;133630;0;41.2;19.0;0.0
49;2021-05-22;4453;1125;0;293713;134755;0;41.8;19.2;0.0
49;2021-05-23;73;16;0;293786;134771;0;41.8;19.2;0.0
49;2021-05-24;3787;401;0;297573;135172;0;42.3;19.2;0.0
49;2021-05-25;5577;3168;0;303150;138340;0;43.1;19.7;0.0
49;2021-05-26;5481;2513;0;308631;140853;0;43.9;20.0;0.0
49;2021-05-27;6191;2635;0;314822;143488;0;44.8;20.4;0.0
49;2021-05-28;6156;3794;0;320978;147282;0;45.7;21.0;0.0
49;2021-05-29;4286;1743;0;325264;149025;0;46.3;21.2;0.0
49;2021-05-30;119;32;0;325383;149057;0;46.3;21.2;0.0
49;2021-05-31;5361;2902;0;330744;151959;0;47.1;21.6;0.0
49;2021-06-01;5980;3730;0;336724;155689;0;47.9;22.2;0.0
49;2021-06-02;5254;3449;0;341978;159138;0;48.7;22.6;0.0
49;2021-06-03;5948;3310;0;347926;162448;0;49.5;23.1;0.0
49;2021-06-04;6009;4584;0;353935;167032;0;50.4;23.8;0.0
49;2021-06-05;4059;2477;0;357994;169509;0;50.9;24.1;0.0
49;2021-06-06;193;73;0;358187;169582;0;51.0;24.1;0.0
49;2021-06-07;4286;4298;0;362473;173880;0;51.6;24.7;0.0
49;2021-06-08;4996;4652;0;367469;178532;0;52.3;25.4;0.0
49;2021-06-09;4993;4103;0;372462;182635;0;53.0;26.0;0.0
49;2021-06-10;5671;3672;0;378133;186307;0;53.8;26.5;0.0
49;2021-06-11;4676;5642;0;382809;191949;0;54.5;27.3;0.0
49;2021-06-12;3711;2926;0;386520;194875;0;55.0;27.7;0.0
49;2021-06-13;131;787;0;386651;195662;0;55.0;27.8;0.0
49;2021-06-14;3367;5529;0;390018;201191;0;55.5;28.6;0.0
49;2021-06-15;4165;5966;0;394183;207157;0;56.1;29.5;0.0
49;2021-06-16;4083;5430;0;398266;212587;0;56.7;30.3;0.0
49;2021-06-17;4866;4966;0;403132;217553;0;57.4;31.0;0.0
49;2021-06-18;4017;6469;0;407149;224022;0;57.9;31.9;0.0
49;2021-06-19;3326;3673;0;410475;227695;0;58.4;32.4;0.0
49;2021-06-20;76;72;0;410551;227767;0;58.4;32.4;0.0
49;2021-06-21;2768;6025;0;413319;233792;0;58.8;33.3;0.0
49;2021-06-22;3132;6575;0;416451;240367;0;59.3;34.2;0.0
49;2021-06-23;3071;5906;0;419522;246273;0;59.7;35.0;0.0
49;2021-06-24;4133;4726;0;423655;250999;0;60.3;35.7;0.0
49;2021-06-25;3238;6904;0;426893;257903;0;60.8;36.7;0.0
49;2021-06-26;2432;4191;0;429325;262094;0;61.1;37.3;0.0
49;2021-06-27;39;1480;0;429364;263574;0;61.1;37.5;0.0
49;2021-06-28;2128;6628;0;431492;270202;0;61.4;38.5;0.0
49;2021-06-29;2847;6775;0;434339;276977;0;61.8;39.4;0.0
49;2021-06-30;2732;6331;0;437071;283308;0;62.2;40.3;0.0
49;2021-07-01;3086;6087;0;440157;289395;0;62.6;41.2;0.0
49;2021-07-02;2889;7577;0;443046;296972;0;63.1;42.3;0.0
49;2021-07-03;1968;4998;0;445014;301970;0;63.3;43.0;0.0
49;2021-07-04;49;157;0;445063;302127;0;63.3;43.0;0.0
49;2021-07-05;1695;6545;0;446758;308672;0;63.6;43.9;0.0
49;2021-07-06;2073;7171;1;448831;315843;1;63.9;44.9;0.0
49;2021-07-07;2206;6173;0;451037;322016;1;64.2;45.8;0.0
49;2021-07-08;2690;6104;0;453727;328120;1;64.6;46.7;0.0
49;2021-07-09;2497;7848;0;456224;335968;1;64.9;47.8;0.0
49;2021-07-10;1943;4921;0;458167;340889;1;65.2;48.5;0.0
49;2021-07-11;62;125;0;458229;341014;1;65.2;48.5;0.0
49;2021-07-12;2053;7227;0;460282;348241;1;65.5;49.6;0.0
49;2021-07-13;2742;7969;1;463024;356210;2;65.9;50.7;0.0
49;2021-07-14;2824;3299;0;465848;359509;2;66.3;51.2;0.0
49;2021-07-15;3376;7249;0;469224;366758;2;66.8;52.2;0.0
49;2021-07-16;3611;7988;0;472835;374746;2;67.3;53.3;0.0
49;2021-07-17;2161;5118;0;474996;379864;2;67.6;54.1;0.0
49;2021-07-18;3170;574;0;478166;380438;2;68.0;54.1;0.0
49;2021-07-19;2633;7119;0;480799;387557;2;68.4;55.2;0.0
49;2021-07-20;3453;7380;0;484252;394937;2;68.9;56.2;0.0
49;2021-07-21;3858;6336;0;488110;401273;2;69.5;57.1;0.0
49;2021-07-22;4422;5925;0;492532;407198;2;70.1;57.9;0.0
49;2021-07-23;4752;6631;0;497284;413829;2;70.8;58.9;0.0
49;2021-07-24;3044;4734;0;500328;418563;2;71.2;59.6;0.0
49;2021-07-25;123;160;0;500451;418723;2;71.2;59.6;0.0
49;2021-07-26;3989;5770;0;504440;424493;2;71.8;60.4;0.0
49;2021-07-27;5602;5398;0;510042;429891;2;72.6;61.2;0.0
49;2021-07-28;5716;4400;0;515758;434291;2;73.4;61.8;0.0
49;2021-07-29;6044;4254;0;521802;438545;2;74.3;62.4;0.0
49;2021-07-30;5799;4825;0;527601;443370;2;75.1;63.1;0.0
49;2021-07-31;3662;3369;0;531263;446739;2;75.6;63.6;0.0
49;2021-08-01;156;77;0;531419;446816;2;75.6;63.6;0.0
49;2021-08-02;4301;4617;0;535720;451433;2;76.2;64.2;0.0
49;2021-08-03;5513;3869;0;541233;455302;2;77.0;64.8;0.0
49;2021-08-04;5239;3723;0;546472;459025;2;77.8;65.3;0.0
49;2021-08-05;5336;3504;0;551808;462529;2;78.5;65.8;0.0
49;2021-08-06;5541;4420;0;557349;466949;2;79.3;66.5;0.0
49;2021-08-07;3587;3022;0;560936;469971;2;79.8;66.9;0.0
49;2021-08-08;90;113;0;561026;470084;2;79.8;66.9;0.0
49;2021-08-09;3524;4717;0;564550;474801;2;80.3;67.6;0.0
49;2021-08-10;4219;3942;0;568769;478743;2;80.9;68.1;0.0
49;2021-08-11;3946;3693;0;572715;482436;2;81.5;68.7;0.0
49;2021-08-12;3066;3265;0;575781;485701;2;81.9;69.1;0.0
49;2021-08-13;3913;4131;0;579694;489832;2;82.5;69.7;0.0
49;2021-08-14;2143;2944;0;581837;492776;2;82.8;70.1;0.0
49;2021-08-15;65;74;0;581902;492850;2;82.8;70.1;0.0
49;2021-08-16;2857;4963;0;584759;497813;2;83.2;70.8;0.0
49;2021-08-17;3179;4823;0;587938;502636;2;83.7;71.5;0.0
49;2021-08-18;2857;4287;0;590795;506923;2;84.1;72.1;0.0
49;2021-08-19;1922;3903;0;592717;510826;2;84.4;72.7;0.0
49;2021-08-20;2738;5496;0;595455;516322;2;84.7;73.5;0.0
49;2021-08-21;1357;3838;0;596812;520160;2;84.9;74.0;0.0
49;2021-08-22;37;168;0;596849;520328;2;84.9;74.0;0.0
49;2021-08-23;2223;5290;0;599072;525618;2;85.3;74.8;0.0
49;2021-08-24;2651;5471;0;601723;531089;2;85.6;75.6;0.0
49;2021-08-25;2279;5224;0;604002;536313;2;86.0;76.3;0.0
49;2021-08-26;1782;4687;1;605784;541000;3;86.2;77.0;0.0
49;2021-08-27;2218;6350;0;608002;547350;3;86.5;77.9;0.0
49;2021-08-28;901;3700;0;608903;551050;3;86.7;78.4;0.0
49;2021-08-29;34;162;0;608937;551212;3;86.7;78.4;0.0
49;2021-08-30;1272;4008;47;610209;555220;50;86.8;79.0;0.0
49;2021-08-31;2130;5525;100;612339;560745;150;87.1;79.8;0.0
49;2021-09-01;1633;3937;235;613972;564682;385;87.4;80.4;0.1
49;2021-09-02;1080;2965;206;615052;567647;591;87.5;80.8;0.1
49;2021-09-03;1412;4020;281;616464;571667;872;87.7;81.4;0.1
49;2021-09-04;1174;3223;127;617638;574890;999;87.9;81.8;0.1
49;2021-09-05;22;44;5;617660;574934;1004;87.9;81.8;0.1
49;2021-09-06;1030;2638;377;618690;577572;1381;88.0;82.2;0.2
49;2021-09-07;1108;2534;385;619798;580106;1766;88.2;82.6;0.3
49;2021-09-08;943;2861;277;620741;582967;2043;88.3;83.0;0.3
49;2021-09-09;740;1733;185;621481;584700;2228;88.4;83.2;0.3
49;2021-09-10;988;2922;252;622469;587622;2480;88.6;83.6;0.4
49;2021-09-11;730;2465;119;623199;590087;2599;88.7;84.0;0.4
49;2021-09-12;16;47;3;623215;590134;2602;88.7;84.0;0.4
49;2021-09-13;723;2018;556;623938;592152;3158;88.8;84.3;0.4
49;2021-09-14;657;1690;689;624595;593842;3847;88.9;84.5;0.5
49;2021-09-15;614;2142;663;625209;595984;4510;89.0;84.8;0.6
49;2021-09-16;543;1347;609;625752;597331;5119;89.1;85.0;0.7
49;2021-09-17;916;2443;632;626668;599774;5751;89.2;85.4;0.8
49;2021-09-18;522;2000;148;627190;601774;5899;89.3;85.6;0.8
49;2021-09-19;8;22;6;627198;601796;5905;89.3;85.6;0.8
49;2021-09-20;498;1248;687;627696;603044;6592;89.3;85.8;0.9
49;2021-09-21;415;1544;799;628111;604588;7391;89.4;86.0;1.1
49;2021-09-22;346;2050;640;628457;606638;8031;89.4;86.3;1.1
49;2021-09-23;297;1090;853;628754;607728;8884;89.5;86.5;1.3
49;2021-09-24;558;2201;930;629312;609929;9814;89.6;86.8;1.4
49;2021-09-25;202;1097;101;629514;611026;9915;89.6;87.0;1.4
49;2021-09-26;4;24;0;629518;611050;9915;89.6;87.0;1.4
49;2021-09-27;355;1312;892;629873;612362;10807;89.6;87.1;1.5
49;2021-09-28;392;1008;740;630265;613370;11547;89.7;87.3;1.6
49;2021-09-29;369;1199;636;630634;614569;12183;89.7;87.5;1.7
49;2021-09-30;332;679;859;630966;615248;13042;89.8;87.6;1.9
49;2021-10-01;526;1495;739;631492;616743;13781;89.9;87.8;2.0
49;2021-10-02;334;1096;163;631826;617839;13944;89.9;87.9;2.0
49;2021-10-03;12;24;4;631838;617863;13948;89.9;87.9;2.0
49;2021-10-04;298;748;688;632136;618611;14636;90.0;88.0;2.1
49;2021-10-05;202;570;753;632338;619181;15389;90.0;88.1;2.2
49;2021-10-06;367;716;672;632705;619897;16061;90.0;88.2;2.3
49;2021-10-07;224;442;801;632929;620339;16862;90.1;88.3;2.4
49;2021-10-08;549;1260;1167;633478;621599;18029;90.2;88.5;2.6
49;2021-10-09;250;655;305;633728;622254;18334;90.2;88.6;2.6
49;2021-10-10;7;11;5;633735;622265;18339;90.2;88.6;2.6
49;2021-10-11;299;660;944;634034;622925;19283;90.2;88.7;2.7
49;2021-10-12;256;345;1147;634290;623270;20430;90.3;88.7;2.9
49;2021-10-13;319;524;1060;634609;623794;21490;90.3;88.8;3.1
49;2021-10-14;221;371;953;634830;624165;22443;90.3;88.8;3.2
49;2021-10-15;450;798;1339;635280;624963;23782;90.4;88.9;3.4
49;2021-10-16;229;398;347;635509;625361;24129;90.4;89.0;3.4
49;2021-10-17;3;12;12;635512;625373;24141;90.4;89.0;3.4
49;2021-10-18;271;314;715;635783;625687;24856;90.5;89.0;3.5
49;2021-10-19;114;338;874;635897;626025;25730;90.5;89.1;3.7
49;2021-10-20;147;321;792;636044;626346;26522;90.5;89.1;3.8
49;2021-10-21;91;240;805;636135;626586;27327;90.5;89.2;3.9
49;2021-10-22;189;649;1627;636324;627235;28954;90.6;89.3;4.1
49;2021-10-23;86;296;338;636410;627531;29292;90.6;89.3;4.2
49;2021-10-24;1;13;12;636411;627544;29304;90.6;89.3;4.2
49;2021-10-25;142;304;878;636553;627848;30182;90.6;89.4;4.3
49;2021-10-26;112;202;808;636665;628050;30990;90.6;89.4;4.4
49;2021-10-27;119;276;988;636784;628326;31978;90.6;89.4;4.6
49;2021-10-28;96;211;979;636880;628537;32957;90.6;89.4;4.7
49;2021-10-29;196;579;1816;637076;629116;34773;90.7;89.5;4.9
49;2021-10-30;62;198;342;637138;629314;35115;90.7;89.6;5.0
49;2021-10-31;4;11;18;637142;629325;35133;90.7;89.6;5.0
49;2021-11-01;4;2;15;637146;629327;35148;90.7;89.6;5.0
49;2021-11-02;152;295;1561;637298;629622;36709;90.7;89.6;5.2
49;2021-11-03;121;289;1582;637419;629911;38291;90.7;89.6;5.4
49;2021-11-04;79;167;1313;637498;630078;39604;90.7;89.7;5.6
49;2021-11-05;180;439;2142;637678;630517;41746;90.7;89.7;5.9
49;2021-11-06;84;188;545;637762;630705;42291;90.8;89.8;6.0
49;2021-11-07;3;20;17;637765;630725;42308;90.8;89.8;6.0
49;2021-11-08;84;272;1934;637849;630997;44242;90.8;89.8;6.3
49;2021-11-09;89;225;2827;637938;631222;47069;90.8;89.8;6.7
49;2021-11-10;160;300;3035;638098;631522;50104;90.8;89.9;7.1
49;2021-11-11;5;4;56;638103;631526;50160;90.8;89.9;7.1
49;2021-11-12;162;284;2910;638265;631810;53070;90.8;89.9;7.6
49;2021-11-13;99;134;818;638364;631944;53888;90.8;89.9;7.7
49;2021-11-14;0;1;19;638364;631945;53907;90.8;89.9;7.7
49;2021-11-15;78;154;2363;638442;632099;56270;90.9;90.0;8.0
49;2021-11-16;82;162;3329;638524;632261;59599;90.9;90.0;8.5
49;2021-11-17;142;206;2929;638666;632467;62528;90.9;90.0;8.9
49;2021-11-18;73;123;2897;638739;632590;65425;90.9;90.0;9.3
49;2021-11-19;178;221;3936;638917;632811;69361;90.9;90.1;9.9
49;2021-11-20;104;83;1109;639021;632894;70470;90.9;90.1;10.0
49;2021-11-21;1;5;12;639022;632899;70482;90.9;90.1;10.0
49;2021-11-22;62;107;2397;639084;633006;72879;91.0;90.1;10.4
49;2021-11-23;136;118;3958;639220;633124;76837;91.0;90.1;10.9
49;2021-11-24;173;187;3490;639393;633311;80327;91.0;90.1;11.4
49;2021-11-25;104;98;3624;639497;633409;83951;91.0;90.1;11.9
49;2021-11-26;209;240;5700;639706;633649;89651;91.0;90.2;12.8
49;2021-11-27;135;148;2475;639841;633797;92126;91.1;90.2;13.1
49;2021-11-28;8;13;791;639849;633810;92917;91.1;90.2;13.2
49;2021-11-29;97;111;4786;639946;633921;97703;91.1;90.2;13.9
49;2021-11-30;135;121;6150;640081;634042;103853;91.1;90.2;14.8
49;2021-12-01;122;137;5945;640203;634179;109798;91.1;90.3;15.6
49;2021-12-02;82;75;5903;640285;634254;115701;91.1;90.3;16.5
49;2021-12-03;148;172;7861;640433;634426;123562;91.1;90.3;17.6
49;2021-12-04;64;111;2923;640497;634537;126485;91.2;90.3;18.0
49;2021-12-05;6;13;790;640503;634550;127275;91.2;90.3;18.1
49;2021-12-06;60;103;7380;640563;634653;134655;91.2;90.3;19.2
49;2021-12-07;112;120;9232;640675;634773;143887;91.2;90.3;20.5
49;2021-12-08;121;183;8006;640796;634956;151893;91.2;90.4;21.6
49;2021-12-09;110;125;9342;640906;635081;161235;91.2;90.4;22.9
49;2021-12-10;112;183;10167;641018;635264;171402;91.2;90.4;24.4
49;2021-12-11;69;145;4525;641087;635409;175927;91.2;90.4;25.0
49;2021-12-12;15;13;1484;641102;635422;177411;91.2;90.4;25.2
49;2021-12-13;70;114;8421;641172;635536;185832;91.2;90.4;26.4
49;2021-12-14;125;172;10523;641297;635708;196355;91.3;90.5;27.9
49;2021-12-15;108;173;9439;641405;635881;205794;91.3;90.5;29.3
49;2021-12-16;90;125;10485;641495;636006;216279;91.3;90.5;30.8
49;2021-12-17;132;267;11333;641627;636273;227612;91.3;90.5;32.4
49;2021-12-18;77;127;5297;641704;636400;232909;91.3;90.6;33.1
49;2021-12-19;14;11;1686;641718;636411;234595;91.3;90.6;33.4
50;2020-12-27;0;0;0;0;0;0;0.0;0.0;0.0
50;2020-12-28;1;0;0;1;0;0;0.0;0.0;0.0
50;2020-12-29;1;0;0;2;0;0;0.0;0.0;0.0
50;2020-12-30;0;0;0;2;0;0;0.0;0.0;0.0
50;2020-12-31;0;0;0;2;0;0;0.0;0.0;0.0
50;2021-01-01;1;0;0;3;0;0;0.0;0.0;0.0
50;2021-01-02;0;0;0;3;0;0;0.0;0.0;0.0
50;2021-01-03;0;0;0;3;0;0;0.0;0.0;0.0
50;2021-01-04;1;0;0;4;0;0;0.0;0.0;0.0
50;2021-01-05;0;0;0;4;0;0;0.0;0.0;0.0
50;2021-01-06;122;0;0;126;0;0;0.0;0.0;0.0
50;2021-01-07;311;0;0;437;0;0;0.1;0.0;0.0
50;2021-01-08;428;2;0;865;2;0;0.2;0.0;0.0
50;2021-01-09;227;0;0;1092;2;0;0.3;0.0;0.0
50;2021-01-10;22;0;0;1114;2;0;0.3;0.0;0.0
50;2021-01-11;368;0;0;1482;2;0;0.3;0.0;0.0
50;2021-01-12;597;0;0;2079;2;0;0.5;0.0;0.0
50;2021-01-13;682;5;0;2761;7;0;0.6;0.0;0.0
50;2021-01-14;979;8;0;3740;15;0;0.9;0.0;0.0
50;2021-01-15;693;5;0;4433;20;0;1.0;0.0;0.0
50;2021-01-16;219;3;0;4652;23;0;1.1;0.0;0.0
50;2021-01-17;9;0;0;4661;23;0;1.1;0.0;0.0
50;2021-01-18;646;1;0;5307;24;0;1.2;0.0;0.0
50;2021-01-19;911;9;0;6218;33;0;1.4;0.0;0.0
50;2021-01-20;968;2;0;7186;35;0;1.7;0.0;0.0
50;2021-01-21;912;3;0;8098;38;0;1.9;0.0;0.0
50;2021-01-22;769;2;0;8867;40;0;2.1;0.0;0.0
50;2021-01-23;658;4;0;9525;44;0;2.2;0.0;0.0
50;2021-01-24;846;3;0;10371;47;0;2.4;0.0;0.0
50;2021-01-25;2577;18;0;12948;65;0;3.0;0.0;0.0
50;2021-01-26;1289;15;0;14237;80;0;3.3;0.0;0.0
50;2021-01-27;750;52;0;14987;132;0;3.5;0.0;0.0
50;2021-01-28;753;166;0;15740;298;0;3.7;0.1;0.0
50;2021-01-29;602;303;0;16342;601;0;3.8;0.1;0.0
50;2021-01-30;375;161;0;16717;762;0;3.9;0.2;0.0
50;2021-01-31;5;0;0;16722;762;0;3.9;0.2;0.0
50;2021-02-01;459;215;0;17181;977;0;4.0;0.2;0.0
50;2021-02-02;463;253;0;17644;1230;0;4.1;0.3;0.0
50;2021-02-03;427;369;0;18071;1599;0;4.2;0.4;0.0
50;2021-02-04;510;456;0;18581;2055;0;4.3;0.5;0.0
50;2021-02-05;448;463;0;19029;2518;0;4.4;0.6;0.0
50;2021-02-06;194;112;0;19223;2630;0;4.5;0.6;0.0
50;2021-02-07;1;5;0;19224;2635;0;4.5;0.6;0.0
50;2021-02-08;284;491;0;19508;3126;0;4.5;0.7;0.0
50;2021-02-09;283;648;0;19791;3774;0;4.6;0.9;0.0
50;2021-02-10;576;564;0;20367;4338;0;4.7;1.0;0.0
50;2021-02-11;485;865;0;20852;5203;0;4.8;1.2;0.0
50;2021-02-12;400;673;0;21252;5876;0;4.9;1.4;0.0
50;2021-02-13;300;445;0;21552;6321;0;5.0;1.5;0.0
50;2021-02-14;180;798;0;21732;7119;0;5.1;1.7;0.0
50;2021-02-15;637;1959;0;22369;9078;0;5.2;2.1;0.0
50;2021-02-16;707;1540;0;23076;10618;0;5.4;2.5;0.0
50;2021-02-17;616;837;0;23692;11455;0;5.5;2.7;0.0
50;2021-02-18;529;841;0;24221;12296;0;5.6;2.9;0.0
50;2021-02-19;639;536;0;24860;12832;0;5.8;3.0;0.0
50;2021-02-20;409;205;0;25269;13037;0;5.9;3.0;0.0
50;2021-02-21;79;30;0;25348;13067;0;5.9;3.0;0.0
50;2021-02-22;305;741;0;25653;13808;0;6.0;3.2;0.0
50;2021-02-23;495;573;0;26148;14381;0;6.1;3.3;0.0
50;2021-02-24;632;562;0;26780;14943;0;6.2;3.5;0.0
50;2021-02-25;797;620;0;27577;15563;0;6.4;3.6;0.0
50;2021-02-26;994;404;0;28571;15967;0;6.6;3.7;0.0
50;2021-02-27;841;120;0;29412;16087;0;6.8;3.7;0.0
50;2021-02-28;102;5;0;29514;16092;0;6.9;3.7;0.0
50;2021-03-01;496;595;0;30010;16687;0;7.0;3.9;0.0
50;2021-03-02;635;549;0;30645;17236;0;7.1;4.0;0.0
50;2021-03-03;795;523;0;31440;17759;0;7.3;4.1;0.0
50;2021-03-04;1257;365;0;32697;18124;0;7.6;4.2;0.0
50;2021-03-05;1559;389;0;34256;18513;0;8.0;4.3;0.0
50;2021-03-06;1323;177;0;35579;18690;0;8.3;4.3;0.0
50;2021-03-07;542;40;0;36121;18730;0;8.4;4.4;0.0
50;2021-03-08;1025;618;0;37146;19348;0;8.6;4.5;0.0
50;2021-03-09;1533;582;0;38679;19930;0;9.0;4.6;0.0
50;2021-03-10;1586;337;0;40265;20267;0;9.4;4.7;0.0
50;2021-03-11;2337;377;0;42602;20644;0;9.9;4.8;0.0
50;2021-03-12;2924;281;0;45526;20925;0;10.6;4.9;0.0
50;2021-03-13;1931;143;0;47457;21068;0;11.0;4.9;0.0
50;2021-03-14;265;39;0;47722;21107;0;11.1;4.9;0.0
50;2021-03-15;1411;310;0;49133;21417;0;11.4;5.0;0.0
50;2021-03-16;1309;283;0;50442;21700;0;11.7;5.0;0.0
50;2021-03-17;1303;408;0;51745;22108;0;12.0;5.1;0.0
50;2021-03-18;1185;422;0;52930;22530;0;12.3;5.2;0.0
50;2021-03-19;1795;588;0;54725;23118;0;12.7;5.4;0.0
50;2021-03-20;1696;224;0;56421;23342;0;13.1;5.4;0.0
50;2021-03-21;776;13;0;57197;23355;0;13.3;5.4;0.0
50;2021-03-22;1514;345;0;58711;23700;0;13.7;5.5;0.0
50;2021-03-23;2064;400;0;60775;24100;0;14.1;5.6;0.0
50;2021-03-24;2283;563;0;63058;24663;0;14.7;5.7;0.0
50;2021-03-25;2844;483;0;65902;25146;0;15.3;5.8;0.0
50;2021-03-26;3247;473;0;69149;25619;0;16.1;6.0;0.0
50;2021-03-27;1724;356;0;70873;25975;0;16.5;6.0;0.0
50;2021-03-28;392;19;0;71265;25994;0;16.6;6.0;0.0
50;2021-03-29;2126;700;0;73391;26694;0;17.1;6.2;0.0
50;2021-03-30;2286;632;0;75677;27326;0;17.6;6.4;0.0
50;2021-03-31;2481;564;0;78158;27890;0;18.2;6.5;0.0
50;2021-04-01;3090;880;0;81248;28770;0;18.9;6.7;0.0
50;2021-04-02;2891;903;0;84139;29673;0;19.6;6.9;0.0
50;2021-04-03;1206;662;0;85345;30335;0;19.8;7.1;0.0
50;2021-04-04;304;132;0;85649;30467;0;19.9;7.1;0.0
50;2021-04-05;385;32;0;86034;30499;0;20.0;7.1;0.0
50;2021-04-06;2067;1194;0;88101;31693;0;20.5;7.4;0.0
50;2021-04-07;2568;1186;0;90669;32879;0;21.1;7.6;0.0
50;2021-04-08;3609;1226;0;94278;34105;0;21.9;7.9;0.0
50;2021-04-09;3854;1291;0;98132;35396;0;22.8;8.2;0.0
50;2021-04-10;2416;850;0;100548;36246;0;23.4;8.4;0.0
50;2021-04-11;383;144;0;100931;36390;0;23.5;8.5;0.0
50;2021-04-12;2403;1393;0;103334;37783;0;24.0;8.8;0.0
50;2021-04-13;2644;1523;0;105978;39306;0;24.6;9.1;0.0
50;2021-04-14;2552;1353;0;108530;40659;0;25.2;9.5;0.0
50;2021-04-15;3083;1151;0;111613;41810;0;26.0;9.7;0.0
50;2021-04-16;3219;1130;0;114832;42940;0;26.7;10.0;0.0
50;2021-04-17;2318;1184;0;117150;44124;0;27.2;10.3;0.0
50;2021-04-18;456;650;0;117606;44774;0;27.3;10.4;0.0
50;2021-04-19;1925;1466;0;119531;46240;0;27.8;10.8;0.0
50;2021-04-20;2179;1557;0;121710;47797;0;28.3;11.1;0.0
50;2021-04-21;2418;1755;0;124128;49552;0;28.9;11.5;0.0
50;2021-04-22;2989;1795;0;127117;51347;0;29.6;11.9;0.0
50;2021-04-23;2654;1933;0;129771;53280;0;30.2;12.4;0.0
50;2021-04-24;1821;1377;0;131592;54657;0;30.6;12.7;0.0
50;2021-04-25;491;269;0;132083;54926;0;30.7;12.8;0.0
50;2021-04-26;2078;1875;0;134161;56801;0;31.2;13.2;0.0
50;2021-04-27;2343;1980;0;136504;58781;0;31.7;13.7;0.0
50;2021-04-28;2569;1970;0;139073;60751;0;32.3;14.1;0.0
50;2021-04-29;3209;2085;0;142282;62836;0;33.1;14.6;0.0
50;2021-04-30;2945;1852;0;145227;64688;0;33.8;15.0;0.0
50;2021-05-01;1001;572;0;146228;65260;0;34.0;15.2;0.0
50;2021-05-02;522;415;0;146750;65675;0;34.1;15.3;0.0
50;2021-05-03;1858;1765;0;148608;67440;0;34.6;15.7;0.0
50;2021-05-04;1827;2266;0;150435;69706;0;35.0;16.2;0.0
50;2021-05-05;1723;2910;0;152158;72616;0;35.4;16.9;0.0
50;2021-05-06;2540;2615;0;154698;75231;0;36.0;17.5;0.0
50;2021-05-07;2244;2850;0;156942;78081;0;36.5;18.2;0.0
50;2021-05-08;1014;781;0;157956;78862;0;36.7;18.3;0.0
50;2021-05-09;625;355;0;158581;79217;0;36.9;18.4;0.0
50;2021-05-10;1790;2551;0;160371;81768;0;37.3;19.0;0.0
50;2021-05-11;2631;2750;0;163002;84518;0;37.9;19.7;0.0
50;2021-05-12;3117;2385;0;166119;86903;0;38.6;20.2;0.0
50;2021-05-13;3265;591;0;169384;87494;0;39.4;20.3;0.0
50;2021-05-14;3512;2207;0;172896;89701;0;40.2;20.9;0.0
50;2021-05-15;3495;1752;0;176391;91453;0;41.0;21.3;0.0
50;2021-05-16;967;262;0;177358;91715;0;41.2;21.3;0.0
50;2021-05-17;2218;1823;0;179576;93538;0;41.8;21.8;0.0
50;2021-05-18;2664;1574;0;182240;95112;0;42.4;22.1;0.0
50;2021-05-19;2628;1402;0;184868;96514;0;43.0;22.4;0.0
50;2021-05-20;3347;1586;0;188215;98100;0;43.8;22.8;0.0
50;2021-05-21;3263;1884;0;191478;99984;0;44.5;23.3;0.0
50;2021-05-22;2598;1262;0;194076;101246;0;45.1;23.5;0.0
50;2021-05-23;584;258;0;194660;101504;0;45.3;23.6;0.0
50;2021-05-24;1527;480;0;196187;101984;0;45.6;23.7;0.0
50;2021-05-25;2596;1635;0;198783;103619;0;46.2;24.1;0.0
50;2021-05-26;3108;1427;0;201891;105046;0;46.9;24.4;0.0
50;2021-05-27;3130;1900;0;205021;106946;0;47.7;24.9;0.0
50;2021-05-28;3029;2132;0;208050;109078;0;48.4;25.4;0.0
50;2021-05-29;2564;1326;0;210614;110404;0;49.0;25.7;0.0
50;2021-05-30;822;301;0;211436;110705;0;49.2;25.7;0.0
50;2021-05-31;2768;1787;0;214204;112492;0;49.8;26.2;0.0
50;2021-06-01;3400;2044;0;217604;114536;0;50.6;26.6;0.0
50;2021-06-02;3289;1826;0;220893;116362;0;51.4;27.1;0.0
50;2021-06-03;4013;2063;0;224906;118425;0;52.3;27.5;0.0
50;2021-06-04;3841;2931;0;228747;121356;0;53.2;28.2;0.0
50;2021-06-05;2825;1833;0;231572;123189;0;53.9;28.6;0.0
50;2021-06-06;831;427;0;232403;123616;0;54.0;28.7;0.0
50;2021-06-07;3447;2077;0;235850;125693;0;54.8;29.2;0.0
50;2021-06-08;4021;2214;0;239871;127907;0;55.8;29.7;0.0
50;2021-06-09;4219;1951;0;244090;129858;0;56.8;30.2;0.0
50;2021-06-10;4134;2146;0;248224;132004;0;57.7;30.7;0.0
50;2021-06-11;4061;2786;0;252285;134790;0;58.7;31.3;0.0
50;2021-06-12;3419;1566;0;255704;136356;0;59.5;31.7;0.0
50;2021-06-13;1009;454;0;256713;136810;0;59.7;31.8;0.0
50;2021-06-14;2555;2994;0;259268;139804;0;60.3;32.5;0.0
50;2021-06-15;2893;2632;0;262161;142436;0;61.0;33.1;0.0
50;2021-06-16;2995;1980;0;265156;144416;0;61.7;33.6;0.0
50;2021-06-17;2707;2520;0;267863;146936;0;62.3;34.2;0.0
50;2021-06-18;3106;3128;0;270969;150064;0;63.0;34.9;0.0
50;2021-06-19;2898;1765;0;273867;151829;0;63.7;35.3;0.0
50;2021-06-20;658;666;0;274525;152495;0;63.8;35.5;0.0
50;2021-06-21;1766;3124;0;276291;155619;0;64.2;36.2;0.0
50;2021-06-22;2016;3388;0;278307;159007;0;64.7;37.0;0.0
50;2021-06-23;1864;3836;0;280171;162843;0;65.2;37.9;0.0
50;2021-06-24;1690;3966;0;281861;166809;0;65.5;38.8;0.0
50;2021-06-25;2042;4071;0;283903;170880;0;66.0;39.7;0.0
50;2021-06-26;1822;3381;0;285725;174261;0;66.4;40.5;0.0
50;2021-06-27;552;864;0;286277;175125;0;66.6;40.7;0.0
50;2021-06-28;1793;3426;0;288070;178551;0;67.0;41.5;0.0
50;2021-06-29;1793;3513;0;289863;182064;0;67.4;42.3;0.0
50;2021-06-30;2066;3445;0;291929;185509;0;67.9;43.1;0.0
50;2021-07-01;1837;3260;0;293766;188769;0;68.3;43.9;0.0
50;2021-07-02;1782;3912;0;295548;192681;0;68.7;44.8;0.0
50;2021-07-03;1273;3249;0;296821;195930;0;69.0;45.6;0.0
50;2021-07-04;381;1005;0;297202;196935;0;69.1;45.8;0.0
50;2021-07-05;1188;3453;0;298390;200388;0;69.4;46.6;0.0
50;2021-07-06;1470;3889;0;299860;204277;0;69.7;47.5;0.0
50;2021-07-07;1699;3612;0;301559;207889;0;70.1;48.3;0.0
50;2021-07-08;1283;4008;0;302842;211897;0;70.4;49.3;0.0
50;2021-07-09;1332;4537;0;304174;216434;0;70.7;50.3;0.0
50;2021-07-10;966;3370;0;305140;219804;0;71.0;51.1;0.0
50;2021-07-11;289;946;0;305429;220750;0;71.0;51.3;0.0
50;2021-07-12;1214;4565;0;306643;225315;0;71.3;52.4;0.0
50;2021-07-13;1542;4788;0;308185;230103;0;71.7;53.5;0.0
50;2021-07-14;1223;2216;0;309408;232319;0;72.0;54.0;0.0
50;2021-07-15;1672;5008;0;311080;237327;0;72.3;55.2;0.0
50;2021-07-16;2724;5089;0;313804;242416;0;73.0;56.4;0.0
50;2021-07-17;1874;3566;0;315678;245982;0;73.4;57.2;0.0
50;2021-07-18;393;1001;0;316071;246983;0;73.5;57.4;0.0
50;2021-07-19;1473;5042;0;317544;252025;0;73.8;58.6;0.0
50;2021-07-20;1447;5251;0;318991;257276;0;74.2;59.8;0.0
50;2021-07-21;1786;5138;0;320777;262414;0;74.6;61.0;0.0
50;2021-07-22;1989;4858;0;322766;267272;0;75.1;62.2;0.0
50;2021-07-23;2156;5169;0;324922;272441;0;75.6;63.4;0.0
50;2021-07-24;1257;3555;0;326179;275996;0;75.9;64.2;0.0
50;2021-07-25;295;946;0;326474;276942;0;75.9;64.4;0.0
50;2021-07-26;2250;3330;0;328724;280272;0;76.4;65.2;0.0
50;2021-07-27;2834;3136;0;331558;283408;0;77.1;65.9;0.0
50;2021-07-28;2940;3297;0;334498;286705;0;77.8;66.7;0.0
50;2021-07-29;3543;3058;0;338041;289763;0;78.6;67.4;0.0
50;2021-07-30;2986;2856;0;341027;292619;0;79.3;68.0;0.0
50;2021-07-31;2228;2401;0;343255;295020;0;79.8;68.6;0.0
50;2021-08-01;513;589;0;343768;295609;0;79.9;68.7;0.0
50;2021-08-02;2353;2578;0;346121;298187;0;80.5;69.3;0.0
50;2021-08-03;3243;2326;0;349364;300513;0;81.2;69.9;0.0
50;2021-08-04;3425;2262;0;352789;302775;0;82.0;70.4;0.0
50;2021-08-05;2995;1989;0;355784;304764;0;82.7;70.9;0.0
50;2021-08-06;3344;2548;0;359128;307312;0;83.5;71.5;0.0
50;2021-08-07;2173;1898;0;361301;309210;0;84.0;71.9;0.0
50;2021-08-08;444;628;0;361745;309838;0;84.1;72.1;0.0
50;2021-08-09;2288;2020;0;364033;311858;0;84.7;72.5;0.0
50;2021-08-10;2703;2008;0;366736;313866;0;85.3;73.0;0.0
50;2021-08-11;2588;1888;1;369324;315754;1;85.9;73.4;0.0
50;2021-08-12;2320;2254;0;371644;318008;1;86.4;74.0;0.0
50;2021-08-13;2278;1858;0;373922;319866;1;87.0;74.4;0.0
50;2021-08-14;1638;1592;0;375560;321458;1;87.3;74.8;0.0
50;2021-08-15;353;316;0;375913;321774;1;87.4;74.8;0.0
50;2021-08-16;1598;2078;0;377511;323852;1;87.8;75.3;0.0
50;2021-08-17;1757;2437;0;379268;326289;1;88.2;75.9;0.0
50;2021-08-18;1617;2389;0;380885;328678;1;88.6;76.4;0.0
50;2021-08-19;1524;2446;0;382409;331124;1;88.9;77.0;0.0
50;2021-08-20;1440;2595;0;383849;333719;1;89.3;77.6;0.0
50;2021-08-21;905;2478;0;384754;336197;1;89.5;78.2;0.0
50;2021-08-22;314;464;0;385068;336661;1;89.5;78.3;0.0
50;2021-08-23;1028;2801;0;386096;339462;1;89.8;78.9;0.0
50;2021-08-24;1133;3041;0;387229;342503;1;90.0;79.6;0.0
50;2021-08-25;981;2652;0;388210;345155;1;90.3;80.3;0.0
50;2021-08-26;823;3147;0;389033;348302;1;90.5;81.0;0.0
50;2021-08-27;884;3114;0;389917;351416;1;90.7;81.7;0.0
50;2021-08-28;710;2705;0;390627;354121;1;90.8;82.3;0.0
50;2021-08-29;236;513;0;390863;354634;1;90.9;82.5;0.0
50;2021-08-30;736;2758;62;391599;357392;63;91.1;83.1;0.0
50;2021-08-31;779;2805;99;392378;360197;162;91.2;83.8;0.0
50;2021-09-01;645;2542;223;393023;362739;385;91.4;84.4;0.1
50;2021-09-02;489;2107;301;393512;364846;686;91.5;84.8;0.2
50;2021-09-03;671;2468;324;394183;367314;1010;91.7;85.4;0.2
50;2021-09-04;574;2676;132;394757;369990;1142;91.8;86.0;0.3
50;2021-09-05;158;585;58;394915;370575;1200;91.8;86.2;0.3
50;2021-09-06;366;1791;285;395281;372366;1485;91.9;86.6;0.3
50;2021-09-07;278;1383;275;395559;373749;1760;92.0;86.9;0.4
50;2021-09-08;432;1792;200;395991;375541;1960;92.1;87.3;0.5
50;2021-09-09;379;1209;231;396370;376750;2191;92.2;87.6;0.5
50;2021-09-10;479;1647;368;396849;378397;2559;92.3;88.0;0.6
50;2021-09-11;340;2010;270;397189;380407;2829;92.4;88.5;0.7
50;2021-09-12;63;320;16;397252;380727;2845;92.4;88.5;0.7
50;2021-09-13;369;941;358;397621;381668;3203;92.5;88.8;0.7
50;2021-09-14;395;854;465;398016;382522;3668;92.6;89.0;0.9
50;2021-09-15;410;982;384;398426;383504;4052;92.7;89.2;0.9
50;2021-09-16;439;696;410;398865;384200;4462;92.8;89.3;1.0
50;2021-09-17;437;994;443;399302;385194;4905;92.9;89.6;1.1
50;2021-09-18;286;1323;179;399588;386517;5084;92.9;89.9;1.2
50;2021-09-19;39;246;20;399627;386763;5104;92.9;89.9;1.2
50;2021-09-20;359;561;398;399986;387324;5502;93.0;90.1;1.3
50;2021-09-21;419;575;555;400405;387899;6057;93.1;90.2;1.4
50;2021-09-22;190;819;416;400595;388718;6473;93.2;90.4;1.5
50;2021-09-23;264;381;641;400859;389099;7114;93.2;90.5;1.7
50;2021-09-24;215;769;544;401074;389868;7658;93.3;90.7;1.8
50;2021-09-25;192;869;154;401266;390737;7812;93.3;90.9;1.8
50;2021-09-26;18;150;34;401284;390887;7846;93.3;90.9;1.8
50;2021-09-27;108;383;549;401392;391270;8395;93.3;91.0;2.0
50;2021-09-28;169;381;579;401561;391651;8974;93.4;91.1;2.1
50;2021-09-29;149;454;511;401710;392105;9485;93.4;91.2;2.2
50;2021-09-30;161;398;610;401871;392503;10095;93.5;91.3;2.3
50;2021-10-01;232;534;614;402103;393037;10709;93.5;91.4;2.5
50;2021-10-02;218;486;239;402321;393523;10948;93.6;91.5;2.5
50;2021-10-03;6;8;22;402327;393531;10970;93.6;91.5;2.6
50;2021-10-04;188;387;673;402515;393918;11643;93.6;91.6;2.7
50;2021-10-05;131;325;690;402646;394243;12333;93.6;91.7;2.9
50;2021-10-06;181;425;449;402827;394668;12782;93.7;91.8;3.0
50;2021-10-07;116;314;605;402943;394982;13387;93.7;91.9;3.1
50;2021-10-08;204;426;552;403147;395408;13939;93.7;91.9;3.2
50;2021-10-09;218;464;372;403365;395872;14311;93.8;92.1;3.3
50;2021-10-10;0;2;1;403365;395874;14312;93.8;92.1;3.3
50;2021-10-11;106;207;622;403471;396081;14934;93.8;92.1;3.5
50;2021-10-12;133;331;805;403604;396412;15739;93.9;92.2;3.7
50;2021-10-13;149;281;622;403753;396693;16361;93.9;92.2;3.8
50;2021-10-14;102;283;763;403855;396976;17124;93.9;92.3;4.0
50;2021-10-15;227;343;922;404082;397319;18046;94.0;92.4;4.2
50;2021-10-16;205;306;663;404287;397625;18709;94.0;92.5;4.4
50;2021-10-17;10;14;91;404297;397639;18800;94.0;92.5;4.4
50;2021-10-18;100;292;423;404397;397931;19223;94.0;92.5;4.5
50;2021-10-19;101;231;554;404498;398162;19777;94.1;92.6;4.6
50;2021-10-20;174;266;886;404672;398428;20663;94.1;92.7;4.8
50;2021-10-21;98;229;698;404770;398657;21361;94.1;92.7;5.0
50;2021-10-22;206;327;895;404976;398984;22256;94.2;92.8;5.2
50;2021-10-23;145;224;546;405121;399208;22802;94.2;92.8;5.3
50;2021-10-24;10;10;31;405131;399218;22833;94.2;92.8;5.3
50;2021-10-25;103;137;567;405234;399355;23400;94.2;92.9;5.4
50;2021-10-26;81;114;765;405315;399469;24165;94.3;92.9;5.6
50;2021-10-27;149;217;1533;405464;399686;25698;94.3;92.9;6.0
50;2021-10-28;76;77;888;405540;399763;26586;94.3;93.0;6.2
50;2021-10-29;154;206;1013;405694;399969;27599;94.3;93.0;6.4
50;2021-10-30;137;220;688;405831;400189;28287;94.4;93.1;6.6
50;2021-10-31;6;5;46;405837;400194;28333;94.4;93.1;6.6
50;2021-11-01;2;1;3;405839;400195;28336;94.4;93.1;6.6
50;2021-11-02;94;119;950;405933;400314;29286;94.4;93.1;6.8
50;2021-11-03;167;253;1474;406100;400567;30760;94.4;93.1;7.2
50;2021-11-04;66;76;744;406166;400643;31504;94.5;93.2;7.3
50;2021-11-05;165;257;1553;406331;400900;33057;94.5;93.2;7.7
50;2021-11-06;151;292;1090;406482;401192;34147;94.5;93.3;7.9
50;2021-11-07;5;6;29;406487;401198;34176;94.5;93.3;7.9
50;2021-11-08;78;141;1140;406565;401339;35316;94.5;93.3;8.2
50;2021-11-09;83;160;1443;406648;401499;36759;94.6;93.4;8.5
50;2021-11-10;135;169;1782;406783;401668;38541;94.6;93.4;9.0
50;2021-11-11;5;4;281;406788;401672;38822;94.6;93.4;9.0
50;2021-11-12;129;185;1734;406917;401857;40556;94.6;93.4;9.4
50;2021-11-13;133;176;1253;407050;402033;41809;94.7;93.5;9.7
50;2021-11-14;4;6;452;407054;402039;42261;94.7;93.5;9.8
50;2021-11-15;112;125;1867;407166;402164;44128;94.7;93.5;10.3
50;2021-11-16;87;75;1932;407253;402239;46060;94.7;93.5;10.7
50;2021-11-17;109;159;2107;407362;402398;48167;94.7;93.6;11.2
50;2021-11-18;87;113;2080;407449;402511;50247;94.7;93.6;11.7
50;2021-11-19;134;172;2366;407583;402683;52613;94.8;93.6;12.2
50;2021-11-20;192;191;1504;407775;402874;54117;94.8;93.7;12.6
50;2021-11-21;1;4;9;407776;402878;54126;94.8;93.7;12.6
50;2021-11-22;118;65;2305;407894;402943;56431;94.9;93.7;13.1
50;2021-11-23;132;96;2613;408026;403039;59044;94.9;93.7;13.7
50;2021-11-24;190;202;2585;408216;403241;61629;94.9;93.8;14.3
50;2021-11-25;128;91;2354;408344;403332;63983;95.0;93.8;14.9
50;2021-11-26;143;145;2863;408487;403477;66846;95.0;93.8;15.5
50;2021-11-27;237;215;2376;408724;403692;69222;95.0;93.9;16.1
50;2021-11-28;53;30;1512;408777;403722;70734;95.1;93.9;16.4
50;2021-11-29;120;108;3338;408897;403830;74072;95.1;93.9;17.2
50;2021-11-30;114;111;4588;409011;403941;78660;95.1;93.9;18.3
50;2021-12-01;122;129;4363;409133;404070;83023;95.1;94.0;19.3
50;2021-12-02;124;80;5262;409257;404150;88285;95.2;94.0;20.5
50;2021-12-03;138;162;5176;409395;404312;93461;95.2;94.0;21.7
50;2021-12-04;97;162;3079;409492;404474;96540;95.2;94.1;22.4
50;2021-12-05;8;15;818;409500;404489;97358;95.2;94.1;22.6
50;2021-12-06;98;101;5316;409598;404590;102674;95.2;94.1;23.9
50;2021-12-07;138;118;6517;409736;404708;109191;95.3;94.1;25.4
50;2021-12-08;197;148;6484;409933;404856;115675;95.3;94.1;26.9
50;2021-12-09;170;94;6950;410103;404950;122625;95.4;94.2;28.5
50;2021-12-10;200;168;7568;410303;405118;130193;95.4;94.2;30.3
50;2021-12-11;104;188;4177;410407;405306;134370;95.4;94.3;31.2
50;2021-12-12;24;9;805;410431;405315;135175;95.4;94.3;31.4
50;2021-12-13;125;142;6107;410556;405457;141282;95.5;94.3;32.9
50;2021-12-14;181;131;7772;410737;405588;149054;95.5;94.3;34.7
50;2021-12-15;185;197;6303;410922;405785;155357;95.6;94.4;36.1
50;2021-12-16;162;143;7537;411084;405928;162894;95.6;94.4;37.9
50;2021-12-17;198;182;7907;411282;406110;170801;95.6;94.4;39.7
50;2021-12-18;156;247;5041;411438;406357;175842;95.7;94.5;40.9
50;2021-12-19;30;23;871;411468;406380;176713;95.7;94.5;41.1
51;2020-12-27;0;0;0;0;0;0;0.0;0.0;0.0
51;2020-12-28;0;0;0;0;0;0;0.0;0.0;0.0
51;2020-12-29;0;0;0;0;0;0;0.0;0.0;0.0
51;2020-12-30;1;0;0;1;0;0;0.0;0.0;0.0
51;2020-12-31;1;0;0;2;0;0;0.0;0.0;0.0
51;2021-01-01;0;0;0;2;0;0;0.0;0.0;0.0
51;2021-01-02;0;0;0;2;0;0;0.0;0.0;0.0
51;2021-01-03;0;0;0;2;0;0;0.0;0.0;0.0
51;2021-01-04;2;0;0;4;0;0;0.0;0.0;0.0
51;2021-01-05;3;0;0;7;0;0;0.0;0.0;0.0
51;2021-01-06;9;0;0;16;0;0;0.0;0.0;0.0
51;2021-01-07;261;1;0;277;1;0;0.1;0.0;0.0
51;2021-01-08;508;1;0;785;2;0;0.2;0.0;0.0
51;2021-01-09;95;1;0;880;3;0;0.2;0.0;0.0
51;2021-01-10;3;0;0;883;3;0;0.2;0.0;0.0
51;2021-01-11;549;1;0;1432;4;0;0.3;0.0;0.0
51;2021-01-12;1428;5;0;2860;9;0;0.6;0.0;0.0
51;2021-01-13;1245;8;0;4105;17;0;0.8;0.0;0.0
51;2021-01-14;1432;10;0;5537;27;0;1.1;0.0;0.0
51;2021-01-15;614;5;0;6151;32;0;1.3;0.0;0.0
51;2021-01-16;176;1;0;6327;33;0;1.3;0.0;0.0
51;2021-01-17;101;0;0;6428;33;0;1.3;0.0;0.0
51;2021-01-18;886;5;0;7314;38;0;1.5;0.0;0.0
51;2021-01-19;1015;6;0;8329;44;0;1.7;0.0;0.0
51;2021-01-20;1023;10;0;9352;54;0;1.9;0.0;0.0
51;2021-01-21;859;3;0;10211;57;0;2.1;0.0;0.0
51;2021-01-22;392;2;0;10603;59;0;2.2;0.0;0.0
51;2021-01-23;294;0;0;10897;59;0;2.2;0.0;0.0
51;2021-01-24;139;1;0;11036;60;0;2.3;0.0;0.0
51;2021-01-25;686;2;0;11722;62;0;2.4;0.0;0.0
51;2021-01-26;754;4;0;12476;66;0;2.6;0.0;0.0
51;2021-01-27;657;5;0;13133;71;0;2.7;0.0;0.0
51;2021-01-28;644;65;0;13777;136;0;2.8;0.0;0.0
51;2021-01-29;474;164;0;14251;300;0;2.9;0.1;0.0
51;2021-01-30;130;7;0;14381;307;0;3.0;0.1;0.0
51;2021-01-31;81;0;0;14462;307;0;3.0;0.1;0.0
51;2021-02-01;282;79;0;14744;386;0;3.0;0.1;0.0
51;2021-02-02;685;710;0;15429;1096;0;3.2;0.2;0.0
51;2021-02-03;597;434;0;16026;1530;0;3.3;0.3;0.0
51;2021-02-04;926;780;0;16952;2310;0;3.5;0.5;0.0
51;2021-02-05;906;524;0;17858;2834;0;3.7;0.6;0.0
51;2021-02-06;37;142;0;17895;2976;0;3.7;0.6;0.0
51;2021-02-07;1;18;0;17896;2994;0;3.7;0.6;0.0
51;2021-02-08;116;420;0;18012;3414;0;3.7;0.7;0.0
51;2021-02-09;243;507;0;18255;3921;0;3.8;0.8;0.0
51;2021-02-10;259;649;0;18514;4570;0;3.8;0.9;0.0
51;2021-02-11;327;575;0;18841;5145;0;3.9;1.1;0.0
51;2021-02-12;369;573;0;19210;5718;0;4.0;1.2;0.0
51;2021-02-13;15;110;0;19225;5828;0;4.0;1.2;0.0
51;2021-02-14;8;167;0;19233;5995;0;4.0;1.2;0.0
51;2021-02-15;254;837;0;19487;6832;0;4.0;1.4;0.0
51;2021-02-16;375;941;0;19862;7773;0;4.1;1.6;0.0
51;2021-02-17;347;902;0;20209;8675;0;4.2;1.8;0.0
51;2021-02-18;410;612;0;20619;9287;0;4.2;1.9;0.0
51;2021-02-19;499;397;0;21118;9684;0;4.4;2.0;0.0
51;2021-02-20;202;295;0;21320;9979;0;4.4;2.1;0.0
51;2021-02-21;10;106;0;21330;10085;0;4.4;2.1;0.0
51;2021-02-22;191;682;0;21521;10767;0;4.4;2.2;0.0
51;2021-02-23;239;1031;0;21760;11798;0;4.5;2.4;0.0
51;2021-02-24;403;689;0;22163;12487;0;4.6;2.6;0.0
51;2021-02-25;1007;850;0;23170;13337;0;4.8;2.7;0.0
51;2021-02-26;1191;638;0;24361;13975;0;5.0;2.9;0.0
51;2021-02-27;603;129;0;24964;14104;0;5.1;2.9;0.0
51;2021-02-28;13;69;0;24977;14173;0;5.1;2.9;0.0
51;2021-03-01;755;313;0;25732;14486;0;5.3;3.0;0.0
51;2021-03-02;1117;467;0;26849;14953;0;5.5;3.1;0.0
51;2021-03-03;1172;469;0;28021;15422;0;5.8;3.2;0.0
51;2021-03-04;1089;700;0;29110;16122;0;6.0;3.3;0.0
51;2021-03-05;1566;646;0;30676;16768;0;6.3;3.5;0.0
51;2021-03-06;1476;66;0;32152;16834;0;6.6;3.5;0.0
51;2021-03-07;292;8;0;32444;16842;0;6.7;3.5;0.0
51;2021-03-08;1017;119;0;33461;16961;0;6.9;3.5;0.0
51;2021-03-09;1671;206;0;35132;17167;0;7.2;3.5;0.0
51;2021-03-10;1964;138;0;37096;17305;0;7.6;3.6;0.0
51;2021-03-11;2407;180;0;39503;17485;0;8.1;3.6;0.0
51;2021-03-12;3242;186;0;42745;17671;0;8.8;3.6;0.0
51;2021-03-13;2504;58;0;45249;17729;0;9.3;3.7;0.0
51;2021-03-14;223;5;0;45472;17734;0;9.4;3.7;0.0
51;2021-03-15;1602;167;0;47074;17901;0;9.7;3.7;0.0
51;2021-03-16;1446;185;0;48520;18086;0;10.0;3.7;0.0
51;2021-03-17;1495;203;0;50015;18289;0;10.3;3.8;0.0
51;2021-03-18;1594;265;0;51609;18554;0;10.6;3.8;0.0
51;2021-03-19;2231;297;0;53840;18851;0;11.1;3.9;0.0
51;2021-03-20;1591;214;0;55431;19065;0;11.4;3.9;0.0
51;2021-03-21;147;7;0;55578;19072;0;11.4;3.9;0.0
51;2021-03-22;1387;132;0;56965;19204;0;11.7;4.0;0.0
51;2021-03-23;2409;180;0;59374;19384;0;12.2;4.0;0.0
51;2021-03-24;2773;123;0;62147;19507;0;12.8;4.0;0.0
51;2021-03-25;3182;343;0;65329;19850;0;13.5;4.1;0.0
51;2021-03-26;3350;501;0;68679;20351;0;14.1;4.2;0.0
51;2021-03-27;1764;253;0;70443;20604;0;14.5;4.2;0.0
51;2021-03-28;247;4;0;70690;20608;0;14.6;4.2;0.0
51;2021-03-29;971;632;0;71661;21240;0;14.8;4.4;0.0
51;2021-03-30;1756;853;0;73417;22093;0;15.1;4.6;0.0
51;2021-03-31;1774;763;0;75191;22856;0;15.5;4.7;0.0
51;2021-04-01;2194;482;0;77385;23338;0;15.9;4.8;0.0
51;2021-04-02;2381;655;0;79766;23993;0;16.4;4.9;0.0
51;2021-04-03;1169;440;0;80935;24433;0;16.7;5.0;0.0
51;2021-04-04;139;13;0;81074;24446;0;16.7;5.0;0.0
51;2021-04-05;125;140;0;81199;24586;0;16.7;5.1;0.0
51;2021-04-06;806;1234;0;82005;25820;0;16.9;5.3;0.0
51;2021-04-07;1340;1411;0;83345;27231;0;17.2;5.6;0.0
51;2021-04-08;2267;1759;0;85612;28990;0;17.6;6.0;0.0
51;2021-04-09;2899;1728;0;88511;30718;0;18.2;6.3;0.0
51;2021-04-10;2182;499;0;90693;31217;0;18.7;6.4;0.0
51;2021-04-11;144;106;0;90837;31323;0;18.7;6.5;0.0
51;2021-04-12;1520;1353;0;92357;32676;0;19.0;6.7;0.0
51;2021-04-13;1979;1681;0;94336;34357;0;19.4;7.1;0.0
51;2021-04-14;2385;1497;0;96721;35854;0;19.9;7.4;0.0
51;2021-04-15;2835;1668;0;99556;37522;0;20.5;7.7;0.0
51;2021-04-16;3179;1562;0;102735;39084;0;21.2;8.1;0.0
51;2021-04-17;1977;734;0;104712;39818;0;21.6;8.2;0.0
51;2021-04-18;350;129;0;105062;39947;0;21.6;8.2;0.0
51;2021-04-19;1634;1160;0;106696;41107;0;22.0;8.5;0.0
51;2021-04-20;1859;1627;0;108555;42734;0;22.4;8.8;0.0
51;2021-04-21;2025;1736;0;110580;44470;0;22.8;9.2;0.0
51;2021-04-22;2465;1602;0;113045;46072;0;23.3;9.5;0.0
51;2021-04-23;3023;1762;0;116068;47834;0;23.9;9.9;0.0
51;2021-04-24;1831;941;0;117899;48775;0;24.3;10.0;0.0
51;2021-04-25;193;179;0;118092;48954;0;24.3;10.1;0.0
51;2021-04-26;1973;728;0;120065;49682;0;24.7;10.2;0.0
51;2021-04-27;2477;1224;0;122542;50906;0;25.2;10.5;0.0
51;2021-04-28;2629;1283;0;125171;52189;0;25.8;10.8;0.0
51;2021-04-29;2820;1465;0;127991;53654;0;26.4;11.1;0.0
51;2021-04-30;3065;1677;0;131056;55331;0;27.0;11.4;0.0
51;2021-05-01;1474;417;0;132530;55748;0;27.3;11.5;0.0
51;2021-05-02;262;142;0;132792;55890;0;27.4;11.5;0.0
51;2021-05-03;2652;809;0;135444;56699;0;27.9;11.7;0.0
51;2021-05-04;2840;1400;0;138284;58099;0;28.5;12.0;0.0
51;2021-05-05;2916;1628;0;141200;59727;0;29.1;12.3;0.0
51;2021-05-06;5427;1951;0;146627;61678;0;30.2;12.7;0.0
51;2021-05-07;3807;1952;0;150434;63630;0;31.0;13.1;0.0
51;2021-05-08;2813;790;0;153247;64420;0;31.6;13.3;0.0
51;2021-05-09;311;140;0;153558;64560;0;31.6;13.3;0.0
51;2021-05-10;3295;1842;0;156853;66402;0;32.3;13.7;0.0
51;2021-05-11;3611;2050;0;160464;68452;0;33.1;14.1;0.0
51;2021-05-12;4249;2248;0;164713;70700;0;33.9;14.6;0.0
51;2021-05-13;1760;512;0;166473;71212;0;34.3;14.7;0.0
51;2021-05-14;5208;1718;0;171681;72930;0;35.4;15.0;0.0
51;2021-05-15;4007;1326;0;175688;74256;0;36.2;15.3;0.0
51;2021-05-16;437;97;0;176125;74353;0;36.3;15.3;0.0
51;2021-05-17;3189;1501;0;179314;75854;0;36.9;15.6;0.0
51;2021-05-18;3876;1704;0;183190;77558;0;37.7;16.0;0.0
51;2021-05-19;4112;1655;0;187302;79213;0;38.6;16.3;0.0
51;2021-05-20;4742;1962;0;192044;81175;0;39.6;16.7;0.0
51;2021-05-21;3790;2412;0;195834;83587;0;40.3;17.2;0.0
51;2021-05-22;2244;1463;0;198078;85050;0;40.8;17.5;0.0
51;2021-05-23;523;223;0;198601;85273;0;40.9;17.6;0.0
51;2021-05-24;2096;704;0;200697;85977;0;41.3;17.7;0.0
51;2021-05-25;3518;1794;0;204215;87771;0;42.1;18.1;0.0
51;2021-05-26;3521;1696;0;207736;89467;0;42.8;18.4;0.0
51;2021-05-27;3495;2093;0;211231;91560;0;43.5;18.9;0.0
51;2021-05-28;3730;2847;0;214961;94407;0;44.3;19.4;0.0
51;2021-05-29;2555;1967;0;217516;96374;0;44.8;19.9;0.0
51;2021-05-30;533;157;0;218049;96531;0;44.9;19.9;0.0
51;2021-05-31;3451;1833;0;221500;98364;0;45.6;20.3;0.0
51;2021-06-01;3875;2405;0;225375;100769;0;46.4;20.8;0.0
51;2021-06-02;5784;2376;0;231159;103145;0;47.6;21.2;0.0
51;2021-06-03;3541;2482;0;234700;105627;0;48.3;21.8;0.0
51;2021-06-04;6141;3010;0;240841;108637;0;49.6;22.4;0.0
51;2021-06-05;2539;1863;0;243380;110500;0;50.1;22.8;0.0
51;2021-06-06;305;225;0;243685;110725;0;50.2;22.8;0.0
51;2021-06-07;3963;2210;0;247648;112935;0;51.0;23.3;0.0
51;2021-06-08;3839;2661;0;251487;115596;0;51.8;23.8;0.0
51;2021-06-09;3837;2730;0;255324;118326;0;52.6;24.4;0.0
51;2021-06-10;3173;2569;0;258497;120895;0;53.2;24.9;0.0
51;2021-06-11;3278;3483;0;261775;124378;0;53.9;25.6;0.0
51;2021-06-12;2204;2161;0;263979;126539;0;54.4;26.1;0.0
51;2021-06-13;248;228;0;264227;126767;0;54.4;26.1;0.0
51;2021-06-14;1561;3451;0;265788;130218;0;54.7;26.8;0.0
51;2021-06-15;2938;3680;0;268726;133898;0;55.4;27.6;0.0
51;2021-06-16;2142;3776;0;270868;137674;0;55.8;28.4;0.0
51;2021-06-17;2543;5434;0;273411;143108;0;56.3;29.5;0.0
51;2021-06-18;2339;5295;0;275750;148403;0;56.8;30.6;0.0
51;2021-06-19;1655;4341;0;277405;152744;0;57.1;31.5;0.0
51;2021-06-20;221;318;0;277626;153062;0;57.2;31.5;0.0
51;2021-06-21;1263;4416;0;278889;157478;0;57.4;32.4;0.0
51;2021-06-22;1529;4039;3;280418;161517;3;57.8;33.3;0.0
51;2021-06-23;3300;4282;0;283718;165799;3;58.4;34.2;0.0
51;2021-06-24;2132;3175;0;285850;168974;3;58.9;34.8;0.0
51;2021-06-25;1811;6324;0;287661;175298;3;59.3;36.1;0.0
51;2021-06-26;1121;4788;0;288782;180086;3;59.5;37.1;0.0
51;2021-06-27;136;435;0;288918;180521;3;59.5;37.2;0.0
51;2021-06-28;1323;4398;0;290241;184919;3;59.8;38.1;0.0
51;2021-06-29;1122;4554;0;291363;189473;3;60.0;39.0;0.0
51;2021-06-30;1612;5877;0;292975;195350;3;60.3;40.2;0.0
51;2021-07-01;1895;3919;0;294870;199269;3;60.7;41.0;0.0
51;2021-07-02;1790;6895;0;296660;206164;3;61.1;42.5;0.0
51;2021-07-03;1002;3301;0;297662;209465;3;61.3;43.1;0.0
51;2021-07-04;190;424;0;297852;209889;3;61.4;43.2;0.0
51;2021-07-05;800;5414;0;298652;215303;3;61.5;44.3;0.0
51;2021-07-06;1211;4913;10;299863;220216;13;61.8;45.4;0.0
51;2021-07-07;1541;4924;5;301404;225140;18;62.1;46.4;0.0
51;2021-07-08;2005;3505;3;303409;228645;21;62.5;47.1;0.0
51;2021-07-09;1798;5118;1;305207;233763;22;62.9;48.2;0.0
51;2021-07-10;1221;3272;0;306428;237035;22;63.1;48.8;0.0
51;2021-07-11;229;387;0;306657;237422;22;63.2;48.9;0.0
51;2021-07-12;1012;4447;0;307669;241869;22;63.4;49.8;0.0
51;2021-07-13;1562;4747;0;309231;246616;22;63.7;50.8;0.0
51;2021-07-14;1068;1602;0;310299;248218;22;63.9;51.1;0.0
51;2021-07-15;2920;4909;0;313219;253127;22;64.5;52.1;0.0
51;2021-07-16;2480;5265;0;315699;258392;22;65.0;53.2;0.0
51;2021-07-17;1819;3388;0;317518;261780;22;65.4;53.9;0.0
51;2021-07-18;284;421;0;317802;262201;22;65.5;54.0;0.0
51;2021-07-19;1968;3979;1;319770;266180;23;65.9;54.8;0.0
51;2021-07-20;2582;4865;0;322352;271045;23;66.4;55.8;0.0
51;2021-07-21;3575;3994;0;325927;275039;23;67.1;56.7;0.0
51;2021-07-22;4342;3767;0;330269;278806;23;68.0;57.4;0.0
51;2021-07-23;3591;4340;0;333860;283146;23;68.8;58.3;0.0
51;2021-07-24;2013;2708;0;335873;285854;23;69.2;58.9;0.0
51;2021-07-25;478;372;0;336351;286226;23;69.3;59.0;0.0
51;2021-07-26;3128;2733;0;339479;288959;23;69.9;59.5;0.0
51;2021-07-27;5493;3166;0;344972;292125;23;71.1;60.2;0.0
51;2021-07-28;3972;4131;0;348944;296256;23;71.9;61.0;0.0
51;2021-07-29;4545;2772;0;353489;299028;23;72.8;61.6;0.0
51;2021-07-30;3673;3109;0;357162;302137;23;73.6;62.2;0.0
51;2021-07-31;2368;1991;0;359530;304128;23;74.1;62.6;0.0
51;2021-08-01;487;313;0;360017;304441;23;74.2;62.7;0.0
51;2021-08-02;3163;2283;0;363180;306724;23;74.8;63.2;0.0
51;2021-08-03;3543;1904;0;366723;308628;23;75.5;63.6;0.0
51;2021-08-04;4053;2111;0;370776;310739;23;76.4;64.0;0.0
51;2021-08-05;2479;1600;0;373255;312339;23;76.9;64.3;0.0
51;2021-08-06;2967;2560;0;376222;314899;23;77.5;64.9;0.0
51;2021-08-07;1938;1633;0;378160;316532;23;77.9;65.2;0.0
51;2021-08-08;416;298;0;378576;316830;23;78.0;65.3;0.0
51;2021-08-09;2418;1915;0;380994;318745;23;78.5;65.7;0.0
51;2021-08-10;2263;1976;0;383257;320721;23;78.9;66.1;0.0
51;2021-08-11;2612;2342;0;385869;323063;23;79.5;66.5;0.0
51;2021-08-12;1737;2041;0;387606;325104;23;79.8;67.0;0.0
51;2021-08-13;1956;2748;0;389562;327852;23;80.2;67.5;0.0
51;2021-08-14;1415;1889;0;390977;329741;23;80.5;67.9;0.0
51;2021-08-15;161;198;0;391138;329939;23;80.6;68.0;0.0
51;2021-08-16;1298;2966;0;392436;332905;23;80.8;68.6;0.0
51;2021-08-17;1492;3153;0;393928;336058;23;81.1;69.2;0.0
51;2021-08-18;1742;3533;0;395670;339591;23;81.5;70.0;0.0
51;2021-08-19;1330;2520;0;397000;342111;23;81.8;70.5;0.0
51;2021-08-20;1585;3847;0;398585;345958;23;82.1;71.3;0.0
51;2021-08-21;898;2274;0;399483;348232;23;82.3;71.7;0.0
51;2021-08-22;112;428;0;399595;348660;23;82.3;71.8;0.0
51;2021-08-23;1099;3488;0;400694;352148;23;82.5;72.5;0.0
51;2021-08-24;1112;3516;0;401806;355664;23;82.8;73.3;0.0
51;2021-08-25;1205;4164;0;403011;359828;23;83.0;74.1;0.0
51;2021-08-26;1000;2490;0;404011;362318;23;83.2;74.6;0.0
51;2021-08-27;1150;3959;0;405161;366277;23;83.5;75.4;0.0
51;2021-08-28;609;2270;0;405770;368547;23;83.6;75.9;0.0
51;2021-08-29;88;410;0;405858;368957;23;83.6;76.0;0.0
51;2021-08-30;1199;4390;48;407057;373347;71;83.8;76.9;0.0
51;2021-08-31;753;2844;93;407810;376191;164;84.0;77.5;0.0
51;2021-09-01;748;2925;165;408558;379116;329;84.2;78.1;0.1
51;2021-09-02;755;1967;178;409313;381083;507;84.3;78.5;0.1
51;2021-09-03;891;2579;286;410204;383662;793;84.5;79.0;0.2
51;2021-09-04;590;2480;95;410794;386142;888;84.6;79.5;0.2
51;2021-09-05;127;216;35;410921;386358;923;84.6;79.6;0.2
51;2021-09-06;412;1450;474;411333;387808;1397;84.7;79.9;0.3
51;2021-09-07;503;1186;427;411836;388994;1824;84.8;80.1;0.4
51;2021-09-08;560;1750;251;412396;390744;2075;84.9;80.5;0.4
51;2021-09-09;455;1175;171;412851;391919;2246;85.0;80.7;0.5
51;2021-09-10;674;1738;303;413525;393657;2549;85.2;81.1;0.5
51;2021-09-11;526;1615;103;414051;395272;2652;85.3;81.4;0.5
51;2021-09-12;29;88;8;414080;395360;2660;85.3;81.4;0.5
51;2021-09-13;424;841;294;414504;396201;2954;85.4;81.6;0.6
51;2021-09-14;572;817;546;415076;397018;3500;85.5;81.8;0.7
51;2021-09-15;491;1326;401;415567;398344;3901;85.6;82.1;0.8
51;2021-09-16;318;641;414;415885;398985;4315;85.7;82.2;0.9
51;2021-09-17;549;1175;552;416434;400160;4867;85.8;82.4;1.0
51;2021-09-18;439;1266;149;416873;401426;5016;85.9;82.7;1.0
51;2021-09-19;16;75;9;416889;401501;5025;85.9;82.7;1.0
51;2021-09-20;277;566;299;417166;402067;5324;85.9;82.8;1.1
51;2021-09-21;238;519;352;417404;402586;5676;86.0;82.9;1.2
51;2021-09-22;309;1245;477;417713;403831;6153;86.0;83.2;1.3
51;2021-09-23;205;607;386;417918;404438;6539;86.1;83.3;1.3
51;2021-09-24;360;956;595;418278;405394;7134;86.2;83.5;1.5
51;2021-09-25;262;894;202;418540;406288;7336;86.2;83.7;1.5
51;2021-09-26;9;125;12;418549;406413;7348;86.2;83.7;1.5
51;2021-09-27;238;413;286;418787;406826;7634;86.3;83.8;1.6
51;2021-09-28;282;374;367;419069;407200;8001;86.3;83.9;1.6
51;2021-09-29;338;711;414;419407;407911;8415;86.4;84.0;1.7
51;2021-09-30;233;399;379;419640;408310;8794;86.4;84.1;1.8
51;2021-10-01;374;704;523;420014;409014;9317;86.5;84.3;1.9
51;2021-10-02;360;698;330;420374;409712;9647;86.6;84.4;2.0
51;2021-10-03;3;5;2;420377;409717;9649;86.6;84.4;2.0
51;2021-10-04;193;406;405;420570;410123;10054;86.6;84.5;2.1
51;2021-10-05;229;430;504;420799;410553;10558;86.7;84.6;2.2
51;2021-10-06;318;536;631;421117;411089;11189;86.7;84.7;2.3
51;2021-10-07;170;370;605;421287;411459;11794;86.8;84.8;2.4
51;2021-10-08;333;604;845;421620;412063;12639;86.8;84.9;2.6
51;2021-10-09;318;555;443;421938;412618;13082;86.9;85.0;2.7
51;2021-10-10;9;12;3;421947;412630;13085;86.9;85.0;2.7
51;2021-10-11;173;309;506;422120;412939;13591;87.0;85.1;2.8
51;2021-10-12;148;361;635;422268;413300;14226;87.0;85.1;2.9
51;2021-10-13;286;419;781;422554;413719;15007;87.0;85.2;3.1
51;2021-10-14;145;198;482;422699;413917;15489;87.1;85.3;3.2
51;2021-10-15;344;514;1231;423043;414431;16720;87.1;85.4;3.4
51;2021-10-16;293;369;487;423336;414800;17207;87.2;85.4;3.5
51;2021-10-17;5;4;8;423341;414804;17215;87.2;85.4;3.5
51;2021-10-18;143;255;656;423484;415059;17871;87.2;85.5;3.7
51;2021-10-19;146;289;661;423630;415348;18532;87.3;85.6;3.8
51;2021-10-20;278;383;987;423908;415731;19519;87.3;85.6;4.0
51;2021-10-21;150;250;643;424058;415981;20162;87.4;85.7;4.2
51;2021-10-22;222;383;1162;424280;416364;21324;87.4;85.8;4.4
51;2021-10-23;206;374;483;424486;416738;21807;87.4;85.8;4.5
51;2021-10-24;1;4;7;424487;416742;21814;87.4;85.8;4.5
51;2021-10-25;157;190;760;424644;416932;22574;87.5;85.9;4.6
51;2021-10-26;119;183;739;424763;417115;23313;87.5;85.9;4.8
51;2021-10-27;223;330;840;424986;417445;24153;87.5;86.0;5.0
51;2021-10-28;128;170;681;425114;417615;24834;87.6;86.0;5.1
51;2021-10-29;177;305;1168;425291;417920;26002;87.6;86.1;5.4
51;2021-10-30;158;299;406;425449;418219;26408;87.6;86.1;5.4
51;2021-10-31;1;6;1;425450;418225;26409;87.6;86.1;5.4
51;2021-11-01;12;8;6;425462;418233;26415;87.6;86.2;5.4
51;2021-11-02;163;228;794;425625;418461;27209;87.7;86.2;5.6
51;2021-11-03;192;231;996;425817;418692;28205;87.7;86.2;5.8
51;2021-11-04;99;155;736;425916;418847;28941;87.7;86.3;6.0
51;2021-11-05;277;371;1423;426193;419218;30364;87.8;86.4;6.3
51;2021-11-06;161;248;688;426354;419466;31052;87.8;86.4;6.4
51;2021-11-07;7;11;16;426361;419477;31068;87.8;86.4;6.4
51;2021-11-08;92;141;901;426453;419618;31969;87.8;86.4;6.6
51;2021-11-09;120;225;1172;426573;419843;33141;87.9;86.5;6.8
51;2021-11-10;197;251;1453;426770;420094;34594;87.9;86.5;7.1
51;2021-11-11;4;25;39;426774;420119;34633;87.9;86.5;7.1
51;2021-11-12;239;345;1785;427013;420464;36418;88.0;86.6;7.5
51;2021-11-13;121;156;692;427134;420620;37110;88.0;86.6;7.6
51;2021-11-14;0;6;14;427134;420626;37124;88.0;86.6;7.6
51;2021-11-15;117;162;1394;427251;420788;38518;88.0;86.7;7.9
51;2021-11-16;122;170;1769;427373;420958;40287;88.0;86.7;8.3
51;2021-11-17;171;220;1753;427544;421178;42040;88.1;86.8;8.7
51;2021-11-18;108;136;1517;427652;421314;43557;88.1;86.8;9.0
51;2021-11-19;258;310;2438;427910;421624;45995;88.1;86.8;9.5
51;2021-11-20;154;230;1160;428064;421854;47155;88.2;86.9;9.7
51;2021-11-21;6;7;46;428070;421861;47201;88.2;86.9;9.7
51;2021-11-22;156;126;1534;428226;421987;48735;88.2;86.9;10.0
51;2021-11-23;158;169;1976;428384;422156;50711;88.2;87.0;10.4
51;2021-11-24;278;201;1864;428662;422357;52575;88.3;87.0;10.8
51;2021-11-25;132;139;2057;428794;422496;54632;88.3;87.0;11.3
51;2021-11-26;246;239;3642;429040;422735;58274;88.4;87.1;12.0
51;2021-11-27;169;196;1803;429209;422931;60077;88.4;87.1;12.4
51;2021-11-28;2;7;136;429211;422938;60213;88.4;87.1;12.4
51;2021-11-29;118;138;3021;429329;423076;63234;88.4;87.1;13.0
51;2021-11-30;162;146;4473;429491;423222;67707;88.5;87.2;13.9
51;2021-12-01;129;173;4203;429620;423395;71910;88.5;87.2;14.8
51;2021-12-02;117;102;4746;429737;423497;76656;88.5;87.2;15.8
51;2021-12-03;157;220;5934;429894;423717;82590;88.6;87.3;17.0
51;2021-12-04;182;156;3999;430076;423873;86589;88.6;87.3;17.8
51;2021-12-05;13;18;385;430089;423891;86974;88.6;87.3;17.9
51;2021-12-06;98;151;4479;430187;424042;91453;88.6;87.3;18.8
51;2021-12-07;145;145;5856;430332;424187;97309;88.6;87.4;20.0
51;2021-12-08;137;187;5243;430469;424374;102552;88.7;87.4;21.1
51;2021-12-09;125;154;6529;430594;424528;109081;88.7;87.4;22.5
51;2021-12-10;187;238;7950;430781;424766;117031;88.7;87.5;24.1
51;2021-12-11;171;167;5053;430952;424933;122084;88.8;87.5;25.1
51;2021-12-12;10;8;497;430962;424941;122581;88.8;87.5;25.3
51;2021-12-13;107;182;5592;431069;425123;128173;88.8;87.6;26.4
51;2021-12-14;136;170;7159;431205;425293;135332;88.8;87.6;27.9
51;2021-12-15;151;239;7623;431356;425532;142955;88.9;87.7;29.4
51;2021-12-16;154;196;8026;431510;425728;150981;88.9;87.7;31.1
51;2021-12-17;204;308;8799;431714;426036;159780;88.9;87.8;32.9
51;2021-12-18;185;237;5564;431899;426273;165344;89.0;87.8;34.1
51;2021-12-19;36;29;941;431935;426302;166285;89.0;87.8;34.3
52;2020-12-27;0;0;0;0;0;0;0.0;0.0;0.0
52;2020-12-28;0;0;0;0;0;0;0.0;0.0;0.0
52;2020-12-29;0;0;0;0;0;0;0.0;0.0;0.0
52;2020-12-30;0;0;0;0;0;0;0.0;0.0;0.0
52;2020-12-31;0;0;0;0;0;0;0.0;0.0;0.0
52;2021-01-01;0;0;0;0;0;0;0.0;0.0;0.0
52;2021-01-02;0;0;0;0;0;0;0.0;0.0;0.0
52;2021-01-03;0;0;0;0;0;0;0.0;0.0;0.0
52;2021-01-04;0;0;0;0;0;0;0.0;0.0;0.0
52;2021-01-05;3;0;0;3;0;0;0.0;0.0;0.0
52;2021-01-06;1;0;0;4;0;0;0.0;0.0;0.0
52;2021-01-07;2;0;0;6;0;0;0.0;0.0;0.0
52;2021-01-08;160;1;0;166;1;0;0.1;0.0;0.0
52;2021-01-09;89;0;0;255;1;0;0.2;0.0;0.0
52;2021-01-10;0;0;0;255;1;0;0.2;0.0;0.0
52;2021-01-11;167;0;0;422;1;0;0.3;0.0;0.0
52;2021-01-12;154;0;0;576;1;0;0.4;0.0;0.0
52;2021-01-13;465;0;0;1041;1;0;0.7;0.0;0.0
52;2021-01-14;614;9;0;1655;10;0;1.1;0.0;0.0
52;2021-01-15;373;1;0;2028;11;0;1.4;0.0;0.0
52;2021-01-16;17;0;0;2045;11;0;1.4;0.0;0.0
52;2021-01-17;1;0;0;2046;11;0;1.4;0.0;0.0
52;2021-01-18;380;0;0;2426;11;0;1.6;0.0;0.0
52;2021-01-19;392;1;0;2818;12;0;1.9;0.0;0.0
52;2021-01-20;403;2;0;3221;14;0;2.2;0.0;0.0
52;2021-01-21;406;1;0;3627;15;0;2.4;0.0;0.0
52;2021-01-22;320;2;0;3947;17;0;2.7;0.0;0.0
52;2021-01-23;69;2;0;4016;19;0;2.7;0.0;0.0
52;2021-01-24;2;0;0;4018;19;0;2.7;0.0;0.0
52;2021-01-25;261;1;0;4279;20;0;2.9;0.0;0.0
52;2021-01-26;304;1;0;4583;21;0;3.1;0.0;0.0
52;2021-01-27;243;1;0;4826;22;0;3.2;0.0;0.0
52;2021-01-28;186;4;0;5012;26;0;3.4;0.0;0.0
52;2021-01-29;81;92;0;5093;118;0;3.4;0.1;0.0
52;2021-01-30;90;90;0;5183;208;0;3.5;0.1;0.0
52;2021-01-31;0;0;0;5183;208;0;3.5;0.1;0.0
52;2021-02-01;116;145;0;5299;353;0;3.6;0.2;0.0
52;2021-02-02;75;142;0;5374;495;0;3.6;0.3;0.0
52;2021-02-03;81;341;0;5455;836;0;3.7;0.6;0.0
52;2021-02-04;209;520;0;5664;1356;0;3.8;0.9;0.0
52;2021-02-05;110;444;0;5774;1800;0;3.9;1.2;0.0
52;2021-02-06;26;0;0;5800;1800;0;3.9;1.2;0.0
52;2021-02-07;0;0;0;5800;1800;0;3.9;1.2;0.0
52;2021-02-08;39;187;0;5839;1987;0;3.9;1.3;0.0
52;2021-02-09;57;196;0;5896;2183;0;4.0;1.5;0.0
52;2021-02-10;99;179;0;5995;2362;0;4.0;1.6;0.0
52;2021-02-11;128;128;0;6123;2490;0;4.1;1.7;0.0
52;2021-02-12;179;136;0;6302;2626;0;4.2;1.8;0.0
52;2021-02-13;7;3;0;6309;2629;0;4.2;1.8;0.0
52;2021-02-14;6;19;0;6315;2648;0;4.2;1.8;0.0
52;2021-02-15;83;273;0;6398;2921;0;4.3;2.0;0.0
52;2021-02-16;66;327;0;6464;3248;0;4.3;2.2;0.0
52;2021-02-17;47;317;0;6511;3565;0;4.4;2.4;0.0
52;2021-02-18;83;250;0;6594;3815;0;4.4;2.6;0.0
52;2021-02-19;60;210;0;6654;4025;0;4.5;2.7;0.0
52;2021-02-20;16;99;0;6670;4124;0;4.5;2.8;0.0
52;2021-02-21;1;7;0;6671;4131;0;4.5;2.8;0.0
52;2021-02-22;40;364;0;6711;4495;0;4.5;3.0;0.0
52;2021-02-23;59;270;0;6770;4765;0;4.5;3.2;0.0
52;2021-02-24;89;217;0;6859;4982;0;4.6;3.3;0.0
52;2021-02-25;152;213;0;7011;5195;0;4.7;3.5;0.0
52;2021-02-26;302;162;0;7313;5357;0;4.9;3.6;0.0
52;2021-02-27;156;48;0;7469;5405;0;5.0;3.6;0.0
52;2021-02-28;1;1;0;7470;5406;0;5.0;3.6;0.0
52;2021-03-01;158;30;0;7628;5436;0;5.1;3.7;0.0
52;2021-03-02;155;66;0;7783;5502;0;5.2;3.7;0.0
52;2021-03-03;363;54;0;8146;5556;0;5.5;3.7;0.0
52;2021-03-04;401;67;0;8547;5623;0;5.7;3.8;0.0
52;2021-03-05;503;58;0;9050;5681;0;6.1;3.8;0.0
52;2021-03-06;428;40;0;9478;5721;0;6.4;3.8;0.0
52;2021-03-07;30;1;0;9508;5722;0;6.4;3.8;0.0
52;2021-03-08;387;114;0;9895;5836;0;6.6;3.9;0.0
52;2021-03-09;534;126;0;10429;5962;0;7.0;4.0;0.0
52;2021-03-10;339;111;0;10768;6073;0;7.2;4.1;0.0
52;2021-03-11;621;46;0;11389;6119;0;7.6;4.1;0.0
52;2021-03-12;549;61;0;11938;6180;0;8.0;4.1;0.0
52;2021-03-13;521;14;0;12459;6194;0;8.4;4.2;0.0
52;2021-03-14;23;2;0;12482;6196;0;8.4;4.2;0.0
52;2021-03-15;347;31;0;12829;6227;0;8.6;4.2;0.0
52;2021-03-16;247;22;0;13076;6249;0;8.8;4.2;0.0
52;2021-03-17;426;26;0;13502;6275;0;9.1;4.2;0.0
52;2021-03-18;488;25;0;13990;6300;0;9.4;4.2;0.0
52;2021-03-19;509;57;0;14499;6357;0;9.7;4.3;0.0
52;2021-03-20;263;13;0;14762;6370;0;9.9;4.3;0.0
52;2021-03-21;30;1;0;14792;6371;0;9.9;4.3;0.0
52;2021-03-22;386;51;0;15178;6422;0;10.2;4.3;0.0
52;2021-03-23;766;53;0;15944;6475;0;10.7;4.3;0.0
52;2021-03-24;818;73;0;16762;6548;0;11.3;4.4;0.0
52;2021-03-25;1144;100;0;17906;6648;0;12.0;4.5;0.0
52;2021-03-26;1023;137;0;18929;6785;0;12.7;4.6;0.0
52;2021-03-27;498;78;0;19427;6863;0;13.0;4.6;0.0
52;2021-03-28;61;0;0;19488;6863;0;13.1;4.6;0.0
52;2021-03-29;523;190;0;20011;7053;0;13.4;4.7;0.0
52;2021-03-30;881;246;0;20892;7299;0;14.0;4.9;0.0
52;2021-03-31;984;285;0;21876;7584;0;14.7;5.1;0.0
52;2021-04-01;1171;219;0;23047;7803;0;15.5;5.2;0.0
52;2021-04-02;996;111;0;24043;7914;0;16.1;5.3;0.0
52;2021-04-03;437;15;0;24480;7929;0;16.4;5.3;0.0
52;2021-04-04;7;3;0;24487;7932;0;16.4;5.3;0.0
52;2021-04-05;20;0;0;24507;7932;0;16.5;5.3;0.0
52;2021-04-06;487;289;0;24994;8221;0;16.8;5.5;0.0
52;2021-04-07;610;454;0;25604;8675;0;17.2;5.8;0.0
52;2021-04-08;932;270;0;26536;8945;0;17.8;6.0;0.0
52;2021-04-09;1116;157;0;27652;9102;0;18.6;6.1;0.0
52;2021-04-10;796;102;0;28448;9204;0;19.1;6.2;0.0
52;2021-04-11;55;11;0;28503;9215;0;19.1;6.2;0.0
52;2021-04-12;945;319;0;29448;9534;0;19.8;6.4;0.0
52;2021-04-13;1244;409;0;30692;9943;0;20.6;6.7;0.0
52;2021-04-14;1258;512;0;31950;10455;0;21.5;7.0;0.0
52;2021-04-15;1421;477;0;33371;10932;0;22.4;7.3;0.0
52;2021-04-16;1539;366;0;34910;11298;0;23.4;7.6;0.0
52;2021-04-17;1403;135;0;36313;11433;0;24.4;7.7;0.0
52;2021-04-18;504;41;0;36817;11474;0;24.7;7.7;0.0
52;2021-04-19;566;618;0;37383;12092;0;25.1;8.1;0.0
52;2021-04-20;950;709;0;38333;12801;0;25.7;8.6;0.0
52;2021-04-21;1043;705;0;39376;13506;0;26.4;9.1;0.0
52;2021-04-22;1412;694;0;40788;14200;0;27.4;9.5;0.0
52;2021-04-23;1336;641;0;42124;14841;0;28.3;10.0;0.0
52;2021-04-24;528;307;0;42652;15148;0;28.6;10.2;0.0
52;2021-04-25;20;86;0;42672;15234;0;28.7;10.2;0.0
52;2021-04-26;610;501;0;43282;15735;0;29.1;10.6;0.0
52;2021-04-27;918;731;0;44200;16466;0;29.7;11.1;0.0
52;2021-04-28;1379;613;0;45579;17079;0;30.6;11.5;0.0
52;2021-04-29;1300;612;0;46879;17691;0;31.5;11.9;0.0
52;2021-04-30;1246;673;0;48125;18364;0;32.3;12.3;0.0
52;2021-05-01;39;260;0;48164;18624;0;32.3;12.5;0.0
52;2021-05-02;8;6;0;48172;18630;0;32.3;12.5;0.0
52;2021-05-03;1062;633;0;49234;19263;0;33.1;12.9;0.0
52;2021-05-04;1279;746;0;50513;20009;0;33.9;13.4;0.0
52;2021-05-05;1593;705;0;52106;20714;0;35.0;13.9;0.0
52;2021-05-06;1706;576;0;53812;21290;0;36.1;14.3;0.0
52;2021-05-07;1425;1191;0;55237;22481;0;37.1;15.1;0.0
52;2021-05-08;587;267;0;55824;22748;0;37.5;15.3;0.0
52;2021-05-09;50;79;0;55874;22827;0;37.5;15.3;0.0
52;2021-05-10;755;1094;0;56629;23921;0;38.0;16.1;0.0
52;2021-05-11;862;1329;0;57491;25250;0;38.6;17.0;0.0
52;2021-05-12;1132;1301;0;58623;26551;0;39.4;17.8;0.0
52;2021-05-13;180;187;0;58803;26738;0;39.5;18.0;0.0
52;2021-05-14;1123;1372;0;59926;28110;0;40.2;18.9;0.0
52;2021-05-15;579;916;0;60505;29026;0;40.6;19.5;0.0
52;2021-05-16;124;60;0;60629;29086;0;40.7;19.5;0.0
52;2021-05-17;1031;694;0;61660;29780;0;41.4;20.0;0.0
52;2021-05-18;1143;671;0;62803;30451;0;42.2;20.4;0.0
52;2021-05-19;1422;430;0;64225;30881;0;43.1;20.7;0.0
52;2021-05-20;1546;446;0;65771;31327;0;44.2;21.0;0.0
52;2021-05-21;1534;611;0;67305;31938;0;45.2;21.4;0.0
52;2021-05-22;1078;212;0;68383;32150;0;45.9;21.6;0.0
52;2021-05-23;18;3;0;68401;32153;0;45.9;21.6;0.0
52;2021-05-24;508;39;0;68909;32192;0;46.3;21.6;0.0
52;2021-05-25;1275;380;0;70184;32572;0;47.1;21.9;0.0
52;2021-05-26;1338;672;0;71522;33244;0;48.0;22.3;0.0
52;2021-05-27;1374;792;0;72896;34036;0;49.0;22.9;0.0
52;2021-05-28;1411;703;0;74307;34739;0;49.9;23.3;0.0
52;2021-05-29;744;866;0;75051;35605;0;50.4;23.9;0.0
52;2021-05-30;32;552;0;75083;36157;0;50.4;24.3;0.0
52;2021-05-31;731;778;0;75814;36935;0;50.9;24.8;0.0
52;2021-06-01;858;830;0;76672;37765;0;51.5;25.4;0.0
52;2021-06-02;817;728;0;77489;38493;0;52.0;25.8;0.0
52;2021-06-03;791;753;0;78280;39246;0;52.6;26.4;0.0
52;2021-06-04;915;1368;0;79195;40614;0;53.2;27.3;0.0
52;2021-06-05;649;643;0;79844;41257;0;53.6;27.7;0.0
52;2021-06-06;31;57;0;79875;41314;0;53.6;27.7;0.0
52;2021-06-07;435;936;0;80310;42250;0;53.9;28.4;0.0
52;2021-06-08;585;1321;0;80895;43571;0;54.3;29.3;0.0
52;2021-06-09;688;1410;0;81583;44981;0;54.8;30.2;0.0
52;2021-06-10;792;955;0;82375;45936;0;55.3;30.8;0.0
52;2021-06-11;840;1319;0;83215;47255;0;55.9;31.7;0.0
52;2021-06-12;465;605;0;83680;47860;0;56.2;32.1;0.0
52;2021-06-13;13;11;0;83693;47871;0;56.2;32.1;0.0
52;2021-06-14;235;1334;0;83928;49205;0;56.4;33.0;0.0
52;2021-06-15;302;1621;0;84230;50826;0;56.6;34.1;0.0
52;2021-06-16;412;1749;0;84642;52575;0;56.8;35.3;0.0
52;2021-06-17;299;1059;0;84941;53634;0;57.0;36.0;0.0
52;2021-06-18;401;1589;0;85342;55223;0;57.3;37.1;0.0
52;2021-06-19;579;725;0;85921;55948;0;57.7;37.6;0.0
52;2021-06-20;4;24;0;85925;55972;0;57.7;37.6;0.0
52;2021-06-21;495;873;0;86420;56845;0;58.0;38.2;0.0
52;2021-06-22;465;1014;0;86885;57859;0;58.3;38.9;0.0
52;2021-06-23;510;1032;0;87395;58891;0;58.7;39.5;0.0
52;2021-06-24;574;781;0;87969;59672;0;59.1;40.1;0.0
52;2021-06-25;635;1334;0;88604;61006;0;59.5;41.0;0.0
52;2021-06-26;327;809;0;88931;61815;0;59.7;41.5;0.0
52;2021-06-27;5;54;0;88936;61869;0;59.7;41.5;0.0
52;2021-06-28;186;1386;0;89122;63255;0;59.8;42.5;0.0
52;2021-06-29;180;1297;0;89302;64552;0;60.0;43.3;0.0
52;2021-06-30;247;1344;0;89549;65896;0;60.1;44.3;0.0
52;2021-07-01;337;1045;0;89886;66941;0;60.4;45.0;0.0
52;2021-07-02;466;1491;0;90352;68432;0;60.7;46.0;0.0
52;2021-07-03;368;1161;0;90720;69593;0;60.9;46.7;0.0
52;2021-07-04;7;45;0;90727;69638;0;60.9;46.8;0.0
52;2021-07-05;228;1377;0;90955;71015;0;61.1;47.7;0.0
52;2021-07-06;332;1368;0;91287;72383;0;61.3;48.6;0.0
52;2021-07-07;338;1143;0;91625;73526;0;61.5;49.4;0.0
52;2021-07-08;459;1173;0;92084;74699;0;61.8;50.2;0.0
52;2021-07-09;348;1559;0;92432;76258;0;62.1;51.2;0.0
52;2021-07-10;208;857;0;92640;77115;0;62.2;51.8;0.0
52;2021-07-11;17;31;0;92657;77146;0;62.2;51.8;0.0
52;2021-07-12;310;1348;0;92967;78494;0;62.4;52.7;0.0
52;2021-07-13;583;1313;0;93550;79807;0;62.8;53.6;0.0
52;2021-07-14;489;192;0;94039;79999;0;63.1;53.7;0.0
52;2021-07-15;636;1343;0;94675;81342;0;63.6;54.6;0.0
52;2021-07-16;939;1363;0;95614;82705;0;64.2;55.5;0.0
52;2021-07-17;660;448;0;96274;83153;0;64.6;55.8;0.0
52;2021-07-18;135;45;0;96409;83198;0;64.7;55.9;0.0
52;2021-07-19;682;982;0;97091;84180;0;65.2;56.5;0.0
52;2021-07-20;1058;909;0;98149;85089;0;65.9;57.1;0.0
52;2021-07-21;1084;788;0;99233;85877;0;66.6;57.7;0.0
52;2021-07-22;1350;912;0;100583;86789;0;67.5;58.3;0.0
52;2021-07-23;1358;1057;0;101941;87846;0;68.5;59.0;0.0
52;2021-07-24;925;551;0;102866;88397;0;69.1;59.4;0.0
52;2021-07-25;45;30;0;102911;88427;0;69.1;59.4;0.0
52;2021-07-26;930;643;0;103841;89070;0;69.7;59.8;0.0
52;2021-07-27;1255;671;0;105096;89741;0;70.6;60.3;0.0
52;2021-07-28;1294;655;0;106390;90396;0;71.4;60.7;0.0
52;2021-07-29;1216;620;0;107606;91016;0;72.3;61.1;0.0
52;2021-07-30;1377;779;0;108983;91795;0;73.2;61.6;0.0
52;2021-07-31;980;594;0;109963;92389;0;73.8;62.0;0.0
52;2021-08-01;21;18;0;109984;92407;0;73.9;62.1;0.0
52;2021-08-02;1155;606;0;111139;93013;0;74.6;62.5;0.0
52;2021-08-03;1302;586;0;112441;93599;0;75.5;62.9;0.0
52;2021-08-04;1131;584;0;113572;94183;0;76.3;63.2;0.0
52;2021-08-05;972;586;0;114544;94769;0;76.9;63.6;0.0
52;2021-08-06;1042;758;0;115586;95527;0;77.6;64.1;0.0
52;2021-08-07;666;505;0;116252;96032;0;78.1;64.5;0.0
52;2021-08-08;14;18;0;116266;96050;0;78.1;64.5;0.0
52;2021-08-09;460;811;0;116726;96861;0;78.4;65.0;0.0
52;2021-08-10;713;793;0;117439;97654;0;78.9;65.6;0.0
52;2021-08-11;564;817;0;118003;98471;0;79.2;66.1;0.0
52;2021-08-12;642;815;0;118645;99286;0;79.7;66.7;0.0
52;2021-08-13;453;1046;0;119098;100332;0;80.0;67.4;0.0
52;2021-08-14;425;394;0;119523;100726;0;80.3;67.6;0.0
52;2021-08-15;36;26;0;119559;100752;0;80.3;67.7;0.0
52;2021-08-16;366;935;0;119925;101687;0;80.5;68.3;0.0
52;2021-08-17;393;908;0;120318;102595;0;80.8;68.9;0.0
52;2021-08-18;475;939;0;120793;103534;0;81.1;69.5;0.0
52;2021-08-19;430;855;0;121223;104389;0;81.4;70.1;0.0
52;2021-08-20;370;1228;0;121593;105617;0;81.7;70.9;0.0
52;2021-08-21;373;672;0;121966;106289;0;81.9;71.4;0.0
52;2021-08-22;10;26;0;121976;106315;0;81.9;71.4;0.0
52;2021-08-23;400;1023;0;122376;107338;0;82.2;72.1;0.0
52;2021-08-24;292;1040;0;122668;108378;0;82.4;72.8;0.0
52;2021-08-25;243;1060;0;122911;109438;0;82.5;73.5;0.0
52;2021-08-26;297;945;0;123208;110383;0;82.7;74.1;0.0
52;2021-08-27;411;1313;0;123619;111696;0;83.0;75.0;0.0
52;2021-08-28;258;585;0;123877;112281;0;83.2;75.4;0.0
52;2021-08-29;9;22;0;123886;112303;0;83.2;75.4;0.0
52;2021-08-30;214;934;22;124100;113237;22;83.3;76.0;0.0
52;2021-08-31;204;963;18;124304;114200;40;83.5;76.7;0.0
52;2021-09-01;189;958;35;124493;115158;75;83.6;77.3;0.1
52;2021-09-02;189;700;67;124682;115858;142;83.7;77.8;0.1
52;2021-09-03;256;849;100;124938;116707;242;83.9;78.4;0.2
52;2021-09-04;206;597;30;125144;117304;272;84.0;78.8;0.2
52;2021-09-05;8;25;3;125152;117329;275;84.0;78.8;0.2
52;2021-09-06;146;504;39;125298;117833;314;84.1;79.1;0.2
52;2021-09-07;178;417;110;125476;118250;424;84.3;79.4;0.3
52;2021-09-08;161;591;54;125637;118841;478;84.4;79.8;0.3
52;2021-09-09;144;360;83;125781;119201;561;84.5;80.0;0.4
52;2021-09-10;257;590;108;126038;119791;669;84.6;80.4;0.4
52;2021-09-11;156;333;31;126194;120124;700;84.7;80.7;0.5
52;2021-09-12;4;15;3;126198;120139;703;84.7;80.7;0.5
52;2021-09-13;179;464;129;126377;120603;832;84.9;81.0;0.6
52;2021-09-14;152;304;145;126529;120907;977;85.0;81.2;0.7
52;2021-09-15;151;424;103;126680;121331;1080;85.1;81.5;0.7
52;2021-09-16;136;288;156;126816;121619;1236;85.2;81.7;0.8
52;2021-09-17;218;485;165;127034;122104;1401;85.3;82.0;0.9
52;2021-09-18;135;271;69;127169;122375;1470;85.4;82.2;1.0
52;2021-09-19;6;24;4;127175;122399;1474;85.4;82.2;1.0
52;2021-09-20;108;321;93;127283;122720;1567;85.5;82.4;1.1
52;2021-09-21;81;205;145;127364;122925;1712;85.5;82.5;1.1
52;2021-09-22;96;283;119;127460;123208;1831;85.6;82.7;1.2
52;2021-09-23;143;213;179;127603;123421;2010;85.7;82.9;1.3
52;2021-09-24;125;288;205;127728;123709;2215;85.8;83.1;1.5
52;2021-09-25;92;252;150;127820;123961;2365;85.8;83.2;1.6
52;2021-09-26;4;6;0;127824;123967;2365;85.8;83.2;1.6
52;2021-09-27;116;177;154;127940;124144;2519;85.9;83.4;1.7
52;2021-09-28;105;122;141;128045;124266;2660;86.0;83.4;1.8
52;2021-09-29;97;215;79;128142;124481;2739;86.0;83.6;1.8
52;2021-09-30;113;127;79;128255;124608;2818;86.1;83.7;1.9
52;2021-10-01;119;230;168;128374;124838;2986;86.2;83.8;2.0
52;2021-10-02;64;164;40;128438;125002;3026;86.2;83.9;2.0
52;2021-10-03;3;7;3;128441;125009;3029;86.3;83.9;2.0
52;2021-10-04;82;177;171;128523;125186;3200;86.3;84.1;2.1
52;2021-10-05;61;142;81;128584;125328;3281;86.3;84.2;2.2
52;2021-10-06;110;162;128;128694;125490;3409;86.4;84.3;2.3
52;2021-10-07;51;111;237;128745;125601;3646;86.5;84.3;2.4
52;2021-10-08;110;211;239;128855;125812;3885;86.5;84.5;2.6
52;2021-10-09;69;131;59;128924;125943;3944;86.6;84.6;2.6
52;2021-10-10;3;5;0;128927;125948;3944;86.6;84.6;2.6
52;2021-10-11;41;154;125;128968;126102;4069;86.6;84.7;2.7
52;2021-10-12;68;103;177;129036;126205;4246;86.6;84.7;2.9
52;2021-10-13;70;96;150;129106;126301;4396;86.7;84.8;3.0
52;2021-10-14;41;51;112;129147;126352;4508;86.7;84.8;3.0
52;2021-10-15;85;231;210;129232;126583;4718;86.8;85.0;3.2
52;2021-10-16;61;111;115;129293;126694;4833;86.8;85.1;3.2
52;2021-10-17;0;3;0;129293;126697;4833;86.8;85.1;3.2
52;2021-10-18;49;167;161;129342;126864;4994;86.9;85.2;3.4
52;2021-10-19;57;106;157;129399;126970;5151;86.9;85.3;3.5
52;2021-10-20;60;75;240;129459;127045;5391;86.9;85.3;3.6
52;2021-10-21;27;73;165;129486;127118;5556;87.0;85.4;3.7
52;2021-10-22;64;152;326;129550;127270;5882;87.0;85.5;3.9
52;2021-10-23;37;83;101;129587;127353;5983;87.0;85.5;4.0
52;2021-10-24;1;0;9;129588;127353;5992;87.0;85.5;4.0
52;2021-10-25;59;88;347;129647;127441;6339;87.1;85.6;4.3
52;2021-10-26;35;53;273;129682;127494;6612;87.1;85.6;4.4
52;2021-10-27;50;67;290;129732;127561;6902;87.1;85.7;4.6
52;2021-10-28;26;32;316;129758;127593;7218;87.1;85.7;4.8
52;2021-10-29;62;108;291;129820;127701;7509;87.2;85.8;5.0
52;2021-10-30;43;76;139;129863;127777;7648;87.2;85.8;5.1
52;2021-10-31;1;4;1;129864;127781;7649;87.2;85.8;5.1
52;2021-11-01;1;1;6;129865;127782;7655;87.2;85.8;5.1
52;2021-11-02;57;66;307;129922;127848;7962;87.2;85.9;5.3
52;2021-11-03;66;84;355;129988;127932;8317;87.3;85.9;5.6
52;2021-11-04;25;35;279;130013;127967;8596;87.3;85.9;5.8
52;2021-11-05;77;117;425;130090;128084;9021;87.4;86.0;6.1
52;2021-11-06;53;62;196;130143;128146;9217;87.4;86.1;6.2
52;2021-11-07;0;1;0;130143;128147;9217;87.4;86.1;6.2
52;2021-11-08;37;68;382;130180;128215;9599;87.4;86.1;6.4
52;2021-11-09;37;67;466;130217;128282;10065;87.4;86.1;6.8
52;2021-11-10;56;94;826;130273;128376;10891;87.5;86.2;7.3
52;2021-11-11;0;6;6;130273;128382;10897;87.5;86.2;7.3
52;2021-11-12;54;88;595;130327;128470;11492;87.5;86.3;7.7
52;2021-11-13;38;47;342;130365;128517;11834;87.5;86.3;7.9
52;2021-11-14;3;1;4;130368;128518;11838;87.5;86.3;7.9
52;2021-11-15;25;56;548;130393;128574;12386;87.6;86.3;8.3
52;2021-11-16;52;72;973;130445;128646;13359;87.6;86.4;9.0
52;2021-11-17;54;55;763;130499;128701;14122;87.6;86.4;9.5
52;2021-11-18;32;39;442;130531;128740;14564;87.7;86.5;9.8
52;2021-11-19;68;73;758;130599;128813;15322;87.7;86.5;10.3
52;2021-11-20;55;55;444;130654;128868;15766;87.7;86.5;10.6
52;2021-11-21;1;1;18;130655;128869;15784;87.7;86.5;10.6
52;2021-11-22;37;24;845;130692;128893;16629;87.8;86.6;11.2
52;2021-11-23;50;28;828;130742;128921;17457;87.8;86.6;11.7
52;2021-11-24;84;63;769;130826;128984;18226;87.9;86.6;12.2
52;2021-11-25;29;24;523;130855;129008;18749;87.9;86.6;12.6
52;2021-11-26;71;69;1355;130926;129077;20104;87.9;86.7;13.5
52;2021-11-27;47;64;932;130973;129141;21036;88.0;86.7;14.1
52;2021-11-28;2;2;17;130975;129143;21053;88.0;86.7;14.1
52;2021-11-29;52;49;1092;131027;129192;22145;88.0;86.8;14.9
52;2021-11-30;58;33;1458;131085;129225;23603;88.0;86.8;15.8
52;2021-12-01;54;40;1345;131139;129265;24948;88.1;86.8;16.8
52;2021-12-02;31;51;1434;131170;129316;26382;88.1;86.8;17.7
52;2021-12-03;46;97;1973;131216;129413;28355;88.1;86.9;19.0
52;2021-12-04;30;46;802;131246;129459;29157;88.1;86.9;19.6
52;2021-12-05;12;9;200;131258;129468;29357;88.1;86.9;19.7
52;2021-12-06;35;45;1539;131293;129513;30896;88.2;87.0;20.7
52;2021-12-07;44;52;2063;131337;129565;32959;88.2;87.0;22.1
52;2021-12-08;36;69;2033;131373;129634;34992;88.2;87.1;23.5
52;2021-12-09;47;47;2184;131420;129681;37176;88.3;87.1;25.0
52;2021-12-10;49;60;2624;131469;129741;39800;88.3;87.1;26.7
52;2021-12-11;49;49;1375;131518;129790;41175;88.3;87.2;27.6
52;2021-12-12;6;9;265;131524;129799;41440;88.3;87.2;27.8
52;2021-12-13;46;50;2049;131570;129849;43489;88.4;87.2;29.2
52;2021-12-14;63;63;2791;131633;129912;46280;88.4;87.2;31.1
52;2021-12-15;36;80;2626;131669;129992;48906;88.4;87.3;32.8
52;2021-12-16;38;80;2354;131707;130072;51260;88.4;87.3;34.4
52;2021-12-17;73;104;2593;131780;130176;53853;88.5;87.4;36.2
52;2021-12-18;30;57;1072;131810;130233;54925;88.5;87.5;36.9
52;2021-12-19;11;9;263;131821;130242;55188;88.5;87.5;37.1
53;2020-12-27;0;0;0;0;0;0;0.0;0.0;0.0
53;2020-12-28;0;0;0;0;0;0;0.0;0.0;0.0
53;2020-12-29;0;0;0;0;0;0;0.0;0.0;0.0
53;2020-12-30;0;0;0;0;0;0;0.0;0.0;0.0
53;2020-12-31;0;0;0;0;0;0;0.0;0.0;0.0
53;2021-01-01;0;0;0;0;0;0;0.0;0.0;0.0
53;2021-01-02;3;1;0;3;1;0;0.0;0.0;0.0
53;2021-01-03;0;0;0;3;1;0;0.0;0.0;0.0
53;2021-01-04;0;0;0;3;1;0;0.0;0.0;0.0
53;2021-01-05;0;0;0;3;1;0;0.0;0.0;0.0
53;2021-01-06;1;0;0;4;1;0;0.0;0.0;0.0
53;2021-01-07;99;0;0;103;1;0;0.0;0.0;0.0
53;2021-01-08;266;1;0;369;2;0;0.1;0.0;0.0
53;2021-01-09;133;1;0;502;3;0;0.2;0.0;0.0
53;2021-01-10;17;0;0;519;3;0;0.2;0.0;0.0
53;2021-01-11;176;1;0;695;4;0;0.3;0.0;0.0
53;2021-01-12;350;2;0;1045;6;0;0.4;0.0;0.0
53;2021-01-13;246;0;0;1291;6;0;0.5;0.0;0.0
53;2021-01-14;279;5;0;1570;11;0;0.6;0.0;0.0
53;2021-01-15;337;5;0;1907;16;0;0.7;0.0;0.0
53;2021-01-16;64;0;0;1971;16;0;0.8;0.0;0.0
53;2021-01-17;34;1;0;2005;17;0;0.8;0.0;0.0
53;2021-01-18;369;0;0;2374;17;0;0.9;0.0;0.0
53;2021-01-19;564;0;0;2938;17;0;1.1;0.0;0.0
53;2021-01-20;590;0;0;3528;17;0;1.3;0.0;0.0
53;2021-01-21;666;3;0;4194;20;0;1.6;0.0;0.0
53;2021-01-22;573;9;0;4767;29;0;1.8;0.0;0.0
53;2021-01-23;159;1;0;4926;30;0;1.9;0.0;0.0
53;2021-01-24;8;0;0;4934;30;0;1.9;0.0;0.0
53;2021-01-25;511;0;0;5445;30;0;2.1;0.0;0.0
53;2021-01-26;1149;7;0;6594;37;0;2.5;0.0;0.0
53;2021-01-27;691;5;0;7285;42;0;2.8;0.0;0.0
53;2021-01-28;676;91;0;7961;133;0;3.0;0.1;0.0
53;2021-01-29;415;171;0;8376;304;0;3.2;0.1;0.0
53;2021-01-30;141;0;0;8517;304;0;3.2;0.1;0.0
53;2021-01-31;0;0;0;8517;304;0;3.2;0.1;0.0
53;2021-02-01;311;145;0;8828;449;0;3.4;0.2;0.0
53;2021-02-02;315;198;0;9143;647;0;3.5;0.2;0.0
53;2021-02-03;228;305;0;9371;952;0;3.6;0.4;0.0
53;2021-02-04;183;315;0;9554;1267;0;3.6;0.5;0.0
53;2021-02-05;242;274;0;9796;1541;0;3.7;0.6;0.0
53;2021-02-06;151;26;0;9947;1567;0;3.8;0.6;0.0
53;2021-02-07;1;1;0;9948;1568;0;3.8;0.6;0.0
53;2021-02-08;178;120;0;10126;1688;0;3.9;0.6;0.0
53;2021-02-09;338;173;0;10464;1861;0;4.0;0.7;0.0
53;2021-02-10;190;312;0;10654;2173;0;4.1;0.8;0.0
53;2021-02-11;378;383;0;11032;2556;0;4.2;1.0;0.0
53;2021-02-12;316;487;0;11348;3043;0;4.3;1.2;0.0
53;2021-02-13;104;112;0;11452;3155;0;4.4;1.2;0.0
53;2021-02-14;0;77;0;11452;3232;0;4.4;1.2;0.0
53;2021-02-15;261;426;0;11713;3658;0;4.5;1.4;0.0
53;2021-02-16;494;782;0;12207;4440;0;4.7;1.7;0.0
53;2021-02-17;390;611;0;12597;5051;0;4.8;1.9;0.0
53;2021-02-18;525;544;0;13122;5595;0;5.0;2.1;0.0
53;2021-02-19;858;369;0;13980;5964;0;5.3;2.3;0.0
53;2021-02-20;143;114;0;14123;6078;0;5.4;2.3;0.0
53;2021-02-21;0;15;0;14123;6093;0;5.4;2.3;0.0
53;2021-02-22;178;517;0;14301;6610;0;5.5;2.5;0.0
53;2021-02-23;83;615;0;14384;7225;0;5.5;2.8;0.0
53;2021-02-24;149;480;0;14533;7705;0;5.5;2.9;0.0
53;2021-02-25;490;351;0;15023;8056;0;5.7;3.1;0.0
53;2021-02-26;459;262;0;15482;8318;0;5.9;3.2;0.0
53;2021-02-27;103;126;0;15585;8444;0;5.9;3.2;0.0
53;2021-02-28;2;5;0;15587;8449;0;5.9;3.2;0.0
53;2021-03-01;242;298;0;15829;8747;0;6.0;3.3;0.0
53;2021-03-02;267;274;0;16096;9021;0;6.1;3.4;0.0
53;2021-03-03;352;351;0;16448;9372;0;6.3;3.6;0.0
53;2021-03-04;892;309;0;17340;9681;0;6.6;3.7;0.0
53;2021-03-05;675;271;0;18015;9952;0;6.9;3.8;0.0
53;2021-03-06;454;212;0;18469;10164;0;7.0;3.9;0.0
53;2021-03-07;294;7;0;18763;10171;0;7.2;3.9;0.0
53;2021-03-08;372;179;0;19135;10350;0;7.3;3.9;0.0
53;2021-03-09;925;224;0;20060;10574;0;7.6;4.0;0.0
53;2021-03-10;856;115;0;20916;10689;0;8.0;4.1;0.0
53;2021-03-11;1307;214;0;22223;10903;0;8.5;4.2;0.0
53;2021-03-12;1637;165;0;23860;11068;0;9.1;4.2;0.0
53;2021-03-13;823;23;0;24683;11091;0;9.4;4.2;0.0
53;2021-03-14;6;4;0;24689;11095;0;9.4;4.2;0.0
53;2021-03-15;981;305;0;25670;11400;0;9.8;4.3;0.0
53;2021-03-16;1010;323;0;26680;11723;0;10.2;4.5;0.0
53;2021-03-17;742;266;0;27422;11989;0;10.5;4.6;0.0
53;2021-03-18;1004;355;0;28426;12344;0;10.8;4.7;0.0
53;2021-03-19;1313;584;0;29739;12928;0;11.3;4.9;0.0
53;2021-03-20;614;19;0;30353;12947;0;11.6;4.9;0.0
53;2021-03-21;4;0;0;30357;12947;0;11.6;4.9;0.0
53;2021-03-22;1182;166;0;31539;13113;0;12.0;5.0;0.0
53;2021-03-23;1697;85;0;33236;13198;0;12.7;5.0;0.0
53;2021-03-24;1356;132;0;34592;13330;0;13.2;5.1;0.0
53;2021-03-25;2248;247;0;36840;13577;0;14.0;5.2;0.0
53;2021-03-26;1915;170;0;38755;13747;0;14.8;5.2;0.0
53;2021-03-27;360;14;0;39115;13761;0;14.9;5.2;0.0
53;2021-03-28;14;3;0;39129;13764;0;14.9;5.2;0.0
53;2021-03-29;1352;225;0;40481;13989;0;15.4;5.3;0.0
53;2021-03-30;1838;218;0;42319;14207;0;16.1;5.4;0.0
53;2021-03-31;1657;226;0;43976;14433;0;16.8;5.5;0.0
53;2021-04-01;1797;661;0;45773;15094;0;17.4;5.8;0.0
53;2021-04-02;1928;213;0;47701;15307;0;18.2;5.8;0.0
53;2021-04-03;395;13;0;48096;15320;0;18.3;5.8;0.0
53;2021-04-04;12;3;0;48108;15323;0;18.3;5.8;0.0
53;2021-04-05;15;13;0;48123;15336;0;18.3;5.8;0.0
53;2021-04-06;1183;538;0;49306;15874;0;18.8;6.0;0.0
53;2021-04-07;1134;955;0;50440;16829;0;19.2;6.4;0.0
53;2021-04-08;1669;1031;0;52109;17860;0;19.9;6.8;0.0
53;2021-04-09;1829;452;0;53938;18312;0;20.6;7.0;0.0
53;2021-04-10;561;15;0;54499;18327;0;20.8;7.0;0.0
53;2021-04-11;23;5;0;54522;18332;0;20.8;7.0;0.0
53;2021-04-12;766;1058;0;55288;19390;0;21.1;7.4;0.0
53;2021-04-13;1542;1101;0;56830;20491;0;21.7;7.8;0.0
53;2021-04-14;1041;780;0;57871;21271;0;22.1;8.1;0.0
53;2021-04-15;1257;1113;0;59128;22384;0;22.5;8.5;0.0
53;2021-04-16;1449;786;0;60577;23170;0;23.1;8.8;0.0
53;2021-04-17;435;304;0;61012;23474;0;23.3;8.9;0.0
53;2021-04-18;33;5;0;61045;23479;0;23.3;8.9;0.0
53;2021-04-19;754;989;0;61799;24468;0;23.6;9.3;0.0
53;2021-04-20;993;1454;0;62792;25922;0;23.9;9.9;0.0
53;2021-04-21;966;1030;0;63758;26952;0;24.3;10.3;0.0
53;2021-04-22;1181;1588;0;64939;28540;0;24.7;10.9;0.0
53;2021-04-23;1431;998;0;66370;29538;0;25.3;11.3;0.0
53;2021-04-24;182;34;0;66552;29572;0;25.4;11.3;0.0
53;2021-04-25;44;44;0;66596;29616;0;25.4;11.3;0.0
53;2021-04-26;484;1119;0;67080;30735;0;25.6;11.7;0.0
53;2021-04-27;932;1788;0;68012;32523;0;25.9;12.4;0.0
53;2021-04-28;1163;1320;0;69175;33843;0;26.4;12.9;0.0
53;2021-04-29;1233;1596;0;70408;35439;0;26.8;13.5;0.0
53;2021-04-30;1552;1279;0;71960;36718;0;27.4;14.0;0.0
53;2021-05-01;156;69;0;72116;36787;0;27.5;14.0;0.0
53;2021-05-02;69;11;0;72185;36798;0;27.5;14.0;0.0
53;2021-05-03;1666;701;0;73851;37499;0;28.1;14.3;0.0
53;2021-05-04;1393;1299;0;75244;38798;0;28.7;14.8;0.0
53;2021-05-05;1699;807;0;76943;39605;0;29.3;15.1;0.0
53;2021-05-06;1508;1323;0;78451;40928;0;29.9;15.6;0.0
53;2021-05-07;1573;1360;0;80024;42288;0;30.5;16.1;0.0
53;2021-05-08;979;70;0;81003;42358;0;30.9;16.1;0.0
53;2021-05-09;70;18;0;81073;42376;0;30.9;16.2;0.0
53;2021-05-10;2451;882;0;83524;43258;0;31.8;16.5;0.0
53;2021-05-11;3112;1341;0;86636;44599;0;33.0;17.0;0.0
53;2021-05-12;2686;1160;0;89322;45759;0;34.0;17.4;0.0
53;2021-05-13;377;49;0;89699;45808;0;34.2;17.5;0.0
53;2021-05-14;1942;711;0;91641;46519;0;34.9;17.7;0.0
53;2021-05-15;1163;130;0;92804;46649;0;35.4;17.8;0.0
53;2021-05-16;100;13;0;92904;46662;0;35.4;17.8;0.0
53;2021-05-17;1695;1308;0;94599;47970;0;36.1;18.3;0.0
53;2021-05-18;1912;1545;0;96511;49515;0;36.8;18.9;0.0
53;2021-05-19;2446;799;0;98957;50314;0;37.7;19.2;0.0
53;2021-05-20;3058;929;0;102015;51243;0;38.9;19.5;0.0
53;2021-05-21;2664;943;0;104679;52186;0;39.9;19.9;0.0
53;2021-05-22;246;108;0;104925;52294;0;40.0;19.9;0.0
53;2021-05-23;79;3;0;105004;52297;0;40.0;19.9;0.0
53;2021-05-24;145;17;0;105149;52314;0;40.1;19.9;0.0
53;2021-05-25;1798;847;0;106947;53161;0;40.8;20.3;0.0
53;2021-05-26;1817;939;0;108764;54100;0;41.5;20.6;0.0
53;2021-05-27;2967;1102;0;111731;55202;0;42.6;21.0;0.0
53;2021-05-28;2483;1028;0;114214;56230;0;43.5;21.4;0.0
53;2021-05-29;972;283;0;115186;56513;0;43.9;21.5;0.0
53;2021-05-30;45;12;0;115231;56525;0;43.9;21.5;0.0
53;2021-05-31;2456;903;0;117687;57428;0;44.9;21.9;0.0
53;2021-06-01;3224;1313;0;120911;58741;0;46.1;22.4;0.0
53;2021-06-02;2846;624;0;123757;59365;0;47.2;22.6;0.0
53;2021-06-03;3740;857;0;127497;60222;0;48.6;23.0;0.0
53;2021-06-04;2893;1368;0;130390;61590;0;49.7;23.5;0.0
53;2021-06-05;340;342;0;130730;61932;0;49.8;23.6;0.0
53;2021-06-06;35;47;0;130765;61979;0;49.8;23.6;0.0
53;2021-06-07;2476;1082;0;133241;63061;0;50.8;24.0;0.0
53;2021-06-08;3182;1239;0;136423;64300;0;52.0;24.5;0.0
53;2021-06-09;2248;1023;0;138671;65323;0;52.9;24.9;0.0
53;2021-06-10;3137;928;0;141808;66251;0;54.0;25.2;0.0
53;2021-06-11;2687;1383;0;144495;67634;0;55.1;25.8;0.0
53;2021-06-12;263;268;0;144758;67902;0;55.2;25.9;0.0
53;2021-06-13;56;61;0;144814;67963;0;55.2;25.9;0.0
53;2021-06-14;1502;1878;0;146316;69841;0;55.8;26.6;0.0
53;2021-06-15;1818;2344;0;148134;72185;0;56.5;27.5;0.0
53;2021-06-16;1710;1838;0;149844;74023;0;57.1;28.2;0.0
53;2021-06-17;2725;1681;0;152569;75704;0;58.1;28.9;0.0
53;2021-06-18;2508;1838;0;155077;77542;0;59.1;29.6;0.0
53;2021-06-19;744;1216;0;155821;78758;0;59.4;30.0;0.0
53;2021-06-20;35;465;0;155856;79223;0;59.4;30.2;0.0
53;2021-06-21;946;2623;0;156802;81846;0;59.8;31.2;0.0
53;2021-06-22;1298;3439;0;158100;85285;0;60.3;32.5;0.0
53;2021-06-23;1325;2864;0;159425;88149;0;60.8;33.6;0.0
53;2021-06-24;1684;2068;0;161109;90217;0;61.4;34.4;0.0
53;2021-06-25;1705;2184;0;162814;92401;0;62.1;35.2;0.0
53;2021-06-26;982;484;0;163796;92885;0;62.4;35.4;0.0
53;2021-06-27;23;92;0;163819;92977;0;62.4;35.4;0.0
53;2021-06-28;661;2945;0;164480;95922;0;62.7;36.6;0.0
53;2021-06-29;875;3584;0;165355;99506;0;63.0;37.9;0.0
53;2021-06-30;784;1639;0;166139;101145;0;63.3;38.5;0.0
53;2021-07-01;1406;2558;1;167545;103703;1;63.9;39.5;0.0
53;2021-07-02;1470;2078;0;169015;105781;1;64.4;40.3;0.0
53;2021-07-03;851;723;0;169866;106504;1;64.7;40.6;0.0
53;2021-07-04;11;89;0;169877;106593;1;64.7;40.6;0.0
53;2021-07-05;581;2130;0;170458;108723;1;65.0;41.4;0.0
53;2021-07-06;857;3526;0;171315;112249;1;65.3;42.8;0.0
53;2021-07-07;1016;2609;0;172331;114858;1;65.7;43.8;0.0
53;2021-07-08;1236;2988;0;173567;117846;1;66.2;44.9;0.0
53;2021-07-09;1022;3284;0;174589;121130;1;66.5;46.2;0.0
53;2021-07-10;386;1081;0;174975;122211;1;66.7;46.6;0.0
53;2021-07-11;40;66;0;175015;122277;1;66.7;46.6;0.0
53;2021-07-12;521;3518;0;175536;125795;1;66.9;47.9;0.0
53;2021-07-13;902;4416;0;176438;130211;1;67.2;49.6;0.0
53;2021-07-14;205;266;0;176643;130477;1;67.3;49.7;0.0
53;2021-07-15;1161;4039;0;177804;134516;1;67.8;51.3;0.0
53;2021-07-16;1259;3658;0;179063;138174;1;68.2;52.7;0.0
53;2021-07-17;1374;564;0;180437;138738;1;68.8;52.9;0.0
53;2021-07-18;168;65;0;180605;138803;1;68.8;52.9;0.0
53;2021-07-19;821;3285;0;181426;142088;1;69.1;54.2;0.0
53;2021-07-20;1061;3842;0;182487;145930;1;69.6;55.6;0.0
53;2021-07-21;915;3090;0;183402;149020;1;69.9;56.8;0.0
53;2021-07-22;1600;3246;0;185002;152266;1;70.5;58.0;0.0
53;2021-07-23;1607;3575;0;186609;155841;1;71.1;59.4;0.0
53;2021-07-24;919;477;0;187528;156318;1;71.5;59.6;0.0
53;2021-07-25;103;78;0;187631;156396;1;71.5;59.6;0.0
53;2021-07-26;1645;1959;0;189276;158355;1;72.1;60.4;0.0
53;2021-07-27;2266;2680;0;191542;161035;1;73.0;61.4;0.0
53;2021-07-28;2040;2644;0;193582;163679;1;73.8;62.4;0.0
53;2021-07-29;2365;2393;0;195947;166072;1;74.7;63.3;0.0
53;2021-07-30;1870;2491;0;197817;168563;1;75.4;64.2;0.0
53;2021-07-31;741;400;0;198558;168963;1;75.7;64.4;0.0
53;2021-08-01;131;61;0;198689;169024;1;75.7;64.4;0.0
53;2021-08-02;1915;1708;0;200604;170732;1;76.5;65.1;0.0
53;2021-08-03;2290;1913;0;202894;172645;1;77.3;65.8;0.0
53;2021-08-04;2457;1741;0;205351;174386;1;78.3;66.5;0.0
53;2021-08-05;2613;1430;0;207964;175816;1;79.3;67.0;0.0
53;2021-08-06;2299;1688;0;210263;177504;1;80.1;67.7;0.0
53;2021-08-07;572;343;0;210835;177847;1;80.4;67.8;0.0
53;2021-08-08;81;79;0;210916;177926;1;80.4;67.8;0.0
53;2021-08-09;1720;1598;0;212636;179524;1;81.0;68.4;0.0
53;2021-08-10;2211;1684;0;214847;181208;1;81.9;69.1;0.0
53;2021-08-11;1678;958;0;216525;182166;1;82.5;69.4;0.0
53;2021-08-12;1876;1050;0;218401;183216;1;83.2;69.8;0.0
53;2021-08-13;1864;1295;0;220265;184511;1;83.9;70.3;0.0
53;2021-08-14;180;256;0;220445;184767;1;84.0;70.4;0.0
53;2021-08-15;26;20;0;220471;184787;1;84.0;70.4;0.0
53;2021-08-16;1252;1648;0;221723;186435;1;84.5;71.1;0.0
53;2021-08-17;1461;1667;0;223184;188102;1;85.1;71.7;0.0
53;2021-08-18;1449;1615;0;224633;189717;1;85.6;72.3;0.0
53;2021-08-19;1299;1816;0;225932;191533;1;86.1;73.0;0.0
53;2021-08-20;1066;2043;0;226998;193576;1;86.5;73.8;0.0
53;2021-08-21;208;471;0;227206;194047;1;86.6;74.0;0.0
53;2021-08-22;24;72;0;227230;194119;1;86.6;74.0;0.0
53;2021-08-23;828;1924;0;228058;196043;1;86.9;74.7;0.0
53;2021-08-24;919;2146;0;228977;198189;1;87.3;75.5;0.0
53;2021-08-25;876;2137;0;229853;200326;1;87.6;76.3;0.0
53;2021-08-26;610;2369;0;230463;202695;1;87.8;77.3;0.0
53;2021-08-27;738;2464;0;231201;205159;1;88.1;78.2;0.0
53;2021-08-28;121;407;0;231322;205566;1;88.2;78.3;0.0
53;2021-08-29;15;80;0;231337;205646;1;88.2;78.4;0.0
53;2021-08-30;592;2050;25;231929;207696;26;88.4;79.2;0.0
53;2021-08-31;742;2647;63;232671;210343;89;88.7;80.2;0.0
53;2021-09-01;395;1579;96;233066;211922;185;88.8;80.8;0.1
53;2021-09-02;435;1578;115;233501;213500;300;89.0;81.4;0.1
53;2021-09-03;455;2169;162;233956;215669;462;89.2;82.2;0.2
53;2021-09-04;160;415;33;234116;216084;495;89.2;82.4;0.2
53;2021-09-05;8;34;2;234124;216118;497;89.2;82.4;0.2
53;2021-09-06;310;1385;192;234434;217503;689;89.3;82.9;0.3
53;2021-09-07;287;1633;165;234721;219136;854;89.5;83.5;0.3
53;2021-09-08;423;1902;162;235144;221038;1016;89.6;84.2;0.4
53;2021-09-09;255;1316;116;235399;222354;1132;89.7;84.7;0.4
53;2021-09-10;382;1659;232;235781;224013;1364;89.9;85.4;0.5
53;2021-09-11;82;282;40;235863;224295;1404;89.9;85.5;0.5
53;2021-09-12;1;14;1;235864;224309;1405;89.9;85.5;0.5
53;2021-09-13;256;952;228;236120;225261;1633;90.0;85.9;0.6
53;2021-09-14;232;821;186;236352;226082;1819;90.1;86.2;0.7
53;2021-09-15;357;1076;342;236709;227158;2161;90.2;86.6;0.8
53;2021-09-16;300;409;283;237009;227567;2444;90.3;86.7;0.9
53;2021-09-17;399;962;310;237408;228529;2754;90.5;87.1;1.0
53;2021-09-18;73;207;30;237481;228736;2784;90.5;87.2;1.1
53;2021-09-19;12;15;0;237493;228751;2784;90.5;87.2;1.1
53;2021-09-20;145;391;173;237638;229142;2957;90.6;87.3;1.1
53;2021-09-21;228;619;244;237866;229761;3201;90.7;87.6;1.2
53;2021-09-22;199;698;229;238065;230459;3430;90.7;87.8;1.3
53;2021-09-23;138;374;663;238203;230833;4093;90.8;88.0;1.6
53;2021-09-24;206;648;256;238409;231481;4349;90.9;88.2;1.7
53;2021-09-25;47;155;45;238456;231636;4394;90.9;88.3;1.7
53;2021-09-26;0;4;0;238456;231640;4394;90.9;88.3;1.7
53;2021-09-27;156;380;307;238612;232020;4701;90.9;88.4;1.8
53;2021-09-28;170;303;323;238782;232323;5024;91.0;88.5;1.9
53;2021-09-29;163;501;301;238945;232824;5325;91.1;88.7;2.0
53;2021-09-30;98;220;268;239043;233044;5593;91.1;88.8;2.1
53;2021-10-01;259;586;398;239302;233630;5991;91.2;89.0;2.3
53;2021-10-02;54;114;31;239356;233744;6022;91.2;89.1;2.3
53;2021-10-03;6;8;4;239362;233752;6026;91.2;89.1;2.3
53;2021-10-04;135;276;459;239497;234028;6485;91.3;89.2;2.5
53;2021-10-05;116;216;472;239613;234244;6957;91.3;89.3;2.7
53;2021-10-06;194;364;425;239807;234608;7382;91.4;89.4;2.8
53;2021-10-07;89;295;154;239896;234903;7536;91.4;89.5;2.9
53;2021-10-08;237;494;571;240133;235397;8107;91.5;89.7;3.1
53;2021-10-09;41;73;22;240174;235470;8129;91.5;89.7;3.1
53;2021-10-10;1;2;1;240175;235472;8130;91.5;89.7;3.1
53;2021-10-11;111;171;484;240286;235643;8614;91.6;89.8;3.3
53;2021-10-12;103;221;472;240389;235864;9086;91.6;89.9;3.5
53;2021-10-13;121;235;471;240510;236099;9557;91.7;90.0;3.6
53;2021-10-14;82;129;267;240592;236228;9824;91.7;90.0;3.7
53;2021-10-15;212;350;754;240804;236578;10578;91.8;90.2;4.0
53;2021-10-16;42;68;35;240846;236646;10613;91.8;90.2;4.0
53;2021-10-17;1;2;0;240847;236648;10613;91.8;90.2;4.0
53;2021-10-18;160;205;602;241007;236853;11215;91.9;90.3;4.3
53;2021-10-19;74;190;520;241081;237043;11735;91.9;90.3;4.5
53;2021-10-20;67;149;594;241148;237192;12329;91.9;90.4;4.7
53;2021-10-21;24;83;349;241172;237275;12678;91.9;90.4;4.8
53;2021-10-22;72;292;696;241244;237567;13374;91.9;90.5;5.1
53;2021-10-23;15;48;53;241259;237615;13427;91.9;90.6;5.1
53;2021-10-24;2;2;0;241261;237617;13427;92.0;90.6;5.1
53;2021-10-25;54;119;623;241315;237736;14050;92.0;90.6;5.4
53;2021-10-26;47;94;598;241362;237830;14648;92.0;90.6;5.6
53;2021-10-27;69;149;810;241431;237979;15458;92.0;90.7;5.9
53;2021-10-28;32;66;524;241463;238045;15982;92.0;90.7;6.1
53;2021-10-29;69;246;829;241532;238291;16811;92.1;90.8;6.4
53;2021-10-30;12;32;70;241544;238323;16881;92.1;90.8;6.4
53;2021-10-31;0;2;0;241544;238325;16881;92.1;90.8;6.4
53;2021-11-01;0;2;5;241544;238327;16886;92.1;90.8;6.4
53;2021-11-02;65;150;878;241609;238477;17764;92.1;90.9;6.8
53;2021-11-03;73;132;702;241682;238609;18466;92.1;90.9;7.0
53;2021-11-04;42;95;679;241724;238704;19145;92.1;91.0;7.3
53;2021-11-05;81;215;956;241805;238919;20101;92.2;91.1;7.7
53;2021-11-06;12;49;98;241817;238968;20199;92.2;91.1;7.7
53;2021-11-07;0;1;11;241817;238969;20210;92.2;91.1;7.7
53;2021-11-08;31;147;906;241848;239116;21116;92.2;91.1;8.0
53;2021-11-09;45;124;1132;241893;239240;22248;92.2;91.2;8.5
53;2021-11-10;78;112;1071;241971;239352;23319;92.2;91.2;8.9
53;2021-11-11;3;1;29;241974;239353;23348;92.2;91.2;8.9
53;2021-11-12;34;44;563;242008;239397;23911;92.2;91.2;9.1
53;2021-11-13;11;32;131;242019;239429;24042;92.2;91.3;9.2
53;2021-11-14;0;2;6;242019;239431;24048;92.2;91.3;9.2
53;2021-11-15;45;67;1184;242064;239498;25232;92.3;91.3;9.6
53;2021-11-16;30;57;792;242094;239555;26024;92.3;91.3;9.9
53;2021-11-17;60;66;1082;242154;239621;27106;92.3;91.3;10.3
53;2021-11-18;38;63;1112;242192;239684;28218;92.3;91.3;10.8
53;2021-11-19;81;113;1471;242273;239797;29689;92.3;91.4;11.3
53;2021-11-20;15;18;127;242288;239815;29816;92.3;91.4;11.4
53;2021-11-21;2;0;8;242290;239815;29824;92.3;91.4;11.4
53;2021-11-22;45;25;1199;242335;239840;31023;92.4;91.4;11.8
53;2021-11-23;40;35;1112;242375;239875;32135;92.4;91.4;12.2
53;2021-11-24;78;104;1159;242453;239979;33294;92.4;91.5;12.7
53;2021-11-25;49;54;1237;242502;240033;34531;92.4;91.5;13.2
53;2021-11-26;116;97;2388;242618;240130;36919;92.5;91.5;14.1
53;2021-11-27;15;23;280;242633;240153;37199;92.5;91.5;14.2
53;2021-11-28;4;1;61;242637;240154;37260;92.5;91.5;14.2
53;2021-11-29;51;56;2460;242688;240210;39720;92.5;91.6;15.1
53;2021-11-30;35;50;2106;242723;240260;41826;92.5;91.6;15.9
53;2021-12-01;63;81;2494;242786;240341;44320;92.5;91.6;16.9
53;2021-12-02;35;19;2133;242821;240360;46453;92.5;91.6;17.7
53;2021-12-03;63;78;3578;242884;240438;50031;92.6;91.6;19.1
53;2021-12-04;28;24;1111;242912;240462;51142;92.6;91.6;19.5
53;2021-12-05;0;3;77;242912;240465;51219;92.6;91.6;19.5
53;2021-12-06;33;45;3288;242945;240510;54507;92.6;91.7;20.8
53;2021-12-07;44;35;3266;242989;240545;57773;92.6;91.7;22.0
53;2021-12-08;43;83;2849;243032;240628;60622;92.6;91.7;23.1
53;2021-12-09;54;36;4366;243086;240664;64988;92.6;91.7;24.8
53;2021-12-10;53;70;3871;243139;240734;68859;92.7;91.7;26.2
53;2021-12-11;32;21;1557;243171;240755;70416;92.7;91.8;26.8
53;2021-12-12;7;5;151;243178;240760;70567;92.7;91.8;26.9
53;2021-12-13;27;52;3612;243205;240812;74179;92.7;91.8;28.3
53;2021-12-14;42;53;3630;243247;240865;77809;92.7;91.8;29.7
53;2021-12-15;34;79;3375;243281;240944;81184;92.7;91.8;30.9
53;2021-12-16;52;53;4276;243333;240997;85460;92.7;91.9;32.6
53;2021-12-17;55;123;4959;243388;241120;90419;92.8;91.9;34.5
53;2021-12-18;23;31;1928;243411;241151;92347;92.8;91.9;35.2
53;2021-12-19;2;2;106;243413;241153;92453;92.8;91.9;35.2
54;2020-12-27;0;0;0;0;0;0;0.0;0.0;0.0
54;2020-12-28;3;0;0;3;0;0;0.0;0.0;0.0
54;2020-12-29;0;0;0;3;0;0;0.0;0.0;0.0
54;2020-12-30;2;0;0;5;0;0;0.0;0.0;0.0
54;2020-12-31;9;0;0;14;0;0;0.0;0.0;0.0
54;2021-01-01;1;0;0;15;0;0;0.0;0.0;0.0
54;2021-01-02;0;0;0;15;0;0;0.0;0.0;0.0
54;2021-01-03;2;0;0;17;0;0;0.0;0.0;0.0
54;2021-01-04;156;0;0;173;0;0;0.0;0.0;0.0
54;2021-01-05;387;1;0;560;1;0;0.1;0.0;0.0
54;2021-01-06;621;1;0;1181;2;0;0.2;0.0;0.0
54;2021-01-07;798;2;0;1979;4;0;0.3;0.0;0.0
54;2021-01-08;692;3;0;2671;7;0;0.4;0.0;0.0
54;2021-01-09;109;0;0;2780;7;0;0.4;0.0;0.0
54;2021-01-10;72;0;0;2852;7;0;0.4;0.0;0.0
54;2021-01-11;950;3;0;3802;10;0;0.6;0.0;0.0
54;2021-01-12;1165;2;0;4967;12;0;0.8;0.0;0.0
54;2021-01-13;2397;7;0;7364;19;0;1.2;0.0;0.0
54;2021-01-14;3263;26;0;10627;45;0;1.7;0.0;0.0
54;2021-01-15;2617;20;0;13244;65;0;2.1;0.0;0.0
54;2021-01-16;813;4;0;14057;69;0;2.2;0.0;0.0
54;2021-01-17;218;0;0;14275;69;0;2.3;0.0;0.0
54;2021-01-18;1575;6;0;15850;75;0;2.5;0.0;0.0
54;2021-01-19;1676;2;0;17526;77;0;2.8;0.0;0.0
54;2021-01-20;1572;5;0;19098;82;0;3.0;0.0;0.0
54;2021-01-21;1452;4;0;20550;86;0;3.2;0.0;0.0
54;2021-01-22;1143;8;0;21693;94;0;3.4;0.0;0.0
54;2021-01-23;479;1;0;22172;95;0;3.5;0.0;0.0
54;2021-01-24;76;0;0;22248;95;0;3.5;0.0;0.0
54;2021-01-25;973;41;0;23221;136;0;3.7;0.0;0.0
54;2021-01-26;223;18;0;23444;154;0;3.7;0.0;0.0
54;2021-01-27;94;175;0;23538;329;0;3.7;0.1;0.0
54;2021-01-28;117;245;0;23655;574;0;3.7;0.1;0.0
54;2021-01-29;61;287;0;23716;861;0;3.7;0.1;0.0
54;2021-01-30;30;14;0;23746;875;0;3.7;0.1;0.0
54;2021-01-31;2;0;0;23748;875;0;3.7;0.1;0.0
54;2021-02-01;45;783;0;23793;1658;0;3.8;0.3;0.0
54;2021-02-02;77;960;0;23870;2618;0;3.8;0.4;0.0
54;2021-02-03;392;1496;0;24262;4114;0;3.8;0.6;0.0
54;2021-02-04;728;2369;0;24990;6483;0;3.9;1.0;0.0
54;2021-02-05;775;1800;0;25765;8283;0;4.1;1.3;0.0
54;2021-02-06;224;349;0;25989;8632;0;4.1;1.4;0.0
54;2021-02-07;5;129;0;25994;8761;0;4.1;1.4;0.0
54;2021-02-08;169;1031;0;26163;9792;0;4.1;1.5;0.0
54;2021-02-09;361;1074;0;26524;10866;0;4.2;1.7;0.0
54;2021-02-10;405;821;0;26929;11687;0;4.2;1.8;0.0
54;2021-02-11;371;894;0;27300;12581;0;4.3;2.0;0.0
54;2021-02-12;513;1301;0;27813;13882;0;4.4;2.2;0.0
54;2021-02-13;174;240;0;27987;14122;0;4.4;2.2;0.0
54;2021-02-14;32;24;0;28019;14146;0;4.4;2.2;0.0
54;2021-02-15;432;1147;0;28451;15293;0;4.5;2.4;0.0
54;2021-02-16;449;1217;0;28900;16510;0;4.6;2.6;0.0
54;2021-02-17;568;1004;0;29468;17514;0;4.6;2.8;0.0
54;2021-02-18;627;848;0;30095;18362;0;4.7;2.9;0.0
54;2021-02-19;557;762;0;30652;19124;0;4.8;3.0;0.0
54;2021-02-20;73;302;0;30725;19426;0;4.8;3.1;0.0
54;2021-02-21;5;25;0;30730;19451;0;4.8;3.1;0.0
54;2021-02-22;538;660;0;31268;20111;0;4.9;3.2;0.0
54;2021-02-23;827;553;0;32095;20664;0;5.1;3.3;0.0
54;2021-02-24;828;396;0;32923;21060;0;5.2;3.3;0.0
54;2021-02-25;1541;722;0;34464;21782;0;5.4;3.4;0.0
54;2021-02-26;1932;768;0;36396;22550;0;5.7;3.6;0.0
54;2021-02-27;899;132;0;37295;22682;0;5.9;3.6;0.0
54;2021-02-28;106;31;0;37401;22713;0;5.9;3.6;0.0
54;2021-03-01;697;244;0;38098;22957;0;6.0;3.6;0.0
54;2021-03-02;1575;222;0;39673;23179;0;6.3;3.7;0.0
54;2021-03-03;1813;116;0;41486;23295;0;6.5;3.7;0.0
54;2021-03-04;2109;168;0;43595;23463;0;6.9;3.7;0.0
54;2021-03-05;2933;200;0;46528;23663;0;7.3;3.7;0.0
54;2021-03-06;4303;136;0;50831;23799;0;8.0;3.8;0.0
54;2021-03-07;2827;81;0;53658;23880;0;8.5;3.8;0.0
54;2021-03-08;1341;118;0;54999;23998;0;8.7;3.8;0.0
54;2021-03-09;2689;162;0;57688;24160;0;9.1;3.8;0.0
54;2021-03-10;3181;152;0;60869;24312;0;9.6;3.8;0.0
54;2021-03-11;3404;166;0;64273;24478;0;10.1;3.9;0.0
54;2021-03-12;5015;240;0;69288;24718;0;10.9;3.9;0.0
54;2021-03-13;4256;157;0;73544;24875;0;11.6;3.9;0.0
54;2021-03-14;559;50;0;74103;24925;0;11.7;3.9;0.0
54;2021-03-15;1695;135;0;75798;25060;0;12.0;4.0;0.0
54;2021-03-16;1790;225;0;77588;25285;0;12.2;4.0;0.0
54;2021-03-17;2001;209;0;79589;25494;0;12.6;4.0;0.0
54;2021-03-18;2045;236;0;81634;25730;0;12.9;4.1;0.0
54;2021-03-19;3336;321;0;84970;26051;0;13.4;4.1;0.0
54;2021-03-20;2395;99;0;87365;26150;0;13.8;4.1;0.0
54;2021-03-21;318;19;0;87683;26169;0;13.8;4.1;0.0
54;2021-03-22;1198;378;0;88881;26547;0;14.0;4.2;0.0
54;2021-03-23;2005;645;0;90886;27192;0;14.3;4.3;0.0
54;2021-03-24;2216;748;0;93102;27940;0;14.7;4.4;0.0
54;2021-03-25;3287;799;0;96389;28739;0;15.2;4.5;0.0
54;2021-03-26;3647;893;0;100036;29632;0;15.8;4.7;0.0
54;2021-03-27;2306;434;0;102342;30066;0;16.1;4.7;0.0
54;2021-03-28;264;110;0;102606;30176;0;16.2;4.8;0.0
54;2021-03-29;1694;455;0;104300;30631;0;16.5;4.8;0.0
54;2021-03-30;2566;1113;0;106866;31744;0;16.9;5.0;0.0
54;2021-03-31;2577;1224;0;109443;32968;0;17.3;5.2;0.0
54;2021-04-01;3107;1364;0;112550;34332;0;17.8;5.4;0.0
54;2021-04-02;2941;1798;0;115491;36130;0;18.2;5.7;0.0
54;2021-04-03;1344;1447;0;116835;37577;0;18.4;5.9;0.0
54;2021-04-04;145;425;0;116980;38002;0;18.5;6.0;0.0
54;2021-04-05;240;566;0;117220;38568;0;18.5;6.1;0.0
54;2021-04-06;1389;1708;0;118609;40276;0;18.7;6.4;0.0
54;2021-04-07;1195;2343;0;119804;42619;0;18.9;6.7;0.0
54;2021-04-08;2604;2505;0;122408;45124;0;19.3;7.1;0.0
54;2021-04-09;4359;3096;0;126767;48220;0;20.0;7.6;0.0
54;2021-04-10;3197;1852;0;129964;50072;0;20.5;7.9;0.0
54;2021-04-11;202;985;0;130166;51057;0;20.5;8.1;0.0
54;2021-04-12;2316;1565;0;132482;52622;0;20.9;8.3;0.0
54;2021-04-13;3121;1965;0;135603;54587;0;21.4;8.6;0.0
54;2021-04-14;3394;1882;0;138997;56469;0;21.9;8.9;0.0
54;2021-04-15;3089;2348;0;142086;58817;0;22.4;9.3;0.0
54;2021-04-16;3190;2691;0;145276;61508;0;22.9;9.7;0.0
54;2021-04-17;3294;1541;0;148570;63049;0;23.4;9.9;0.0
54;2021-04-18;185;273;0;148755;63322;0;23.5;10.0;0.0
54;2021-04-19;2529;1133;0;151284;64455;0;23.9;10.2;0.0
54;2021-04-20;3066;1335;0;154350;65790;0;24.3;10.4;0.0
54;2021-04-21;3794;1604;0;158144;67394;0;24.9;10.6;0.0
54;2021-04-22;3583;2357;0;161727;69751;0;25.5;11.0;0.0
54;2021-04-23;3769;2190;0;165496;71941;0;26.1;11.3;0.0
54;2021-04-24;2267;995;0;167763;72936;0;26.5;11.5;0.0
54;2021-04-25;289;276;0;168052;73212;0;26.5;11.5;0.0
54;2021-04-26;2284;1376;0;170336;74588;0;26.9;11.8;0.0
54;2021-04-27;3161;1402;0;173497;75990;0;27.4;12.0;0.0
54;2021-04-28;2701;1944;0;176198;77934;0;27.8;12.3;0.0
54;2021-04-29;3707;2116;0;179905;80050;0;28.4;12.6;0.0
54;2021-04-30;4483;2070;0;184388;82120;0;29.1;13.0;0.0
54;2021-05-01;2189;799;0;186577;82919;0;29.4;13.1;0.0
54;2021-05-02;276;89;0;186853;83008;0;29.5;13.1;0.0
54;2021-05-03;3057;1093;0;189910;84101;0;30.0;13.3;0.0
54;2021-05-04;3511;1640;0;193421;85741;0;30.5;13.5;0.0
54;2021-05-05;4821;1693;0;198242;87434;0;31.3;13.8;0.0
54;2021-05-06;4539;2878;0;202781;90312;0;32.0;14.2;0.0
54;2021-05-07;5011;3505;0;207792;93817;0;32.8;14.8;0.0
54;2021-05-08;2072;670;0;209864;94487;0;33.1;14.9;0.0
54;2021-05-09;502;184;0;210366;94671;0;33.2;14.9;0.0
54;2021-05-10;3186;2359;0;213552;97030;0;33.7;15.3;0.0
54;2021-05-11;5424;3114;0;218976;100144;0;34.5;15.8;0.0
54;2021-05-12;4215;3507;0;223191;103651;0;35.2;16.4;0.0
54;2021-05-13;2732;516;0;225923;104167;0;35.6;16.4;0.0
54;2021-05-14;6806;2080;0;232729;106247;0;36.7;16.8;0.0
54;2021-05-15;5333;1315;0;238062;107562;0;37.6;17.0;0.0
54;2021-05-16;1066;117;0;239128;107679;0;37.7;17.0;0.0
54;2021-05-17;3718;903;0;242846;108582;0;38.3;17.1;0.0
54;2021-05-18;3412;1224;0;246258;109806;0;38.8;17.3;0.0
54;2021-05-19;3658;1545;0;249916;111351;0;39.4;17.6;0.0
54;2021-05-20;4494;1674;0;254410;113025;0;40.1;17.8;0.0
54;2021-05-21;6437;2543;0;260847;115568;0;41.1;18.2;0.0
54;2021-05-22;5224;1379;0;266071;116947;0;42.0;18.4;0.0
54;2021-05-23;516;89;0;266587;117036;0;42.1;18.5;0.0
54;2021-05-24;1426;352;0;268013;117388;0;42.3;18.5;0.0
54;2021-05-25;4057;1626;0;272070;119014;0;42.9;18.8;0.0
54;2021-05-26;3432;2265;0;275502;121279;0;43.5;19.1;0.0
54;2021-05-27;3861;2437;0;279363;123716;0;44.1;19.5;0.0
54;2021-05-28;4918;3665;0;284281;127381;0;44.8;20.1;0.0
54;2021-05-29;3793;3908;0;288074;131289;0;45.4;20.7;0.0
54;2021-05-30;202;146;0;288276;131435;0;45.5;20.7;0.0
54;2021-05-31;2910;3073;0;291186;134508;0;45.9;21.2;0.0
54;2021-06-01;2915;4176;0;294101;138684;0;46.4;21.9;0.0
54;2021-06-02;2525;3804;0;296626;142488;0;46.8;22.5;0.0
54;2021-06-03;3169;5199;0;299795;147687;0;47.3;23.3;0.0
54;2021-06-04;5219;5357;0;305014;153044;0;48.1;24.1;0.0
54;2021-06-05;2588;3210;0;307602;156254;0;48.5;24.6;0.0
54;2021-06-06;194;259;0;307796;156513;0;48.6;24.7;0.0
54;2021-06-07;3623;2871;0;311419;159384;0;49.1;25.1;0.0
54;2021-06-08;4497;4124;0;315916;163508;0;49.8;25.8;0.0
54;2021-06-09;5769;3140;0;321685;166648;0;50.7;26.3;0.0
54;2021-06-10;5170;4369;0;326855;171017;0;51.6;27.0;0.0
54;2021-06-11;4866;4922;0;331721;175939;0;52.3;27.8;0.0
54;2021-06-12;3958;3117;0;335679;179056;0;53.0;28.2;0.0
54;2021-06-13;142;254;0;335821;179310;0;53.0;28.3;0.0
54;2021-06-14;2351;3635;0;338172;182945;0;53.3;28.9;0.0
54;2021-06-15;2944;4805;0;341116;187750;0;53.8;29.6;0.0
54;2021-06-16;3350;5598;0;344466;193348;0;54.3;30.5;0.0
54;2021-06-17;3101;5277;0;347567;198625;0;54.8;31.3;0.0
54;2021-06-18;3980;6234;0;351547;204859;0;55.5;32.3;0.0
54;2021-06-19;2622;3106;0;354169;207965;0;55.9;32.8;0.0
54;2021-06-20;124;336;0;354293;208301;0;55.9;32.9;0.0
54;2021-06-21;2337;4700;0;356630;213001;0;56.3;33.6;0.0
54;2021-06-22;1947;6173;0;358577;219174;0;56.6;34.6;0.0
54;2021-06-23;2193;5544;0;360770;224718;0;56.9;35.4;0.0
54;2021-06-24;1958;3477;0;362728;228195;0;57.2;36.0;0.0
54;2021-06-25;2182;7078;0;364910;235273;0;57.6;37.1;0.0
54;2021-06-26;2239;5504;0;367149;240777;0;57.9;38.0;0.0
54;2021-06-27;190;727;0;367339;241504;0;57.9;38.1;0.0
54;2021-06-28;1768;4325;0;369107;245829;0;58.2;38.8;0.0
54;2021-06-29;1803;5210;0;370910;251039;0;58.5;39.6;0.0
54;2021-06-30;1920;5150;1;372830;256189;1;58.8;40.4;0.0
54;2021-07-01;2122;5714;0;374952;261903;1;59.1;41.3;0.0
54;2021-07-02;2777;7254;0;377729;269157;1;59.6;42.5;0.0
54;2021-07-03;2622;4005;0;380351;273162;1;60.0;43.1;0.0
54;2021-07-04;209;546;0;380560;273708;1;60.0;43.2;0.0
54;2021-07-05;1536;4158;0;382096;277866;1;60.3;43.8;0.0
54;2021-07-06;1935;5034;0;384031;282900;1;60.6;44.6;0.0
54;2021-07-07;1871;4736;0;385902;287636;1;60.9;45.4;0.0
54;2021-07-08;1644;3974;0;387546;291610;1;61.1;46.0;0.0
54;2021-07-09;3053;6132;0;390599;297742;1;61.6;47.0;0.0
54;2021-07-10;2394;4268;0;392993;302010;1;62.0;47.6;0.0
54;2021-07-11;57;163;0;393050;302173;1;62.0;47.7;0.0
54;2021-07-12;2070;4760;0;395120;306933;1;62.3;48.4;0.0
54;2021-07-13;2717;5179;0;397837;312112;1;62.8;49.2;0.0
54;2021-07-14;1562;1533;0;399399;313645;1;63.0;49.5;0.0
54;2021-07-15;3217;5092;0;402616;318737;1;63.5;50.3;0.0
54;2021-07-16;4637;6533;0;407253;325270;1;64.2;51.3;0.0
54;2021-07-17;4060;4719;0;411313;329989;1;64.9;52.1;0.0
54;2021-07-18;1567;1582;0;412880;331571;1;65.1;52.3;0.0
54;2021-07-19;2600;4174;0;415480;335745;1;65.5;53.0;0.0
54;2021-07-20;3169;4848;0;418649;340593;1;66.0;53.7;0.0
54;2021-07-21;3504;6217;0;422153;346810;1;66.6;54.7;0.0
54;2021-07-22;3655;5580;0;425808;352390;1;67.2;55.6;0.0
54;2021-07-23;4268;6824;0;430076;359214;1;67.8;56.7;0.0
54;2021-07-24;2899;5056;0;432975;364270;1;68.3;57.5;0.0
54;2021-07-25;216;139;0;433191;364409;1;68.3;57.5;0.0
54;2021-07-26;3007;4099;0;436198;368508;1;68.8;58.1;0.0
54;2021-07-27;3985;4022;0;440183;372530;1;69.4;58.8;0.0
54;2021-07-28;5221;3833;0;445404;376363;1;70.3;59.4;0.0
54;2021-07-29;5154;3144;0;450558;379507;1;71.1;59.9;0.0
54;2021-07-30;5005;4744;0;455563;384251;1;71.9;60.6;0.0
54;2021-07-31;4222;3076;0;459785;387327;1;72.5;61.1;0.0
54;2021-08-01;368;141;0;460153;387468;1;72.6;61.1;0.0
54;2021-08-02;3031;3606;0;463184;391074;1;73.1;61.7;0.0
54;2021-08-03;4196;2951;0;467380;394025;1;73.7;62.2;0.0
54;2021-08-04;4406;2702;0;471786;396727;1;74.4;62.6;0.0
54;2021-08-05;4577;2464;0;476363;399191;1;75.1;63.0;0.0
54;2021-08-06;5296;4035;0;481659;403226;1;76.0;63.6;0.0
54;2021-08-07;3565;2902;0;485224;406128;1;76.5;64.1;0.0
54;2021-08-08;327;208;0;485551;406336;1;76.6;64.1;0.0
54;2021-08-09;2807;2728;0;488358;409064;1;77.0;64.5;0.0
54;2021-08-10;2479;3833;0;490837;412897;1;77.4;65.1;0.0
54;2021-08-11;2276;2757;0;493113;415654;1;77.8;65.6;0.0
54;2021-08-12;2102;3179;0;495215;418833;1;78.1;66.1;0.0
54;2021-08-13;2467;4402;0;497682;423235;1;78.5;66.8;0.0
54;2021-08-14;1321;2161;0;499003;425396;1;78.7;67.1;0.0
54;2021-08-15;80;111;0;499083;425507;1;78.7;67.1;0.0
54;2021-08-16;1685;3340;0;500768;428847;1;79.0;67.6;0.0
54;2021-08-17;1885;3479;0;502653;432326;1;79.3;68.2;0.0
54;2021-08-18;1460;4095;0;504113;436421;1;79.5;68.8;0.0
54;2021-08-19;1216;2917;0;505329;439338;1;79.7;69.3;0.0
54;2021-08-20;1671;4835;0;507000;444173;1;80.0;70.1;0.0
54;2021-08-21;1324;3872;0;508324;448045;1;80.2;70.7;0.0
54;2021-08-22;68;92;0;508392;448137;1;80.2;70.7;0.0
54;2021-08-23;1138;3708;0;509530;451845;1;80.4;71.3;0.0
54;2021-08-24;1115;3354;0;510645;455199;1;80.6;71.8;0.0
54;2021-08-25;1302;4338;0;511947;459537;1;80.8;72.5;0.0
54;2021-08-26;982;3149;0;512929;462686;1;80.9;73.0;0.0
54;2021-08-27;1452;5161;0;514381;467847;1;81.1;73.8;0.0
54;2021-08-28;1064;4090;0;515445;471937;1;81.3;74.4;0.0
54;2021-08-29;46;150;0;515491;472087;1;81.3;74.5;0.0
54;2021-08-30;1115;3873;84;516606;475960;85;81.5;75.1;0.0
54;2021-08-31;966;4209;254;517572;480169;339;81.6;75.7;0.1
54;2021-09-01;1157;3267;378;518729;483436;717;81.8;76.3;0.1
54;2021-09-02;738;1972;228;519467;485408;945;81.9;76.6;0.1
54;2021-09-03;948;2913;294;520415;488321;1239;82.1;77.0;0.2
54;2021-09-04;999;2831;311;521414;491152;1550;82.2;77.5;0.2
54;2021-09-05;41;67;13;521455;491219;1563;82.3;77.5;0.2
54;2021-09-06;514;1288;174;521969;492507;1737;82.3;77.7;0.3
54;2021-09-07;554;1454;184;522523;493961;1921;82.4;77.9;0.3
54;2021-09-08;636;1588;298;523159;495549;2219;82.5;78.2;0.4
54;2021-09-09;899;1659;431;524058;497208;2650;82.7;78.4;0.4
54;2021-09-10;939;2198;510;524997;499406;3160;82.8;78.8;0.5
54;2021-09-11;688;2318;180;525685;501724;3340;82.9;79.1;0.5
54;2021-09-12;80;119;31;525765;501843;3371;82.9;79.2;0.5
54;2021-09-13;653;905;396;526418;502748;3767;83.0;79.3;0.6
54;2021-09-14;636;935;613;527054;503683;4380;83.1;79.5;0.7
54;2021-09-15;623;1638;937;527677;505321;5317;83.2;79.7;0.8
54;2021-09-16;621;671;460;528298;505992;5777;83.3;79.8;0.9
54;2021-09-17;827;1425;596;529125;507417;6373;83.5;80.0;1.0
54;2021-09-18;439;1299;212;529564;508716;6585;83.5;80.2;1.0
54;2021-09-19;29;52;24;529593;508768;6609;83.5;80.3;1.0
54;2021-09-20;372;631;366;529965;509399;6975;83.6;80.4;1.1
54;2021-09-21;428;867;504;530393;510266;7479;83.7;80.5;1.2
54;2021-09-22;414;1072;640;530807;511338;8119;83.7;80.7;1.3
54;2021-09-23;322;789;603;531129;512127;8722;83.8;80.8;1.4
54;2021-09-24;515;1105;625;531644;513232;9347;83.9;81.0;1.5
54;2021-09-25;331;1025;223;531975;514257;9570;83.9;81.1;1.5
54;2021-09-26;13;41;8;531988;514298;9578;83.9;81.1;1.5
54;2021-09-27;228;676;513;532216;514974;10091;84.0;81.2;1.6
54;2021-09-28;295;567;663;532511;515541;10754;84.0;81.3;1.7
54;2021-09-29;388;774;798;532899;516315;11552;84.1;81.4;1.8
54;2021-09-30;216;454;627;533115;516769;12179;84.1;81.5;1.9
54;2021-10-01;578;944;1031;533693;517713;13210;84.2;81.7;2.1
54;2021-10-02;353;879;445;534046;518592;13655;84.2;81.8;2.2
54;2021-10-03;13;23;11;534059;518615;13666;84.2;81.8;2.2
54;2021-10-04;263;503;444;534322;519118;14110;84.3;81.9;2.2
54;2021-10-05;291;861;732;534613;519979;14842;84.3;82.0;2.3
54;2021-10-06;376;756;818;534989;520735;15660;84.4;82.1;2.5
54;2021-10-07;251;636;964;535240;521371;16624;84.4;82.2;2.6
54;2021-10-08;409;866;1323;535649;522237;17947;84.5;82.4;2.8
54;2021-10-09;364;635;631;536013;522872;18578;84.6;82.5;2.9
54;2021-10-10;17;26;32;536030;522898;18610;84.6;82.5;2.9
54;2021-10-11;261;407;841;536291;523305;19451;84.6;82.5;3.1
54;2021-10-12;244;570;988;536535;523875;20439;84.6;82.6;3.2
54;2021-10-13;332;505;1292;536867;524380;21731;84.7;82.7;3.4
54;2021-10-14;264;519;743;537131;524899;22474;84.7;82.8;3.5
54;2021-10-15;418;636;1463;537549;525535;23937;84.8;82.9;3.8
54;2021-10-16;378;521;747;537927;526056;24684;84.9;83.0;3.9
54;2021-10-17;9;19;12;537936;526075;24696;84.9;83.0;3.9
54;2021-10-18;251;392;677;538187;526467;25373;84.9;83.0;4.0
54;2021-10-19;233;324;1096;538420;526791;26469;84.9;83.1;4.2
54;2021-10-20;321;450;1371;538741;527241;27840;85.0;83.2;4.4
54;2021-10-21;139;254;827;538880;527495;28667;85.0;83.2;4.5
54;2021-10-22;369;565;1584;539249;528060;30251;85.1;83.3;4.8
54;2021-10-23;297;415;664;539546;528475;30915;85.1;83.4;4.9
54;2021-10-24;9;5;1;539555;528480;30916;85.1;83.4;4.9
54;2021-10-25;220;266;863;539775;528746;31779;85.1;83.4;5.0
54;2021-10-26;157;201;1019;539932;528947;32798;85.2;83.4;5.2
54;2021-10-27;286;371;1479;540218;529318;34277;85.2;83.5;5.4
54;2021-10-28;141;195;898;540359;529513;35175;85.2;83.5;5.5
54;2021-10-29;271;419;1775;540630;529932;36950;85.3;83.6;5.8
54;2021-10-30;251;365;1074;540881;530297;38024;85.3;83.7;6.0
54;2021-10-31;5;19;14;540886;530316;38038;85.3;83.7;6.0
54;2021-11-01;84;37;113;540970;530353;38151;85.3;83.7;6.0
54;2021-11-02;197;322;979;541167;530675;39130;85.4;83.7;6.2
54;2021-11-03;325;455;1634;541492;531130;40764;85.4;83.8;6.4
54;2021-11-04;190;244;1067;541682;531374;41831;85.4;83.8;6.6
54;2021-11-05;311;438;1952;541993;531812;43783;85.5;83.9;6.9
54;2021-11-06;266;416;1171;542259;532228;44954;85.5;84.0;7.1
54;2021-11-07;10;18;72;542269;532246;45026;85.5;84.0;7.1
54;2021-11-08;196;276;1409;542465;532522;46435;85.6;84.0;7.3
54;2021-11-09;176;282;1788;542641;532804;48223;85.6;84.0;7.6
54;2021-11-10;331;379;2500;542972;533183;50723;85.7;84.1;8.0
54;2021-11-11;78;91;287;543050;533274;51010;85.7;84.1;8.0
54;2021-11-12;304;437;2591;543354;533711;53601;85.7;84.2;8.5
54;2021-11-13;209;328;1348;543563;534039;54949;85.7;84.2;8.7
54;2021-11-14;3;12;15;543566;534051;54964;85.7;84.2;8.7
54;2021-11-15;179;244;1820;543745;534295;56784;85.8;84.3;9.0
54;2021-11-16;167;220;1965;543912;534515;58749;85.8;84.3;9.3
54;2021-11-17;278;318;2586;544190;534833;61335;85.8;84.4;9.7
54;2021-11-18;150;177;2056;544340;535010;63391;85.9;84.4;10.0
54;2021-11-19;318;382;3022;544658;535392;66413;85.9;84.5;10.5
54;2021-11-20;255;350;1581;544913;535742;67994;86.0;84.5;10.7
54;2021-11-21;25;27;183;544938;535769;68177;86.0;84.5;10.8
54;2021-11-22;224;205;1768;545162;535974;69945;86.0;84.5;11.0
54;2021-11-23;187;179;2114;545349;536153;72059;86.0;84.6;11.4
54;2021-11-24;318;313;2641;545667;536466;74700;86.1;84.6;11.8
54;2021-11-25;179;168;2783;545846;536634;77483;86.1;84.7;12.2
54;2021-11-26;310;358;5186;546156;536992;82669;86.2;84.7;13.0
54;2021-11-27;278;329;3780;546434;537321;86449;86.2;84.8;13.6
54;2021-11-28;17;26;583;546451;537347;87032;86.2;84.8;13.7
54;2021-11-29;146;206;4188;546597;537553;91220;86.2;84.8;14.4
54;2021-11-30;159;183;4782;546756;537736;96002;86.2;84.8;15.1
54;2021-12-01;225;328;7623;546981;538064;103625;86.3;84.9;16.3
54;2021-12-02;174;167;6279;547155;538231;109904;86.3;84.9;17.3
54;2021-12-03;285;350;8881;547440;538581;118785;86.4;85.0;18.7
54;2021-12-04;219;311;5318;547659;538892;124103;86.4;85.0;19.6
54;2021-12-05;20;14;495;547679;538906;124598;86.4;85.0;19.7
54;2021-12-06;247;266;6861;547926;539172;131459;86.4;85.1;20.7
54;2021-12-07;203;242;7244;548129;539414;138703;86.5;85.1;21.9
54;2021-12-08;283;356;8428;548412;539770;147131;86.5;85.1;23.2
54;2021-12-09;205;244;7993;548617;540014;155124;86.5;85.2;24.5
54;2021-12-10;328;327;10123;548945;540341;165247;86.6;85.2;26.1
54;2021-12-11;259;320;6091;549204;540661;171338;86.6;85.3;27.0
54;2021-12-12;35;39;580;549239;540700;171918;86.6;85.3;27.1
54;2021-12-13;276;282;7279;549515;540982;179197;86.7;85.3;28.3
54;2021-12-14;265;294;8184;549780;541276;187381;86.7;85.4;29.6
54;2021-12-15;402;391;9657;550182;541667;197038;86.8;85.4;31.1
54;2021-12-16;232;269;8848;550414;541936;205886;86.8;85.5;32.5
54;2021-12-17;401;388;11226;550815;542324;217112;86.9;85.5;34.2
54;2021-12-18;355;337;6060;551170;542661;223172;86.9;85.6;35.2
54;2021-12-19;57;49;949;551227;542710;224121;87.0;85.6;35.4
55;2020-12-27;0;0;0;0;0;0;0.0;0.0;0.0
55;2020-12-28;2;0;0;2;0;0;0.0;0.0;0.0
55;2020-12-29;0;0;0;2;0;0;0.0;0.0;0.0
55;2020-12-30;0;0;0;2;0;0;0.0;0.0;0.0
55;2020-12-31;0;0;0;2;0;0;0.0;0.0;0.0
55;2021-01-01;0;0;0;2;0;0;0.0;0.0;0.0
55;2021-01-02;0;0;0;2;0;0;0.0;0.0;0.0
55;2021-01-03;0;0;0;2;0;0;0.0;0.0;0.0
55;2021-01-04;2;0;0;4;0;0;0.0;0.0;0.0
55;2021-01-05;4;0;0;8;0;0;0.0;0.0;0.0
55;2021-01-06;7;0;0;15;0;0;0.0;0.0;0.0
55;2021-01-07;121;0;0;136;0;0;0.1;0.0;0.0
55;2021-01-08;145;0;0;281;0;0;0.2;0.0;0.0
55;2021-01-09;28;0;0;309;0;0;0.2;0.0;0.0
55;2021-01-10;1;0;0;310;0;0;0.2;0.0;0.0
55;2021-01-11;155;1;0;465;1;0;0.3;0.0;0.0
55;2021-01-12;136;0;0;601;1;0;0.4;0.0;0.0
55;2021-01-13;177;0;0;778;1;0;0.5;0.0;0.0
55;2021-01-14;642;7;0;1420;8;0;0.9;0.0;0.0
55;2021-01-15;270;0;0;1690;8;0;1.1;0.0;0.0
55;2021-01-16;67;0;0;1757;8;0;1.1;0.0;0.0
55;2021-01-17;3;0;0;1760;8;0;1.1;0.0;0.0
55;2021-01-18;461;1;0;2221;9;0;1.4;0.0;0.0
55;2021-01-19;383;4;0;2604;13;0;1.6;0.0;0.0
55;2021-01-20;452;2;0;3056;15;0;1.9;0.0;0.0
55;2021-01-21;439;2;0;3495;17;0;2.2;0.0;0.0
55;2021-01-22;387;0;0;3882;17;0;2.5;0.0;0.0
55;2021-01-23;54;0;0;3936;17;0;2.5;0.0;0.0
55;2021-01-24;1;0;0;3937;17;0;2.5;0.0;0.0
55;2021-01-25;408;0;0;4345;17;0;2.7;0.0;0.0
55;2021-01-26;439;0;0;4784;17;0;3.0;0.0;0.0
55;2021-01-27;384;1;0;5168;18;0;3.3;0.0;0.0
55;2021-01-28;477;91;0;5645;109;0;3.6;0.1;0.0
55;2021-01-29;155;76;0;5800;185;0;3.7;0.1;0.0
55;2021-01-30;99;19;0;5899;204;0;3.7;0.1;0.0
55;2021-01-31;0;0;0;5899;204;0;3.7;0.1;0.0
55;2021-02-01;139;178;0;6038;382;0;3.8;0.2;0.0
55;2021-02-02;164;157;0;6202;539;0;3.9;0.3;0.0
55;2021-02-03;61;182;0;6263;721;0;4.0;0.5;0.0
55;2021-02-04;230;418;0;6493;1139;0;4.1;0.7;0.0
55;2021-02-05;197;175;0;6690;1314;0;4.2;0.8;0.0
55;2021-02-06;60;58;0;6750;1372;0;4.3;0.9;0.0
55;2021-02-07;4;48;0;6754;1420;0;4.3;0.9;0.0
55;2021-02-08;11;46;0;6765;1466;0;4.3;0.9;0.0
55;2021-02-09;106;132;0;6871;1598;0;4.3;1.0;0.0
55;2021-02-10;81;36;0;6952;1634;0;4.4;1.0;0.0
55;2021-02-11;174;82;0;7126;1716;0;4.5;1.1;0.0
55;2021-02-12;115;47;0;7241;1763;0;4.6;1.1;0.0
55;2021-02-13;12;5;0;7253;1768;0;4.6;1.1;0.0
55;2021-02-14;5;1;0;7258;1769;0;4.6;1.1;0.0
55;2021-02-15;24;433;0;7282;2202;0;4.6;1.4;0.0
55;2021-02-16;141;420;0;7423;2622;0;4.7;1.7;0.0
55;2021-02-17;34;494;0;7457;3116;0;4.7;2.0;0.0
55;2021-02-18;33;338;0;7490;3454;0;4.7;2.2;0.0
55;2021-02-19;145;292;0;7635;3746;0;4.8;2.4;0.0
55;2021-02-20;12;6;0;7647;3752;0;4.8;2.4;0.0
55;2021-02-21;0;0;0;7647;3752;0;4.8;2.4;0.0
55;2021-02-22;61;425;0;7708;4177;0;4.9;2.6;0.0
55;2021-02-23;88;442;0;7796;4619;0;4.9;2.9;0.0
55;2021-02-24;93;381;0;7889;5000;0;5.0;3.2;0.0
55;2021-02-25;282;687;0;8171;5687;0;5.2;3.6;0.0
55;2021-02-26;350;241;0;8521;5928;0;5.4;3.7;0.0
55;2021-02-27;137;87;0;8658;6015;0;5.5;3.8;0.0
55;2021-02-28;9;6;0;8667;6021;0;5.5;3.8;0.0
55;2021-03-01;108;147;0;8775;6168;0;5.5;3.9;0.0
55;2021-03-02;173;179;0;8948;6347;0;5.7;4.0;0.0
55;2021-03-03;232;13;0;9180;6360;0;5.8;4.0;0.0
55;2021-03-04;276;52;0;9456;6412;0;6.0;4.0;0.0
55;2021-03-05;427;63;0;9883;6475;0;6.2;4.1;0.0
55;2021-03-06;310;13;0;10193;6488;0;6.4;4.1;0.0
55;2021-03-07;141;3;0;10334;6491;0;6.5;4.1;0.0
55;2021-03-08;375;53;0;10709;6544;0;6.8;4.1;0.0
55;2021-03-09;669;60;0;11378;6604;0;7.2;4.2;0.0
55;2021-03-10;440;36;0;11818;6640;0;7.5;4.2;0.0
55;2021-03-11;622;152;0;12440;6792;0;7.9;4.3;0.0
55;2021-03-12;876;107;0;13316;6899;0;8.4;4.4;0.0
55;2021-03-13;586;25;0;13902;6924;0;8.8;4.4;0.0
55;2021-03-14;51;2;0;13953;6926;0;8.8;4.4;0.0
55;2021-03-15;425;31;0;14378;6957;0;9.1;4.4;0.0
55;2021-03-16;616;117;0;14994;7074;0;9.5;4.5;0.0
55;2021-03-17;727;28;0;15721;7102;0;9.9;4.5;0.0
55;2021-03-18;390;33;0;16111;7135;0;10.2;4.5;0.0
55;2021-03-19;513;72;0;16624;7207;0;10.5;4.6;0.0
55;2021-03-20;294;16;0;16918;7223;0;10.7;4.6;0.0
55;2021-03-21;9;1;0;16927;7224;0;10.7;4.6;0.0
55;2021-03-22;517;30;0;17444;7254;0;11.0;4.6;0.0
55;2021-03-23;1036;78;0;18480;7332;0;11.7;4.6;0.0
55;2021-03-24;852;67;0;19332;7399;0;12.2;4.7;0.0
55;2021-03-25;1145;91;0;20477;7490;0;12.9;4.7;0.0
55;2021-03-26;678;60;0;21155;7550;0;13.4;4.8;0.0
55;2021-03-27;309;37;0;21464;7587;0;13.6;4.8;0.0
55;2021-03-28;2;6;0;21466;7593;0;13.6;4.8;0.0
55;2021-03-29;933;67;0;22399;7660;0;14.1;4.8;0.0
55;2021-03-30;1419;102;0;23818;7762;0;15.0;4.9;0.0
55;2021-03-31;1441;104;0;25259;7866;0;16.0;5.0;0.0
55;2021-04-01;1217;174;0;26476;8040;0;16.7;5.1;0.0
55;2021-04-02;903;102;0;27379;8142;0;17.3;5.1;0.0
55;2021-04-03;220;37;0;27599;8179;0;17.4;5.2;0.0
55;2021-04-04;15;16;0;27614;8195;0;17.4;5.2;0.0
55;2021-04-05;9;20;0;27623;8215;0;17.4;5.2;0.0
55;2021-04-06;895;319;0;28518;8534;0;18.0;5.4;0.0
55;2021-04-07;903;291;0;29421;8825;0;18.6;5.6;0.0
55;2021-04-08;1568;443;0;30989;9268;0;19.6;5.9;0.0
55;2021-04-09;1353;302;0;32342;9570;0;20.4;6.0;0.0
55;2021-04-10;270;209;0;32612;9779;0;20.6;6.2;0.0
55;2021-04-11;507;50;0;33119;9829;0;20.9;6.2;0.0
55;2021-04-12;786;370;0;33905;10199;0;21.4;6.4;0.0
55;2021-04-13;1214;564;0;35119;10763;0;22.2;6.8;0.0
55;2021-04-14;1287;778;0;36406;11541;0;23.0;7.3;0.0
55;2021-04-15;1508;491;0;37914;12032;0;23.9;7.6;0.0
55;2021-04-16;730;402;0;38644;12434;0;24.4;7.9;0.0
55;2021-04-17;713;83;0;39357;12517;0;24.9;7.9;0.0
55;2021-04-18;41;26;0;39398;12543;0;24.9;7.9;0.0
55;2021-04-19;853;423;0;40251;12966;0;25.4;8.2;0.0
55;2021-04-20;1078;802;0;41329;13768;0;26.1;8.7;0.0
55;2021-04-21;899;679;0;42228;14447;0;26.7;9.1;0.0
55;2021-04-22;1002;739;0;43230;15186;0;27.3;9.6;0.0
55;2021-04-23;1311;633;0;44541;15819;0;28.1;10.0;0.0
55;2021-04-24;365;158;0;44906;15977;0;28.4;10.1;0.0
55;2021-04-25;341;49;0;45247;16026;0;28.6;10.1;0.0
55;2021-04-26;435;793;0;45682;16819;0;28.8;10.6;0.0
55;2021-04-27;562;983;0;46244;17802;0;29.2;11.2;0.0
55;2021-04-28;869;827;0;47113;18629;0;29.8;11.8;0.0
55;2021-04-29;1067;842;0;48180;19471;0;30.4;12.3;0.0
55;2021-04-30;1243;622;0;49423;20093;0;31.2;12.7;0.0
55;2021-05-01;137;136;0;49560;20229;0;31.3;12.8;0.0
55;2021-05-02;13;6;0;49573;20235;0;31.3;12.8;0.0
55;2021-05-03;1160;627;0;50733;20862;0;32.0;13.2;0.0
55;2021-05-04;735;1080;0;51468;21942;0;32.5;13.9;0.0
55;2021-05-05;802;947;0;52270;22889;0;33.0;14.5;0.0
55;2021-05-06;1461;1089;0;53731;23978;0;33.9;15.1;0.0
55;2021-05-07;1441;568;0;55172;24546;0;34.8;15.5;0.0
55;2021-05-08;165;78;0;55337;24624;0;34.9;15.6;0.0
55;2021-05-09;133;451;0;55470;25075;0;35.0;15.8;0.0
55;2021-05-10;911;930;0;56381;26005;0;35.6;16.4;0.0
55;2021-05-11;1201;1257;0;57582;27262;0;36.4;17.2;0.0
55;2021-05-12;1107;1599;0;58689;28861;0;37.1;18.2;0.0
55;2021-05-13;288;88;0;58977;28949;0;37.2;18.3;0.0
55;2021-05-14;597;570;0;59574;29519;0;37.6;18.6;0.0
55;2021-05-15;416;501;0;59990;30020;0;37.9;19.0;0.0
55;2021-05-16;82;17;0;60072;30037;0;37.9;19.0;0.0
55;2021-05-17;1114;774;0;61186;30811;0;38.6;19.5;0.0
55;2021-05-18;1628;839;0;62814;31650;0;39.7;20.0;0.0
55;2021-05-19;1788;735;0;64602;32385;0;40.8;20.5;0.0
55;2021-05-20;2294;692;0;66896;33077;0;42.2;20.9;0.0
55;2021-05-21;1980;794;0;68876;33871;0;43.5;21.4;0.0
55;2021-05-22;325;198;0;69201;34069;0;43.7;21.5;0.0
55;2021-05-23;58;99;0;69259;34168;0;43.7;21.6;0.0
55;2021-05-24;96;8;0;69355;34176;0;43.8;21.6;0.0
55;2021-05-25;1327;628;0;70682;34804;0;44.6;22.0;0.0
55;2021-05-26;1572;965;0;72254;35769;0;45.6;22.6;0.0
55;2021-05-27;1375;967;0;73629;36736;0;46.5;23.2;0.0
55;2021-05-28;1532;918;0;75161;37654;0;47.5;23.8;0.0
55;2021-05-29;1221;662;0;76382;38316;0;48.2;24.2;0.0
55;2021-05-30;27;197;0;76409;38513;0;48.3;24.3;0.0
55;2021-05-31;1002;1039;0;77411;39552;0;48.9;25.0;0.0
55;2021-06-01;890;889;0;78301;40441;0;49.4;25.5;0.0
55;2021-06-02;1134;953;0;79435;41394;0;50.2;26.1;0.0
55;2021-06-03;822;586;0;80257;41980;0;50.7;26.5;0.0
55;2021-06-04;1380;1074;0;81637;43054;0;51.6;27.2;0.0
55;2021-06-05;1242;302;0;82879;43356;0;52.3;27.4;0.0
55;2021-06-06;15;6;0;82894;43362;0;52.3;27.4;0.0
55;2021-06-07;832;703;0;83726;44065;0;52.9;27.8;0.0
55;2021-06-08;803;1043;0;84529;45108;0;53.4;28.5;0.0
55;2021-06-09;942;818;0;85471;45926;0;54.0;29.0;0.0
55;2021-06-10;550;372;0;86021;46298;0;54.3;29.2;0.0
55;2021-06-11;633;1268;0;86654;47566;0;54.7;30.0;0.0
55;2021-06-12;771;534;0;87425;48100;0;55.2;30.4;0.0
55;2021-06-13;261;42;0;87686;48142;0;55.4;30.4;0.0
55;2021-06-14;433;1317;0;88119;49459;0;55.6;31.2;0.0
55;2021-06-15;611;1327;0;88730;50786;0;56.0;32.1;0.0
55;2021-06-16;786;969;0;89516;51755;0;56.5;32.7;0.0
55;2021-06-17;491;960;0;90007;52715;0;56.8;33.3;0.0
55;2021-06-18;697;1557;0;90704;54272;0;57.3;34.3;0.0
55;2021-06-19;649;504;0;91353;54776;0;57.7;34.6;0.0
55;2021-06-20;16;40;0;91369;54816;0;57.7;34.6;0.0
55;2021-06-21;473;1163;0;91842;55979;0;58.0;35.4;0.0
55;2021-06-22;408;1168;0;92250;57147;0;58.3;36.1;0.0
55;2021-06-23;682;1282;0;92932;58429;0;58.7;36.9;0.0
55;2021-06-24;250;591;0;93182;59020;0;58.8;37.3;0.0
55;2021-06-25;693;1393;0;93875;60413;0;59.3;38.2;0.0
55;2021-06-26;492;478;0;94367;60891;0;59.6;38.5;0.0
55;2021-06-27;7;50;0;94374;60941;0;59.6;38.5;0.0
55;2021-06-28;203;1460;0;94577;62401;0;59.7;39.4;0.0
55;2021-06-29;256;1377;0;94833;63778;0;59.9;40.3;0.0
55;2021-06-30;326;2005;0;95159;65783;0;60.1;41.5;0.0
55;2021-07-01;445;2034;0;95604;67817;0;60.4;42.8;0.0
55;2021-07-02;454;1804;0;96058;69621;0;60.7;44.0;0.0
55;2021-07-03;209;362;0;96267;69983;0;60.8;44.2;0.0
55;2021-07-04;38;56;0;96305;70039;0;60.8;44.2;0.0
55;2021-07-05;255;1549;0;96560;71588;0;61.0;45.2;0.0
55;2021-07-06;376;1043;0;96936;72631;0;61.2;45.9;0.0
55;2021-07-07;419;1834;0;97355;74465;0;61.5;47.0;0.0
55;2021-07-08;630;1633;0;97985;76098;0;61.9;48.1;0.0
55;2021-07-09;551;1587;0;98536;77685;0;62.2;49.1;0.0
55;2021-07-10;399;1066;0;98935;78751;0;62.5;49.7;0.0
55;2021-07-11;6;25;0;98941;78776;0;62.5;49.7;0.0
55;2021-07-12;633;1242;0;99574;80018;0;62.9;50.5;0.0
55;2021-07-13;717;1507;0;100291;81525;0;63.3;51.5;0.0
55;2021-07-14;91;75;0;100382;81600;0;63.4;51.5;0.0
55;2021-07-15;865;1705;0;101247;83305;0;63.9;52.6;0.0
55;2021-07-16;1261;1817;0;102508;85122;0;64.7;53.8;0.0
55;2021-07-17;1315;922;0;103823;86044;0;65.6;54.3;0.0
55;2021-07-18;39;37;0;103862;86081;0;65.6;54.4;0.0
55;2021-07-19;653;925;0;104515;87006;0;66.0;54.9;0.0
55;2021-07-20;1064;1152;0;105579;88158;0;66.7;55.7;0.0
55;2021-07-21;1476;1407;0;107055;89565;0;67.6;56.6;0.0
55;2021-07-22;1287;772;0;108342;90337;0;68.4;57.0;0.0
55;2021-07-23;1262;1496;0;109604;91833;0;69.2;58.0;0.0
55;2021-07-24;860;828;0;110464;92661;0;69.8;58.5;0.0
55;2021-07-25;131;233;0;110595;92894;0;69.8;58.7;0.0
55;2021-07-26;760;586;0;111355;93480;0;70.3;59.0;0.0
55;2021-07-27;1258;617;0;112613;94097;0;71.1;59.4;0.0
55;2021-07-28;1229;1153;0;113842;95250;0;71.9;60.2;0.0
55;2021-07-29;918;596;0;114760;95846;0;72.5;60.5;0.0
55;2021-07-30;1418;1090;0;116178;96936;0;73.4;61.2;0.0
55;2021-07-31;872;705;0;117050;97641;0;73.9;61.7;0.0
55;2021-08-01;57;16;0;117107;97657;0;74.0;61.7;0.0
55;2021-08-02;755;536;0;117862;98193;0;74.4;62.0;0.0
55;2021-08-03;833;529;0;118695;98722;0;75.0;62.3;0.0
55;2021-08-04;1402;951;0;120097;99673;0;75.8;62.9;0.0
55;2021-08-05;1177;403;0;121274;100076;0;76.6;63.2;0.0
55;2021-08-06;1043;1162;0;122317;101238;0;77.2;63.9;0.0
55;2021-08-07;697;446;0;123014;101684;0;77.7;64.2;0.0
55;2021-08-08;63;16;0;123077;101700;0;77.7;64.2;0.0
55;2021-08-09;500;464;0;123577;102164;0;78.0;64.5;0.0
55;2021-08-10;536;836;0;124113;103000;0;78.4;65.0;0.0
55;2021-08-11;725;725;0;124838;103725;0;78.8;65.5;0.0
55;2021-08-12;499;623;0;125337;104348;0;79.2;65.9;0.0
55;2021-08-13;552;1209;0;125889;105557;0;79.5;66.7;0.0
55;2021-08-14;254;344;0;126143;105901;0;79.7;66.9;0.0
55;2021-08-15;39;26;0;126182;105927;0;79.7;66.9;0.0
55;2021-08-16;325;816;0;126507;106743;0;79.9;67.4;0.0
55;2021-08-17;355;450;0;126862;107193;0;80.1;67.7;0.0
55;2021-08-18;568;1322;0;127430;108515;0;80.5;68.5;0.0
55;2021-08-19;525;1039;0;127955;109554;0;80.8;69.2;0.0
55;2021-08-20;614;1169;0;128569;110723;0;81.2;69.9;0.0
55;2021-08-21;342;804;0;128911;111527;0;81.4;70.4;0.0
55;2021-08-22;18;41;0;128929;111568;0;81.4;70.5;0.0
55;2021-08-23;332;728;0;129261;112296;0;81.6;70.9;0.0
55;2021-08-24;335;891;0;129596;113187;0;81.8;71.5;0.0
55;2021-08-25;704;1252;0;130300;114439;0;82.3;72.3;0.0
55;2021-08-26;449;1335;0;130749;115774;0;82.6;73.1;0.0
55;2021-08-27;352;1474;0;131101;117248;0;82.8;74.0;0.0
55;2021-08-28;372;738;0;131473;117986;0;83.0;74.5;0.0
55;2021-08-29;191;57;0;131664;118043;0;83.1;74.5;0.0
55;2021-08-30;142;799;9;131806;118842;9;83.2;75.1;0.0
55;2021-08-31;306;941;24;132112;119783;33;83.4;75.6;0.0
55;2021-09-01;546;1336;62;132658;121119;95;83.8;76.5;0.1
55;2021-09-02;244;998;82;132902;122117;177;83.9;77.1;0.1
55;2021-09-03;399;1143;208;133301;123260;385;84.2;77.8;0.2
55;2021-09-04;297;720;22;133598;123980;407;84.4;78.3;0.3
55;2021-09-05;17;89;1;133615;124069;408;84.4;78.4;0.3
55;2021-09-06;78;223;9;133693;124292;417;84.4;78.5;0.3
55;2021-09-07;264;469;188;133957;124761;605;84.6;78.8;0.4
55;2021-09-08;224;378;64;134181;125139;669;84.7;79.0;0.4
55;2021-09-09;218;620;70;134399;125759;739;84.9;79.4;0.5
55;2021-09-10;209;541;139;134608;126300;878;85.0;79.8;0.6
55;2021-09-11;133;398;42;134741;126698;920;85.1;80.0;0.6
55;2021-09-12;3;10;0;134744;126708;920;85.1;80.0;0.6
55;2021-09-13;119;355;123;134863;127063;1043;85.2;80.2;0.7
55;2021-09-14;291;225;126;135154;127288;1169;85.4;80.4;0.7
55;2021-09-15;285;699;228;135439;127987;1397;85.5;80.8;0.9
55;2021-09-16;116;222;117;135555;128209;1514;85.6;81.0;1.0
55;2021-09-17;118;195;127;135673;128404;1641;85.7;81.1;1.0
55;2021-09-18;142;426;79;135815;128830;1720;85.8;81.4;1.1
55;2021-09-19;4;12;3;135819;128842;1723;85.8;81.4;1.1
55;2021-09-20;72;166;34;135891;129008;1757;85.8;81.5;1.1
55;2021-09-21;117;282;232;136008;129290;1989;85.9;81.6;1.3
55;2021-09-22;122;376;102;136130;129666;2091;86.0;81.9;1.3
55;2021-09-23;101;373;272;136231;130039;2363;86.0;82.1;1.5
55;2021-09-24;100;339;202;136331;130378;2565;86.1;82.3;1.6
55;2021-09-25;67;201;54;136398;130579;2619;86.1;82.5;1.7
55;2021-09-26;1;1;0;136399;130580;2619;86.1;82.5;1.7
55;2021-09-27;51;135;132;136450;130715;2751;86.2;82.5;1.7
55;2021-09-28;65;95;105;136515;130810;2856;86.2;82.6;1.8
55;2021-09-29;152;790;199;136667;131600;3055;86.3;83.1;1.9
55;2021-09-30;71;312;174;136738;131912;3229;86.4;83.3;2.0
55;2021-10-01;74;221;154;136812;132133;3383;86.4;83.4;2.1
55;2021-10-02;117;389;82;136929;132522;3465;86.5;83.7;2.2
55;2021-10-03;3;3;0;136932;132525;3465;86.5;83.7;2.2
55;2021-10-04;111;255;255;137043;132780;3720;86.5;83.9;2.3
55;2021-10-05;75;193;186;137118;132973;3906;86.6;84.0;2.5
55;2021-10-06;104;329;175;137222;133302;4081;86.7;84.2;2.6
55;2021-10-07;67;92;184;137289;133394;4265;86.7;84.2;2.7
55;2021-10-08;80;145;127;137369;133539;4392;86.8;84.3;2.8
55;2021-10-09;88;226;118;137457;133765;4510;86.8;84.5;2.8
55;2021-10-10;18;160;20;137475;133925;4530;86.8;84.6;2.9
55;2021-10-11;73;115;134;137548;134040;4664;86.9;84.6;2.9
55;2021-10-12;88;319;257;137636;134359;4921;86.9;84.9;3.1
55;2021-10-13;110;137;281;137746;134496;5202;87.0;84.9;3.3
55;2021-10-14;38;76;118;137784;134572;5320;87.0;85.0;3.4
55;2021-10-15;72;140;150;137856;134712;5470;87.1;85.1;3.5
55;2021-10-16;63;93;95;137919;134805;5565;87.1;85.1;3.5
55;2021-10-17;10;18;11;137929;134823;5576;87.1;85.1;3.5
55;2021-10-18;73;102;277;138002;134925;5853;87.2;85.2;3.7
55;2021-10-19;48;70;197;138050;134995;6050;87.2;85.3;3.8
55;2021-10-20;52;143;307;138102;135138;6357;87.2;85.3;4.0
55;2021-10-21;40;123;199;138142;135261;6556;87.2;85.4;4.1
55;2021-10-22;58;74;187;138200;135335;6743;87.3;85.5;4.3
55;2021-10-23;89;180;333;138289;135515;7076;87.3;85.6;4.5
55;2021-10-24;1;4;5;138290;135519;7081;87.3;85.6;4.5
55;2021-10-25;82;107;337;138372;135626;7418;87.4;85.7;4.7
55;2021-10-26;39;47;172;138411;135673;7590;87.4;85.7;4.8
55;2021-10-27;74;138;293;138485;135811;7883;87.5;85.8;5.0
55;2021-10-28;42;33;222;138527;135844;8105;87.5;85.8;5.1
55;2021-10-29;66;79;313;138593;135923;8418;87.5;85.8;5.3
55;2021-10-30;18;52;83;138611;135975;8501;87.5;85.9;5.4
55;2021-10-31;0;3;2;138611;135978;8503;87.5;85.9;5.4
55;2021-11-01;8;4;1;138619;135982;8504;87.5;85.9;5.4
55;2021-11-02;27;35;108;138646;136017;8612;87.6;85.9;5.4
55;2021-11-03;42;80;287;138688;136097;8899;87.6;85.9;5.6
55;2021-11-04;110;108;865;138798;136205;9764;87.7;86.0;6.2
55;2021-11-05;18;75;206;138816;136280;9970;87.7;86.1;6.3
55;2021-11-06;84;111;422;138900;136391;10392;87.7;86.1;6.6
55;2021-11-07;5;6;31;138905;136397;10423;87.7;86.1;6.6
55;2021-11-08;70;114;620;138975;136511;11043;87.8;86.2;7.0
55;2021-11-09;28;62;455;139003;136573;11498;87.8;86.2;7.3
55;2021-11-10;61;83;774;139064;136656;12272;87.8;86.3;7.8
55;2021-11-11;2;1;24;139066;136657;12296;87.8;86.3;7.8
55;2021-11-12;41;65;403;139107;136722;12699;87.8;86.3;8.0
55;2021-11-13;35;40;136;139142;136762;12835;87.9;86.4;8.1
55;2021-11-14;4;1;16;139146;136763;12851;87.9;86.4;8.1
55;2021-11-15;58;120;866;139204;136883;13717;87.9;86.4;8.7
55;2021-11-16;33;57;515;139237;136940;14232;87.9;86.5;9.0
55;2021-11-17;76;63;782;139313;137003;15014;88.0;86.5;9.5
55;2021-11-18;50;77;563;139363;137080;15577;88.0;86.6;9.8
55;2021-11-19;58;69;615;139421;137149;16192;88.0;86.6;10.2
55;2021-11-20;65;79;638;139486;137228;16830;88.1;86.7;10.6
55;2021-11-21;3;0;3;139489;137228;16833;88.1;86.7;10.6
55;2021-11-22;46;41;959;139535;137269;17792;88.1;86.7;11.2
55;2021-11-23;57;41;922;139592;137310;18714;88.2;86.7;11.8
55;2021-11-24;60;66;904;139652;137376;19618;88.2;86.8;12.4
55;2021-11-25;48;47;567;139700;137423;20185;88.2;86.8;12.7
55;2021-11-26;88;70;1277;139788;137493;21462;88.3;86.8;13.6
55;2021-11-27;60;66;828;139848;137559;22290;88.3;86.9;14.1
55;2021-11-28;4;7;87;139852;137566;22377;88.3;86.9;14.1
55;2021-11-29;58;117;1106;139910;137683;23483;88.4;86.9;14.8
55;2021-11-30;51;35;1010;139961;137718;24493;88.4;87.0;15.5
55;2021-12-01;53;107;1531;140014;137825;26024;88.4;87.0;16.4
55;2021-12-02;51;30;2031;140065;137855;28055;88.5;87.1;17.7
55;2021-12-03;88;66;1928;140153;137921;29983;88.5;87.1;18.9
55;2021-12-04;75;53;825;140228;137974;30808;88.6;87.1;19.5
55;2021-12-05;8;5;301;140236;137979;31109;88.6;87.1;19.6
55;2021-12-06;38;75;1836;140274;138054;32945;88.6;87.2;20.8
55;2021-12-07;46;37;1527;140320;138091;34472;88.6;87.2;21.8
55;2021-12-08;97;61;2201;140417;138152;36673;88.7;87.2;23.2
55;2021-12-09;66;29;1758;140483;138181;38431;88.7;87.3;24.3
55;2021-12-10;69;57;2125;140552;138238;40556;88.8;87.3;25.6
55;2021-12-11;72;95;2313;140624;138333;42869;88.8;87.4;27.1
55;2021-12-12;8;5;94;140632;138338;42963;88.8;87.4;27.1
55;2021-12-13;53;48;1365;140685;138386;44328;88.8;87.4;28.0
55;2021-12-14;68;62;2388;140753;138448;46716;88.9;87.4;29.5
55;2021-12-15;70;60;1806;140823;138508;48522;88.9;87.5;30.6
55;2021-12-16;63;70;3011;140886;138578;51533;89.0;87.5;32.5
55;2021-12-17;85;107;3097;140971;138685;54630;89.0;87.6;34.5
55;2021-12-18;98;78;1844;141069;138763;56474;89.1;87.6;35.7
55;2021-12-19;24;13;447;141093;138776;56921;89.1;87.6;35.9
56;2020-12-27;0;0;0;0;0;0;0.0;0.0;0.0
56;2020-12-28;1;0;0;1;0;0;0.0;0.0;0.0
56;2020-12-29;0;0;0;1;0;0;0.0;0.0;0.0
56;2020-12-30;0;0;0;1;0;0;0.0;0.0;0.0
56;2020-12-31;0;0;0;1;0;0;0.0;0.0;0.0
56;2021-01-01;1;0;0;2;0;0;0.0;0.0;0.0
56;2021-01-02;1;0;0;3;0;0;0.0;0.0;0.0
56;2021-01-03;0;0;0;3;0;0;0.0;0.0;0.0
56;2021-01-04;1;0;0;4;0;0;0.0;0.0;0.0
56;2021-01-05;3;0;0;7;0;0;0.0;0.0;0.0
56;2021-01-06;10;0;0;17;0;0;0.0;0.0;0.0
56;2021-01-07;185;0;0;202;0;0;0.0;0.0;0.0
56;2021-01-08;149;1;0;351;1;0;0.1;0.0;0.0
56;2021-01-09;2;0;0;353;1;0;0.1;0.0;0.0
56;2021-01-10;3;0;0;356;1;0;0.1;0.0;0.0
56;2021-01-11;255;0;0;611;1;0;0.1;0.0;0.0
56;2021-01-12;739;15;0;1350;16;0;0.2;0.0;0.0
56;2021-01-13;656;1;0;2006;17;0;0.3;0.0;0.0
56;2021-01-14;961;19;0;2967;36;0;0.4;0.0;0.0
56;2021-01-15;810;6;0;3777;42;0;0.6;0.0;0.0
56;2021-01-16;231;4;0;4008;46;0;0.6;0.0;0.0
56;2021-01-17;28;0;0;4036;46;0;0.6;0.0;0.0
56;2021-01-18;955;2;0;4991;48;0;0.8;0.0;0.0
56;2021-01-19;860;23;0;5851;71;0;0.9;0.0;0.0
56;2021-01-20;905;1;0;6756;72;0;1.0;0.0;0.0
56;2021-01-21;1450;19;0;8206;91;0;1.2;0.0;0.0
56;2021-01-22;1227;4;0;9433;95;0;1.4;0.0;0.0
56;2021-01-23;306;4;0;9739;99;0;1.5;0.0;0.0
56;2021-01-24;7;1;0;9746;100;0;1.5;0.0;0.0
56;2021-01-25;795;5;0;10541;105;0;1.6;0.0;0.0
56;2021-01-26;1001;8;0;11542;113;0;1.7;0.0;0.0
56;2021-01-27;1037;65;0;12579;178;0;1.9;0.0;0.0
56;2021-01-28;1032;110;0;13611;288;0;2.1;0.0;0.0
56;2021-01-29;853;111;0;14464;399;0;2.2;0.1;0.0
56;2021-01-30;145;18;0;14609;417;0;2.2;0.1;0.0
56;2021-01-31;5;3;0;14614;420;0;2.2;0.1;0.0
56;2021-02-01;480;149;0;15094;569;0;2.3;0.1;0.0
56;2021-02-02;844;237;0;15938;806;0;2.4;0.1;0.0
56;2021-02-03;901;250;0;16839;1056;0;2.5;0.2;0.0
56;2021-02-04;4359;379;0;21198;1435;0;3.2;0.2;0.0
56;2021-02-05;3388;465;0;24586;1900;0;3.7;0.3;0.0
56;2021-02-06;524;173;0;25110;2073;0;3.8;0.3;0.0
56;2021-02-07;125;23;0;25235;2096;0;3.8;0.3;0.0
56;2021-02-08;303;308;0;25538;2404;0;3.9;0.4;0.0
56;2021-02-09;772;476;0;26310;2880;0;4.0;0.4;0.0
56;2021-02-10;853;743;0;27163;3623;0;4.1;0.5;0.0
56;2021-02-11;987;1107;0;28150;4730;0;4.3;0.7;0.0
56;2021-02-12;1119;642;0;29269;5372;0;4.4;0.8;0.0
56;2021-02-13;215;125;0;29484;5497;0;4.5;0.8;0.0
56;2021-02-14;6;44;0;29490;5541;0;4.5;0.8;0.0
56;2021-02-15;617;1012;0;30107;6553;0;4.6;1.0;0.0
56;2021-02-16;1189;684;0;31296;7237;0;4.7;1.1;0.0
56;2021-02-17;1137;914;0;32433;8151;0;4.9;1.2;0.0
56;2021-02-18;1368;923;0;33801;9074;0;5.1;1.4;0.0
56;2021-02-19;1392;924;0;35193;9998;0;5.3;1.5;0.0
56;2021-02-20;358;262;0;35551;10260;0;5.4;1.6;0.0
56;2021-02-21;2;2;0;35553;10262;0;5.4;1.6;0.0
56;2021-02-22;395;685;0;35948;10947;0;5.4;1.7;0.0
56;2021-02-23;699;862;0;36647;11809;0;5.5;1.8;0.0
56;2021-02-24;933;1094;0;37580;12903;0;5.7;2.0;0.0
56;2021-02-25;2087;4022;0;39667;16925;0;6.0;2.6;0.0
56;2021-02-26;2292;2100;0;41959;19025;0;6.4;2.9;0.0
56;2021-02-27;731;454;0;42690;19479;0;6.5;2.9;0.0
56;2021-02-28;17;111;0;42707;19590;0;6.5;3.0;0.0
56;2021-03-01;723;551;0;43430;20141;0;6.6;3.0;0.0
56;2021-03-02;1012;787;0;44442;20928;0;6.7;3.2;0.0
56;2021-03-03;1163;896;0;45605;21824;0;6.9;3.3;0.0
56;2021-03-04;1980;1001;0;47585;22825;0;7.2;3.5;0.0
56;2021-03-05;2570;1415;0;50155;24240;0;7.6;3.7;0.0
56;2021-03-06;1216;221;0;51371;24461;0;7.8;3.7;0.0
56;2021-03-07;283;27;0;51654;24488;0;7.8;3.7;0.0
56;2021-03-08;1151;418;0;52805;24906;0;8.0;3.8;0.0
56;2021-03-09;2052;641;0;54857;25547;0;8.3;3.9;0.0
56;2021-03-10;1994;922;0;56851;26469;0;8.6;4.0;0.0
56;2021-03-11;3261;769;0;60112;27238;0;9.1;4.1;0.0
56;2021-03-12;4193;807;0;64305;28045;0;9.7;4.2;0.0
56;2021-03-13;1906;162;0;66211;28207;0;10.0;4.3;0.0
56;2021-03-14;182;6;0;66393;28213;0;10.1;4.3;0.0
56;2021-03-15;1374;541;0;67767;28754;0;10.3;4.4;0.0
56;2021-03-16;1084;1048;0;68851;29802;0;10.4;4.5;0.0
56;2021-03-17;1338;782;0;70189;30584;0;10.6;4.6;0.0
56;2021-03-18;1980;1799;0;72169;32383;0;10.9;4.9;0.0
56;2021-03-19;2926;1378;0;75095;33761;0;11.4;5.1;0.0
56;2021-03-20;1460;198;0;76555;33959;0;11.6;5.1;0.0
56;2021-03-21;185;21;0;76740;33980;0;11.6;5.1;0.0
56;2021-03-22;1596;385;0;78336;34365;0;11.9;5.2;0.0
56;2021-03-23;2772;698;0;81108;35063;0;12.3;5.3;0.0
56;2021-03-24;3389;554;0;84497;35617;0;12.8;5.4;0.0
56;2021-03-25;4209;744;0;88706;36361;0;13.4;5.5;0.0
56;2021-03-26;5082;803;0;93788;37164;0;14.2;5.6;0.0
56;2021-03-27;1488;286;0;95276;37450;0;14.4;5.7;0.0
56;2021-03-28;216;11;0;95492;37461;0;14.5;5.7;0.0
56;2021-03-29;2199;556;0;97691;38017;0;14.8;5.8;0.0
56;2021-03-30;3439;826;0;101130;38843;0;15.3;5.9;0.0
56;2021-03-31;3066;739;0;104196;39582;0;15.8;6.0;0.0
56;2021-04-01;4157;846;0;108353;40428;0;16.4;6.1;0.0
56;2021-04-02;3920;1018;0;112273;41446;0;17.0;6.3;0.0
56;2021-04-03;1152;277;0;113425;41723;0;17.2;6.3;0.0
56;2021-04-04;220;10;0;113645;41733;0;17.2;6.3;0.0
56;2021-04-05;213;13;0;113858;41746;0;17.2;6.3;0.0
56;2021-04-06;2719;1222;0;116577;42968;0;17.6;6.5;0.0
56;2021-04-07;3925;1172;0;120502;44140;0;18.2;6.7;0.0
56;2021-04-08;5277;1195;0;125779;45335;0;19.0;6.9;0.0
56;2021-04-09;7148;1260;0;132927;46595;0;20.1;7.1;0.0
56;2021-04-10;2458;396;0;135385;46991;0;20.5;7.1;0.0
56;2021-04-11;189;104;0;135574;47095;0;20.5;7.1;0.0
56;2021-04-12;3764;871;0;139338;47966;0;21.1;7.3;0.0
56;2021-04-13;5704;1246;0;145042;49212;0;22.0;7.5;0.0
56;2021-04-14;4991;1438;0;150033;50650;0;22.7;7.7;0.0
56;2021-04-15;6831;1729;0;156864;52379;0;23.7;7.9;0.0
56;2021-04-16;7679;1955;0;164543;54334;0;24.9;8.2;0.0
56;2021-04-17;2956;625;0;167499;54959;0;25.4;8.3;0.0
56;2021-04-18;508;105;0;168007;55064;0;25.4;8.3;0.0
56;2021-04-19;3596;1244;0;171603;56308;0;26.0;8.5;0.0
56;2021-04-20;3953;1916;0;175556;58224;0;26.6;8.8;0.0
56;2021-04-21;3930;2322;0;179486;60546;0;27.2;9.2;0.0
56;2021-04-22;5048;1936;0;184534;62482;0;27.9;9.5;0.0
56;2021-04-23;5103;2486;0;189637;64968;0;28.7;9.8;0.0
56;2021-04-24;2805;633;0;192442;65601;0;29.1;9.9;0.0
56;2021-04-25;457;144;0;192899;65745;0;29.2;10.0;0.0
56;2021-04-26;4431;1661;0;197330;67406;0;29.9;10.2;0.0
56;2021-04-27;4892;2477;0;202222;69883;0;30.6;10.6;0.0
56;2021-04-28;4762;2211;0;206984;72094;0;31.3;10.9;0.0
56;2021-04-29;5684;2954;0;212668;75048;0;32.2;11.4;0.0
56;2021-04-30;6086;2706;0;218754;77754;0;33.1;11.8;0.0
56;2021-05-01;2301;339;0;221055;78093;0;33.5;11.8;0.0
56;2021-05-02;259;250;0;221314;78343;0;33.5;11.9;0.0
56;2021-05-03;3708;2010;0;225022;80353;0;34.1;12.2;0.0
56;2021-05-04;4235;3739;0;229257;84092;0;34.7;12.7;0.0
56;2021-05-05;3442;3783;0;232699;87875;0;35.2;13.3;0.0
56;2021-05-06;4314;5297;0;237013;93172;0;35.9;14.1;0.0
56;2021-05-07;4210;4872;0;241223;98044;0;36.5;14.8;0.0
56;2021-05-08;1563;306;0;242786;98350;0;36.8;14.9;0.0
56;2021-05-09;522;229;0;243308;98579;0;36.8;14.9;0.0
56;2021-05-10;3596;3796;0;246904;102375;0;37.4;15.5;0.0
56;2021-05-11;4095;4903;0;250999;107278;0;38.0;16.2;0.0
56;2021-05-12;4200;4548;0;255199;111826;0;38.6;16.9;0.0
56;2021-05-13;2412;960;0;257611;112786;0;39.0;17.1;0.0
56;2021-05-14;4140;4193;0;261751;116979;0;39.6;17.7;0.0
56;2021-05-15;2471;1747;0;264222;118726;0;40.0;18.0;0.0
56;2021-05-16;308;466;0;264530;119192;0;40.0;18.0;0.0
56;2021-05-17;2644;3584;0;267174;122776;0;40.4;18.6;0.0
56;2021-05-18;3670;3980;0;270844;126756;0;41.0;19.2;0.0
56;2021-05-19;3708;3263;0;274552;130019;0;41.6;19.7;0.0
56;2021-05-20;4127;4712;0;278679;134731;0;42.2;20.4;0.0
56;2021-05-21;3998;4979;0;282677;139710;0;42.8;21.2;0.0
56;2021-05-22;1720;2074;0;284397;141784;0;43.1;21.5;0.0
56;2021-05-23;340;184;0;284737;141968;0;43.1;21.5;0.0
56;2021-05-24;2325;496;0;287062;142464;0;43.5;21.6;0.0
56;2021-05-25;3367;4307;0;290429;146771;0;44.0;22.2;0.0
56;2021-05-26;3922;3851;0;294351;150622;0;44.6;22.8;0.0
56;2021-05-27;4599;4781;0;298950;155403;0;45.3;23.5;0.0
56;2021-05-28;4762;5758;0;303712;161161;0;46.0;24.4;0.0
56;2021-05-29;1936;1609;0;305648;162770;0;46.3;24.6;0.0
56;2021-05-30;359;74;0;306007;162844;0;46.3;24.7;0.0
56;2021-05-31;4626;3082;0;310633;165926;0;47.0;25.1;0.0
56;2021-06-01;5699;3368;0;316332;169294;0;47.9;25.6;0.0
56;2021-06-02;5734;2937;0;322066;172231;0;48.8;26.1;0.0
56;2021-06-03;6252;3306;0;328318;175537;0;49.7;26.6;0.0
56;2021-06-04;5874;4354;0;334192;179891;0;50.6;27.2;0.0
56;2021-06-05;4283;2345;0;338475;182236;0;51.2;27.6;0.0
56;2021-06-06;728;621;0;339203;182857;0;51.4;27.7;0.0
56;2021-06-07;5040;3227;0;344243;186084;0;52.1;28.2;0.0
56;2021-06-08;6023;3411;0;350266;189495;0;53.0;28.7;0.0
56;2021-06-09;6309;2844;0;356575;192339;0;54.0;29.1;0.0
56;2021-06-10;7364;2986;0;363939;195325;0;55.1;29.6;0.0
56;2021-06-11;6746;3888;0;370685;199213;0;56.1;30.2;0.0
56;2021-06-12;4999;1984;0;375684;201197;0;56.9;30.5;0.0
56;2021-06-13;2048;402;0;377732;201599;0;57.2;30.5;0.0
56;2021-06-14;3400;4560;1;381132;206159;1;57.7;31.2;0.0
56;2021-06-15;4305;4794;0;385437;210953;1;58.4;31.9;0.0
56;2021-06-16;4654;4351;0;390091;215304;1;59.1;32.6;0.0
56;2021-06-17;4445;4652;0;394536;219956;1;59.7;33.3;0.0
56;2021-06-18;4630;5808;0;399166;225764;1;60.4;34.2;0.0
56;2021-06-19;3755;2079;0;402921;227843;1;61.0;34.5;0.0
56;2021-06-20;1646;355;0;404567;228198;1;61.3;34.5;0.0
56;2021-06-21;3344;4484;0;407911;232682;1;61.8;35.2;0.0
56;2021-06-22;3586;5439;0;411497;238121;1;62.3;36.1;0.0
56;2021-06-23;3888;5053;0;415385;243174;1;62.9;36.8;0.0
56;2021-06-24;3613;5254;0;418998;248428;1;63.4;37.6;0.0
56;2021-06-25;3969;6153;0;422967;254581;1;64.0;38.5;0.0
56;2021-06-26;3138;2918;0;426105;257499;1;64.5;39.0;0.0
56;2021-06-27;506;255;0;426611;257754;1;64.6;39.0;0.0
56;2021-06-28;1664;4143;0;428275;261897;1;64.8;39.7;0.0
56;2021-06-29;2455;5804;0;430730;267701;1;65.2;40.5;0.0
56;2021-06-30;2583;5680;0;433313;273381;1;65.6;41.4;0.0
56;2021-07-01;2882;5084;2;436195;278465;3;66.0;42.2;0.0
56;2021-07-02;2694;6226;0;438889;284691;3;66.4;43.1;0.0
56;2021-07-03;2204;2685;0;441093;287376;3;66.8;43.5;0.0
56;2021-07-04;878;825;0;441971;288201;3;66.9;43.6;0.0
56;2021-07-05;1806;5567;0;443777;293768;3;67.2;44.5;0.0
56;2021-07-06;2159;5986;0;445936;299754;3;67.5;45.4;0.0
56;2021-07-07;2728;5678;0;448664;305432;3;67.9;46.2;0.0
56;2021-07-08;3015;6043;1;451679;311475;4;68.4;47.2;0.0
56;2021-07-09;2141;7097;0;453820;318572;4;68.7;48.2;0.0
56;2021-07-10;1199;3048;0;455019;321620;4;68.9;48.7;0.0
56;2021-07-11;380;475;0;455399;322095;4;68.9;48.8;0.0
56;2021-07-12;2038;6814;1;457437;328909;5;69.3;49.8;0.0
56;2021-07-13;2963;7521;0;460400;336430;5;69.7;50.9;0.0
56;2021-07-14;1672;2572;0;462072;339002;5;70.0;51.3;0.0
56;2021-07-15;3533;7004;0;465605;346006;5;70.5;52.4;0.0
56;2021-07-16;3807;7954;0;469412;353960;5;71.1;53.6;0.0
56;2021-07-17;2124;3595;0;471536;357555;5;71.4;54.1;0.0
56;2021-07-18;279;646;0;471815;358201;5;71.4;54.2;0.0
56;2021-07-19;2639;6378;0;474454;364579;5;71.8;55.2;0.0
56;2021-07-20;3336;7875;0;477790;372454;5;72.3;56.4;0.0
56;2021-07-21;2910;7384;0;480700;379838;5;72.8;57.5;0.0
56;2021-07-22;4116;7853;0;484816;387691;5;73.4;58.7;0.0
56;2021-07-23;4176;8240;0;488992;395931;5;74.0;59.9;0.0
56;2021-07-24;1680;4602;0;490672;400533;5;74.3;60.6;0.0
56;2021-07-25;584;1939;0;491256;402472;5;74.4;60.9;0.0
56;2021-07-26;3350;5453;0;494606;407925;5;74.9;61.8;0.0
56;2021-07-27;4822;6064;0;499428;413989;5;75.6;62.7;0.0
56;2021-07-28;4350;5357;0;503778;419346;5;76.3;63.5;0.0
56;2021-07-29;4923;5491;0;508701;424837;5;77.0;64.3;0.0
56;2021-07-30;5073;5662;0;513774;430499;5;77.8;65.2;0.0
56;2021-07-31;2052;2721;0;515826;433220;5;78.1;65.6;0.0
56;2021-08-01;1200;989;0;517026;434209;5;78.3;65.7;0.0
56;2021-08-02;3918;4433;0;520944;438642;5;78.9;66.4;0.0
56;2021-08-03;5416;4671;0;526360;443313;5;79.7;67.1;0.0
56;2021-08-04;5128;3991;0;531488;447304;5;80.5;67.7;0.0
56;2021-08-05;5288;4159;0;536776;451463;5;81.3;68.4;0.0
56;2021-08-06;4978;4378;0;541754;455841;5;82.0;69.0;0.0
56;2021-08-07;2434;2130;0;544188;457971;5;82.4;69.3;0.0
56;2021-08-08;1545;566;0;545733;458537;5;82.6;69.4;0.0
56;2021-08-09;3274;3875;0;549007;462412;5;83.1;70.0;0.0
56;2021-08-10;4236;4119;0;553243;466531;5;83.8;70.6;0.0
56;2021-08-11;3871;3592;0;557114;470123;5;84.3;71.2;0.0
56;2021-08-12;4008;3938;0;561122;474061;5;85.0;71.8;0.0
56;2021-08-13;3656;4056;0;564778;478117;5;85.5;72.4;0.0
56;2021-08-14;1727;2012;0;566505;480129;5;85.8;72.7;0.0
56;2021-08-15;466;479;1;566971;480608;6;85.8;72.8;0.0
56;2021-08-16;2857;4003;0;569828;484611;6;86.3;73.4;0.0
56;2021-08-17;3433;4296;0;573261;488907;6;86.8;74.0;0.0
56;2021-08-18;3383;3957;2;576644;492864;8;87.3;74.6;0.0
56;2021-08-19;2872;4467;0;579516;497331;8;87.7;75.3;0.0
56;2021-08-20;2705;4629;0;582221;501960;8;88.1;76.0;0.0
56;2021-08-21;1216;2180;0;583437;504140;8;88.3;76.3;0.0
56;2021-08-22;261;540;0;583698;504680;8;88.4;76.4;0.0
56;2021-08-23;1882;4523;0;585580;509203;8;88.7;77.1;0.0
56;2021-08-24;1893;4982;0;587473;514185;8;88.9;77.8;0.0
56;2021-08-25;1669;4620;0;589142;518805;8;89.2;78.5;0.0
56;2021-08-26;1412;4929;0;590554;523734;8;89.4;79.3;0.0
56;2021-08-27;1731;5414;0;592285;529148;8;89.7;80.1;0.0
56;2021-08-28;654;2682;0;592939;531830;8;89.8;80.5;0.0
56;2021-08-29;145;505;0;593084;532335;8;89.8;80.6;0.0
56;2021-08-30;1357;4383;123;594441;536718;131;90.0;81.3;0.0
56;2021-08-31;1468;4399;142;595909;541117;273;90.2;81.9;0.0
56;2021-09-01;1362;3723;241;597271;544840;514;90.4;82.5;0.1
56;2021-09-02;1096;3599;316;598367;548439;830;90.6;83.0;0.1
56;2021-09-03;1114;4054;352;599481;552493;1182;90.8;83.6;0.2
56;2021-09-04;790;2340;98;600271;554833;1280;90.9;84.0;0.2
56;2021-09-05;160;460;15;600431;555293;1295;90.9;84.1;0.2
56;2021-09-06;852;3000;466;601283;558293;1761;91.0;84.5;0.3
56;2021-09-07;801;2897;474;602084;561190;2235;91.2;85.0;0.3
56;2021-09-08;967;3162;229;603051;564352;2464;91.3;85.4;0.4
56;2021-09-09;811;2612;376;603862;566964;2840;91.4;85.8;0.4
56;2021-09-10;913;3089;365;604775;570053;3205;91.6;86.3;0.5
56;2021-09-11;503;2050;96;605278;572103;3301;91.6;86.6;0.5
56;2021-09-12;72;308;8;605350;572411;3309;91.6;86.7;0.5
56;2021-09-13;755;2113;572;606105;574524;3881;91.8;87.0;0.6
56;2021-09-14;714;1924;1019;606819;576448;4900;91.9;87.3;0.7
56;2021-09-15;723;2564;548;607542;579012;5448;92.0;87.7;0.8
56;2021-09-16;702;1629;1004;608244;580641;6452;92.1;87.9;1.0
56;2021-09-17;774;2166;739;609018;582807;7191;92.2;88.2;1.1
56;2021-09-18;312;1811;168;609330;584618;7359;92.3;88.5;1.1
56;2021-09-19;73;280;17;609403;584898;7376;92.3;88.6;1.1
56;2021-09-20;455;1335;807;609858;586233;8183;92.3;88.8;1.2
56;2021-09-21;483;1203;914;610341;587436;9097;92.4;88.9;1.4
56;2021-09-22;469;1796;587;610810;589232;9684;92.5;89.2;1.5
56;2021-09-23;500;1037;1128;611310;590269;10812;92.6;89.4;1.6
56;2021-09-24;569;1638;983;611879;591907;11795;92.6;89.6;1.8
56;2021-09-25;289;1165;216;612168;593072;12011;92.7;89.8;1.8
56;2021-09-26;19;118;19;612187;593190;12030;92.7;89.8;1.8
56;2021-09-27;439;997;785;612626;594187;12815;92.8;90.0;1.9
56;2021-09-28;442;938;883;613068;595125;13698;92.8;90.1;2.1
56;2021-09-29;410;1188;644;613478;596313;14342;92.9;90.3;2.2
56;2021-09-30;338;622;860;613816;596935;15202;92.9;90.4;2.3
56;2021-10-01;520;1192;1248;614336;598127;16450;93.0;90.6;2.5
56;2021-10-02;209;483;202;614545;598610;16652;93.0;90.6;2.5
56;2021-10-03;5;68;9;614550;598678;16661;93.0;90.6;2.5
56;2021-10-04;312;769;794;614862;599447;17455;93.1;90.8;2.6
56;2021-10-05;256;650;762;615118;600097;18217;93.1;90.9;2.8
56;2021-10-06;405;948;625;615523;601045;18842;93.2;91.0;2.9
56;2021-10-07;300;863;1151;615823;601908;19993;93.2;91.1;3.0
56;2021-10-08;442;933;976;616265;602841;20969;93.3;91.3;3.2
56;2021-10-09;155;394;235;616420;603235;21204;93.3;91.3;3.2
56;2021-10-10;8;58;9;616428;603293;21213;93.3;91.3;3.2
56;2021-10-11;268;628;625;616696;603921;21838;93.4;91.4;3.3
56;2021-10-12;297;647;900;616993;604568;22738;93.4;91.5;3.4
56;2021-10-13;252;434;446;617245;605002;23184;93.4;91.6;3.5
56;2021-10-14;280;669;945;617525;605671;24129;93.5;91.7;3.7
56;2021-10-15;494;866;1410;618019;606537;25539;93.6;91.8;3.9
56;2021-10-16;164;234;249;618183;606771;25788;93.6;91.9;3.9
56;2021-10-17;7;26;18;618190;606797;25806;93.6;91.9;3.9
56;2021-10-18;326;523;932;618516;607320;26738;93.6;91.9;4.0
56;2021-10-19;217;504;921;618733;607824;27659;93.7;92.0;4.2
56;2021-10-20;153;250;572;618886;608074;28231;93.7;92.1;4.3
56;2021-10-21;255;426;1229;619141;608500;29460;93.7;92.1;4.5
56;2021-10-22;300;727;1403;619441;609227;30863;93.8;92.2;4.7
56;2021-10-23;123;216;197;619564;609443;31060;93.8;92.3;4.7
56;2021-10-24;1;15;2;619565;609458;31062;93.8;92.3;4.7
56;2021-10-25;221;304;964;619786;609762;32026;93.8;92.3;4.8
56;2021-10-26;192;361;1074;619978;610123;33100;93.9;92.4;5.0
56;2021-10-27;192;334;1036;620170;610457;34136;93.9;92.4;5.2
56;2021-10-28;194;278;1089;620364;610735;35225;93.9;92.5;5.3
56;2021-10-29;323;504;1641;620687;611239;36866;94.0;92.5;5.6
56;2021-10-30;82;135;311;620769;611374;37177;94.0;92.6;5.6
56;2021-10-31;5;12;5;620774;611386;37182;94.0;92.6;5.6
56;2021-11-01;11;14;3;620785;611400;37185;94.0;92.6;5.6
56;2021-11-02;326;445;1337;621111;611845;38522;94.0;92.6;5.8
56;2021-11-03;170;178;1012;621281;612023;39534;94.1;92.7;6.0
56;2021-11-04;321;408;1822;621602;612431;41356;94.1;92.7;6.3
56;2021-11-05;231;437;1724;621833;612868;43080;94.1;92.8;6.5
56;2021-11-06;78;115;467;621911;612983;43547;94.2;92.8;6.6
56;2021-11-07;1;6;15;621912;612989;43562;94.2;92.8;6.6
56;2021-11-08;237;369;2189;622149;613358;45751;94.2;92.9;6.9
56;2021-11-09;221;278;2059;622370;613636;47810;94.2;92.9;7.2
56;2021-11-10;191;280;1923;622561;613916;49733;94.3;92.9;7.5
56;2021-11-11;6;14;63;622567;613930;49796;94.3;92.9;7.5
56;2021-11-12;294;503;3051;622861;614433;52847;94.3;93.0;8.0
56;2021-11-13;105;127;979;622966;614560;53826;94.3;93.0;8.1
56;2021-11-14;3;2;8;622969;614562;53834;94.3;93.0;8.2
56;2021-11-15;168;242;2401;623137;614804;56235;94.3;93.1;8.5
56;2021-11-16;174;220;2581;623311;615024;58816;94.4;93.1;8.9
56;2021-11-17;193;250;2319;623504;615274;61135;94.4;93.2;9.3
56;2021-11-18;229;216;3115;623733;615490;64250;94.4;93.2;9.7
56;2021-11-19;358;427;5313;624091;615917;69563;94.5;93.2;10.5
56;2021-11-20;128;122;922;624219;616039;70485;94.5;93.3;10.7
56;2021-11-21;8;8;8;624227;616047;70493;94.5;93.3;10.7
56;2021-11-22;249;150;3457;624476;616197;73950;94.5;93.3;11.2
56;2021-11-23;170;197;3397;624646;616394;77347;94.6;93.3;11.7
56;2021-11-24;210;213;3015;624856;616607;80362;94.6;93.4;12.2
56;2021-11-25;249;232;4822;625105;616839;85184;94.6;93.4;12.9
56;2021-11-26;387;401;6255;625492;617240;91439;94.7;93.4;13.8
56;2021-11-27;103;103;1468;625595;617343;92907;94.7;93.5;14.1
56;2021-11-28;14;14;74;625609;617357;92981;94.7;93.5;14.1
56;2021-11-29;270;223;4691;625879;617580;97672;94.8;93.5;14.8
56;2021-11-30;221;250;6283;626100;617830;103955;94.8;93.5;15.7
56;2021-12-01;272;222;6259;626372;618052;110214;94.8;93.6;16.7
56;2021-12-02;160;138;6845;626532;618190;117059;94.9;93.6;17.7
56;2021-12-03;246;302;8593;626778;618492;125652;94.9;93.6;19.0
56;2021-12-04;174;144;3695;626952;618636;129347;94.9;93.7;19.6
56;2021-12-05;7;15;429;626959;618651;129776;94.9;93.7;19.6
56;2021-12-06;185;198;6415;627144;618849;136191;94.9;93.7;20.6
56;2021-12-07;211;267;8849;627355;619116;145040;95.0;93.7;22.0
56;2021-12-08;255;248;7458;627610;619364;152498;95.0;93.8;23.1
56;2021-12-09;239;260;9765;627849;619624;162263;95.1;93.8;24.6
56;2021-12-10;298;379;10574;628147;620003;172837;95.1;93.9;26.2
56;2021-12-11;171;145;5258;628318;620148;178095;95.1;93.9;27.0
56;2021-12-12;31;20;735;628349;620168;178830;95.1;93.9;27.1
56;2021-12-13;190;258;8377;628539;620426;187207;95.2;93.9;28.3
56;2021-12-14;257;218;11024;628796;620644;198231;95.2;94.0;30.0
56;2021-12-15;245;285;9660;629041;620929;207891;95.2;94.0;31.5
56;2021-12-16;246;311;11438;629287;621240;219329;95.3;94.1;33.2
56;2021-12-17;319;381;11878;629606;621621;231207;95.3;94.1;35.0
56;2021-12-18;270;199;6328;629876;621820;237535;95.4;94.1;36.0
56;2021-12-19;15;16;481;629891;621836;238016;95.4;94.1;36.0
57;2020-12-27;0;0;0;0;0;0;0.0;0.0;0.0
57;2020-12-28;5;0;0;5;0;0;0.0;0.0;0.0
57;2020-12-29;7;0;0;12;0;0;0.0;0.0;0.0
57;2020-12-30;7;0;0;19;0;0;0.0;0.0;0.0
57;2020-12-31;2;0;0;21;0;0;0.0;0.0;0.0
57;2021-01-01;4;1;0;25;1;0;0.0;0.0;0.0
57;2021-01-02;5;0;0;30;1;0;0.0;0.0;0.0
57;2021-01-03;0;0;0;30;1;0;0.0;0.0;0.0
57;2021-01-04;22;0;0;52;1;0;0.0;0.0;0.0
57;2021-01-05;197;0;0;249;1;0;0.0;0.0;0.0
57;2021-01-06;229;0;0;478;1;0;0.1;0.0;0.0
57;2021-01-07;577;2;0;1055;3;0;0.1;0.0;0.0
57;2021-01-08;520;2;0;1575;5;0;0.2;0.0;0.0
57;2021-01-09;197;0;0;1772;5;0;0.2;0.0;0.0
57;2021-01-10;111;1;0;1883;6;0;0.2;0.0;0.0
57;2021-01-11;476;1;0;2359;7;0;0.3;0.0;0.0
57;2021-01-12;627;6;0;2986;13;0;0.3;0.0;0.0
57;2021-01-13;704;2;0;3690;15;0;0.4;0.0;0.0
57;2021-01-14;785;8;0;4475;23;0;0.5;0.0;0.0
57;2021-01-15;695;5;0;5170;28;0;0.6;0.0;0.0
57;2021-01-16;439;1;0;5609;29;0;0.6;0.0;0.0
57;2021-01-17;477;1;0;6086;30;0;0.7;0.0;0.0
57;2021-01-18;2636;23;0;8722;53;0;1.0;0.0;0.0
57;2021-01-19;2589;20;0;11311;73;0;1.3;0.0;0.0
57;2021-01-20;2740;26;0;14051;99;0;1.6;0.0;0.0
57;2021-01-21;1772;11;0;15823;110;0;1.8;0.0;0.0
57;2021-01-22;1321;9;0;17144;119;0;1.9;0.0;0.0
57;2021-01-23;574;16;0;17718;135;0;2.0;0.0;0.0
57;2021-01-24;4;0;0;17722;135;0;2.0;0.0;0.0
57;2021-01-25;937;179;0;18659;314;0;2.1;0.0;0.0
57;2021-01-26;1091;200;0;19750;514;0;2.2;0.1;0.0
57;2021-01-27;1072;170;0;20822;684;0;2.3;0.1;0.0
57;2021-01-28;1096;287;0;21918;971;0;2.4;0.1;0.0
57;2021-01-29;1015;376;0;22933;1347;0;2.5;0.1;0.0
57;2021-01-30;449;90;0;23382;1437;0;2.6;0.2;0.0
57;2021-01-31;17;27;0;23399;1464;0;2.6;0.2;0.0
57;2021-02-01;847;365;0;24246;1829;0;2.7;0.2;0.0
57;2021-02-02;1024;376;0;25270;2205;0;2.8;0.2;0.0
57;2021-02-03;996;337;0;26266;2542;0;2.9;0.3;0.0
57;2021-02-04;1173;815;0;27439;3357;0;3.0;0.4;0.0
57;2021-02-05;983;392;0;28422;3749;0;3.2;0.4;0.0
57;2021-02-06;488;326;0;28910;4075;0;3.2;0.5;0.0
57;2021-02-07;104;331;0;29014;4406;0;3.2;0.5;0.0
57;2021-02-08;1210;1454;0;30224;5860;0;3.4;0.7;0.0
57;2021-02-09;1693;1623;0;31917;7483;0;3.5;0.8;0.0
57;2021-02-10;1682;2015;0;33599;9498;0;3.7;1.1;0.0
57;2021-02-11;1456;1265;0;35055;10763;0;3.9;1.2;0.0
57;2021-02-12;1203;678;0;36258;11441;0;4.0;1.3;0.0
57;2021-02-13;1112;185;0;37370;11626;0;4.2;1.3;0.0
57;2021-02-14;1157;28;0;38527;11654;0;4.3;1.3;0.0
57;2021-02-15;766;868;0;39293;12522;0;4.4;1.4;0.0
57;2021-02-16;1065;865;0;40358;13387;0;4.5;1.5;0.0
57;2021-02-17;952;1014;0;41310;14401;0;4.6;1.6;0.0
57;2021-02-18;952;1226;0;42262;15627;0;4.7;1.7;0.0
57;2021-02-19;974;987;0;43236;16614;0;4.8;1.8;0.0
57;2021-02-20;1121;610;0;44357;17224;0;4.9;1.9;0.0
57;2021-02-21;321;22;0;44678;17246;0;5.0;1.9;0.0
57;2021-02-22;1161;925;0;45839;18171;0;5.1;2.0;0.0
57;2021-02-23;2056;1155;0;47895;19326;0;5.3;2.1;0.0
57;2021-02-24;2159;1020;0;50054;20346;0;5.6;2.3;0.0
57;2021-02-25;3190;1143;0;53244;21489;0;5.9;2.4;0.0
57;2021-02-26;3392;979;0;56636;22468;0;6.3;2.5;0.0
57;2021-02-27;3446;542;0;60082;23010;0;6.7;2.6;0.0
57;2021-02-28;1763;61;0;61845;23071;0;6.9;2.6;0.0
57;2021-03-01;1977;1326;0;63822;24397;0;7.1;2.7;0.0
57;2021-03-02;2774;1591;0;66596;25988;0;7.4;2.9;0.0
57;2021-03-03;2741;1613;0;69337;27601;0;7.7;3.1;0.0
57;2021-03-04;3199;1303;0;72536;28904;0;8.1;3.2;0.0
57;2021-03-05;4298;1249;0;76834;30153;0;8.5;3.3;0.0
57;2021-03-06;6905;796;0;83739;30949;0;9.3;3.4;0.0
57;2021-03-07;5678;280;0;89417;31229;0;9.9;3.5;0.0
57;2021-03-08;2288;1005;0;91705;32234;0;10.2;3.6;0.0
57;2021-03-09;3306;1280;0;95011;33514;0;10.6;3.7;0.0
57;2021-03-10;3578;968;0;98589;34482;0;10.9;3.8;0.0
57;2021-03-11;4023;1192;0;102612;35674;0;11.4;4.0;0.0
57;2021-03-12;5085;1217;0;107697;36891;0;12.0;4.1;0.0
57;2021-03-13;6109;965;0;113806;37856;0;12.6;4.2;0.0
57;2021-03-14;2335;419;0;116141;38275;0;12.9;4.3;0.0
57;2021-03-15;2988;867;0;119129;39142;0;13.2;4.3;0.0
57;2021-03-16;2957;1249;0;122086;40391;0;13.6;4.5;0.0
57;2021-03-17;3093;1109;0;125179;41500;0;13.9;4.6;0.0
57;2021-03-18;3403;1025;0;128582;42525;0;14.3;4.7;0.0
57;2021-03-19;4567;1005;0;133149;43530;0;14.8;4.8;0.0
57;2021-03-20;4552;998;0;137701;44528;0;15.3;4.9;0.0
57;2021-03-21;1840;251;0;139541;44779;0;15.5;5.0;0.0
57;2021-03-22;2413;1402;0;141954;46181;0;15.8;5.1;0.0
57;2021-03-23;3425;2228;0;145379;48409;0;16.1;5.4;0.0
57;2021-03-24;3919;2085;0;149298;50494;0;16.6;5.6;0.0
57;2021-03-25;4756;2512;0;154054;53006;0;17.1;5.9;0.0
57;2021-03-26;4823;2168;0;158877;55174;0;17.6;6.1;0.0
57;2021-03-27;3793;2968;0;162670;58142;0;18.1;6.5;0.0
57;2021-03-28;1399;1715;0;164069;59857;0;18.2;6.6;0.0
57;2021-03-29;2052;2085;0;166121;61942;0;18.4;6.9;0.0
57;2021-03-30;3443;2380;0;169564;64322;0;18.8;7.1;0.0
57;2021-03-31;2974;2256;0;172538;66578;0;19.2;7.4;0.0
57;2021-04-01;3417;3054;0;175955;69632;0;19.5;7.7;0.0
57;2021-04-02;2528;2453;0;178483;72085;0;19.8;8.0;0.0
57;2021-04-03;2599;2503;0;181082;74588;0;20.1;8.3;0.0
57;2021-04-04;567;915;0;181649;75503;0;20.2;8.4;0.0
57;2021-04-05;1836;674;0;183485;76177;0;20.4;8.5;0.0
57;2021-04-06;2413;2730;0;185898;78907;0;20.6;8.8;0.0
57;2021-04-07;3706;2990;0;189604;81897;0;21.1;9.1;0.0
57;2021-04-08;5471;2869;0;195075;84766;0;21.7;9.4;0.0
57;2021-04-09;5056;2776;0;200131;87542;0;22.2;9.7;0.0
57;2021-04-10;2452;3451;0;202583;90993;0;22.5;10.1;0.0
57;2021-04-11;1066;1842;0;203649;92835;0;22.6;10.3;0.0
57;2021-04-12;1862;2731;0;205511;95566;0;22.8;10.6;0.0
57;2021-04-13;2101;3032;0;207612;98598;0;23.1;11.0;0.0
57;2021-04-14;2119;3010;0;209731;101608;0;23.3;11.3;0.0
57;2021-04-15;2552;3393;0;212283;105001;0;23.6;11.7;0.0
57;2021-04-16;2770;3278;0;215053;108279;0;23.9;12.0;0.0
57;2021-04-17;2680;3119;0;217733;111398;0;24.2;12.4;0.0
57;2021-04-18;1147;1718;0;218880;113116;0;24.3;12.6;0.0
57;2021-04-19;2356;2331;0;221236;115447;0;24.6;12.8;0.0
57;2021-04-20;2722;2801;0;223958;118248;0;24.9;13.1;0.0
57;2021-04-21;3369;2455;0;227327;120703;0;25.2;13.4;0.0
57;2021-04-22;3428;2324;0;230755;123027;0;25.6;13.7;0.0
57;2021-04-23;4233;2631;0;234988;125658;0;26.1;14.0;0.0
57;2021-04-24;3529;2610;0;238517;128268;0;26.5;14.2;0.0
57;2021-04-25;805;1121;0;239322;129389;0;26.6;14.4;0.0
57;2021-04-26;3129;2135;0;242451;131524;0;26.9;14.6;0.0
57;2021-04-27;4056;2511;0;246507;134035;0;27.4;14.9;0.0
57;2021-04-28;4674;2661;0;251181;136696;0;27.9;15.2;0.0
57;2021-04-29;5655;3472;0;256836;140168;0;28.5;15.6;0.0
57;2021-04-30;4980;3526;0;261816;143694;0;29.1;16.0;0.0
57;2021-05-01;2456;1707;0;264272;145401;0;29.3;16.1;0.0
57;2021-05-02;838;898;0;265110;146299;0;29.4;16.2;0.0
57;2021-05-03;3824;3025;0;268934;149324;0;29.9;16.6;0.0
57;2021-05-04;4989;3178;0;273923;152502;0;30.4;16.9;0.0
57;2021-05-05;6324;3154;0;280247;155656;0;31.1;17.3;0.0
57;2021-05-06;6103;3332;0;286350;158988;0;31.8;17.7;0.0
57;2021-05-07;6845;3478;0;293195;162466;0;32.6;18.0;0.0
57;2021-05-08;4014;1578;0;297209;164044;0;33.0;18.2;0.0
57;2021-05-09;2047;1051;0;299256;165095;0;33.2;18.3;0.0
57;2021-05-10;5195;3115;0;304451;168210;0;33.8;18.7;0.0
57;2021-05-11;7468;2929;0;311919;171139;0;34.6;19.0;0.0
57;2021-05-12;7749;3421;0;319668;174560;0;35.5;19.4;0.0
57;2021-05-13;4604;930;0;324272;175490;0;36.0;19.5;0.0
57;2021-05-14;7732;2693;0;332004;178183;0;36.9;19.8;0.0
57;2021-05-15;5849;2137;0;337853;180320;0;37.5;20.0;0.0
57;2021-05-16;3355;579;0;341208;180899;0;37.9;20.1;0.0
57;2021-05-17;3977;2201;0;345185;183100;0;38.3;20.3;0.0
57;2021-05-18;6268;2160;0;351453;185260;0;39.0;20.6;0.0
57;2021-05-19;6980;2426;0;358433;187686;0;39.8;20.8;0.0
57;2021-05-20;6277;2264;0;364710;189950;0;40.5;21.1;0.0
57;2021-05-21;7737;2968;0;372447;192918;0;41.4;21.4;0.0
57;2021-05-22;5089;2196;0;377536;195114;0;41.9;21.7;0.0
57;2021-05-23;1961;426;0;379497;195540;0;42.1;21.7;0.0
57;2021-05-24;3114;1072;0;382611;196612;0;42.5;21.8;0.0
57;2021-05-25;5626;2853;0;388237;199465;0;43.1;22.2;0.0
57;2021-05-26;6516;3322;0;394753;202787;0;43.8;22.5;0.0
57;2021-05-27;6246;3266;0;400999;206053;0;44.5;22.9;0.0
57;2021-05-28;6965;4743;0;407964;210796;0;45.3;23.4;0.0
57;2021-05-29;5319;4394;0;413283;215190;0;45.9;23.9;0.0
57;2021-05-30;1900;1685;0;415183;216875;0;46.1;24.1;0.0
57;2021-05-31;4394;3486;0;419577;220361;0;46.6;24.5;0.0
57;2021-06-01;5872;3841;0;425449;224202;0;47.2;24.9;0.0
57;2021-06-02;6261;4286;0;431710;228488;0;47.9;25.4;0.0
57;2021-06-03;6176;4125;0;437886;232613;0;48.6;25.8;0.0
57;2021-06-04;7392;5152;0;445278;237765;0;49.5;26.4;0.0
57;2021-06-05;4703;4136;0;449981;241901;0;50.0;26.9;0.0
57;2021-06-06;1925;897;0;451906;242798;0;50.2;27.0;0.0
57;2021-06-07;4341;4180;0;456247;246978;0;50.7;27.4;0.0
57;2021-06-08;6398;4631;0;462645;251609;0;51.4;27.9;0.0
57;2021-06-09;6683;4440;0;469328;256049;0;52.1;28.4;0.0
57;2021-06-10;6011;4779;0;475339;260828;0;52.8;29.0;0.0
57;2021-06-11;5236;5460;0;480575;266288;0;53.4;29.6;0.0
57;2021-06-12;5429;4526;0;486004;270814;0;54.0;30.1;0.0
57;2021-06-13;1408;1140;0;487412;271954;0;54.1;30.2;0.0
57;2021-06-14;3272;4926;0;490684;276880;0;54.5;30.7;0.0
57;2021-06-15;3813;6075;0;494497;282955;0;54.9;31.4;0.0
57;2021-06-16;4333;6696;0;498830;289651;0;55.4;32.2;0.0
57;2021-06-17;4198;6128;0;503028;295779;0;55.9;32.8;0.0
57;2021-06-18;4300;7387;0;507328;303166;0;56.3;33.7;0.0
57;2021-06-19;4019;6268;0;511347;309434;0;56.8;34.4;0.0
57;2021-06-20;945;1649;0;512292;311083;0;56.9;34.5;0.0
57;2021-06-21;2179;6102;0;514471;317185;0;57.1;35.2;0.0
57;2021-06-22;2638;8043;0;517109;325228;0;57.4;36.1;0.0
57;2021-06-23;3070;8392;0;520179;333620;0;57.8;37.1;0.0
57;2021-06-24;2566;5401;0;522745;339021;0;58.1;37.7;0.0
57;2021-06-25;2814;7835;0;525559;346856;0;58.4;38.5;0.0
57;2021-06-26;2789;7127;0;528348;353983;0;58.7;39.3;0.0
57;2021-06-27;717;2797;0;529065;356780;0;58.8;39.6;0.0
57;2021-06-28;1668;5285;0;530733;362065;0;58.9;40.2;0.0
57;2021-06-29;2096;6924;0;532829;368989;0;59.2;41.0;0.0
57;2021-06-30;3068;7401;2;535897;376390;2;59.5;41.8;0.0
57;2021-07-01;2727;6197;0;538624;382587;2;59.8;42.5;0.0
57;2021-07-02;2695;8193;0;541319;390780;2;60.1;43.4;0.0
57;2021-07-03;3126;6424;0;544445;397204;2;60.5;44.1;0.0
57;2021-07-04;887;2437;0;545332;399641;2;60.6;44.4;0.0
57;2021-07-05;1833;4807;0;547165;404448;2;60.8;44.9;0.0
57;2021-07-06;2509;6509;0;549674;410957;2;61.0;45.6;0.0
57;2021-07-07;2774;7182;0;552448;418139;2;61.4;46.4;0.0
57;2021-07-08;2638;6110;0;555086;424249;2;61.6;47.1;0.0
57;2021-07-09;3411;8356;0;558497;432605;2;62.0;48.0;0.0
57;2021-07-10;2986;6867;0;561483;439472;2;62.4;48.8;0.0
57;2021-07-11;815;2186;0;562298;441658;2;62.4;49.0;0.0
57;2021-07-12;2401;6472;0;564699;448130;2;62.7;49.8;0.0
57;2021-07-13;4274;7507;0;568973;455637;2;63.2;50.6;0.0
57;2021-07-14;2751;3773;0;571724;459410;2;63.5;51.0;0.0
57;2021-07-15;4000;7695;0;575724;467105;2;63.9;51.9;0.0
57;2021-07-16;5553;9487;0;581277;476592;2;64.6;52.9;0.0
57;2021-07-17;5477;7024;0;586754;483616;2;65.2;53.7;0.0
57;2021-07-18;1545;2621;0;588299;486237;2;65.3;54.0;0.0
57;2021-07-19;2569;6188;0;590868;492425;2;65.6;54.7;0.0
57;2021-07-20;4260;6958;0;595128;499383;2;66.1;55.5;0.0
57;2021-07-21;5037;6868;0;600165;506251;2;66.7;56.2;0.0
57;2021-07-22;5568;5872;0;605733;512123;2;67.3;56.9;0.0
57;2021-07-23;6571;6379;0;612304;518502;2;68.0;57.6;0.0
57;2021-07-24;4379;6859;0;616683;525361;2;68.5;58.3;0.0
57;2021-07-25;1319;1714;0;618002;527075;2;68.6;58.5;0.0
57;2021-07-26;3705;4560;0;621707;531635;2;69.0;59.0;0.0
57;2021-07-27;6630;5075;0;628337;536710;2;69.8;59.6;0.0
57;2021-07-28;7163;4553;0;635500;541263;2;70.6;60.1;0.0
57;2021-07-29;7435;4615;0;642935;545878;2;71.4;60.6;0.0
57;2021-07-30;6727;5033;0;649662;550911;2;72.1;61.2;0.0
57;2021-07-31;5503;4965;0;655165;555876;2;72.8;61.7;0.0
57;2021-08-01;1954;1103;0;657119;556979;2;73.0;61.9;0.0
57;2021-08-02;3698;3318;0;660817;560297;2;73.4;62.2;0.0
57;2021-08-03;5394;4307;0;666211;564604;2;74.0;62.7;0.0
57;2021-08-04;5019;3511;0;671230;568115;2;74.5;63.1;0.0
57;2021-08-05;5137;3782;0;676367;571897;2;75.1;63.5;0.0
57;2021-08-06;5397;4811;0;681764;576708;2;75.7;64.0;0.0
57;2021-08-07;4253;5023;1;686017;581731;3;76.2;64.6;0.0
57;2021-08-08;1438;1468;0;687455;583199;3;76.3;64.8;0.0
57;2021-08-09;2577;3295;1;690032;586494;4;76.6;65.1;0.0
57;2021-08-10;3475;3881;0;693507;590375;4;77.0;65.6;0.0
57;2021-08-11;3540;3959;0;697047;594334;4;77.4;66.0;0.0
57;2021-08-12;3060;5066;0;700107;599400;4;77.8;66.6;0.0
57;2021-08-13;3293;4689;0;703400;604089;4;78.1;67.1;0.0
57;2021-08-14;2143;4982;0;705543;609071;4;78.4;67.6;0.0
57;2021-08-15;491;1075;0;706034;610146;4;78.4;67.8;0.0
57;2021-08-16;1840;3610;0;707874;613756;4;78.6;68.2;0.0
57;2021-08-17;2318;5313;0;710192;619069;4;78.9;68.8;0.0
57;2021-08-18;2321;5176;0;712513;624245;4;79.1;69.3;0.0
57;2021-08-19;2203;5393;0;714716;629638;4;79.4;69.9;0.0
57;2021-08-20;2035;5972;0;716751;635610;4;79.6;70.6;0.0
57;2021-08-21;1797;5291;0;718548;640901;4;79.8;71.2;0.0
57;2021-08-22;427;1482;0;718975;642383;4;79.8;71.3;0.0
57;2021-08-23;1165;3871;0;720140;646254;4;80.0;71.8;0.0
57;2021-08-24;1764;5477;0;721904;651731;4;80.2;72.4;0.0
57;2021-08-25;1607;5122;0;723511;656853;4;80.4;72.9;0.0
57;2021-08-26;1535;4535;0;725046;661388;4;80.5;73.5;0.0
57;2021-08-27;1727;5716;0;726773;667104;4;80.7;74.1;0.0
57;2021-08-28;1950;5217;0;728723;672321;4;80.9;74.7;0.0
57;2021-08-29;343;1086;0;729066;673407;4;81.0;74.8;0.0
57;2021-08-30;1063;3204;51;730129;676611;55;81.1;75.1;0.0
57;2021-08-31;1430;4157;159;731559;680768;214;81.2;75.6;0.0
57;2021-09-01;1657;3734;338;733216;684502;552;81.4;76.0;0.1
57;2021-09-02;1169;2995;322;734385;687497;874;81.6;76.4;0.1
57;2021-09-03;1540;3913;422;735925;691410;1296;81.7;76.8;0.1
57;2021-09-04;1608;3664;289;737533;695074;1585;81.9;77.2;0.2
57;2021-09-05;345;795;96;737878;695869;1681;81.9;77.3;0.2
57;2021-09-06;814;1778;375;738692;697647;2056;82.0;77.5;0.2
57;2021-09-07;728;1868;403;739420;699515;2459;82.1;77.7;0.3
57;2021-09-08;938;2424;443;740358;701939;2902;82.2;78.0;0.3
57;2021-09-09;676;1930;436;741034;703869;3338;82.3;78.2;0.4
57;2021-09-10;1150;2412;567;742184;706281;3905;82.4;78.4;0.4
57;2021-09-11;1167;2939;335;743351;709220;4240;82.6;78.8;0.5
57;2021-09-12;239;465;66;743590;709685;4306;82.6;78.8;0.5
57;2021-09-13;651;1234;491;744241;710919;4797;82.7;79.0;0.5
57;2021-09-14;774;1487;711;745015;712406;5508;82.7;79.1;0.6
57;2021-09-15;773;1936;753;745788;714342;6261;82.8;79.3;0.7
57;2021-09-16;715;1192;735;746503;715534;6996;82.9;79.5;0.8
57;2021-09-17;1110;1793;637;747613;717327;7633;83.0;79.7;0.8
57;2021-09-18;824;2504;422;748437;719831;8055;83.1;79.9;0.9
57;2021-09-19;117;322;73;748554;720153;8128;83.1;80.0;0.9
57;2021-09-20;452;890;752;749006;721043;8880;83.2;80.1;1.0
57;2021-09-21;489;839;815;749495;721882;9695;83.2;80.2;1.1
57;2021-09-22;511;1305;743;750006;723187;10438;83.3;80.3;1.2
57;2021-09-23;459;1174;757;750465;724361;11195;83.3;80.4;1.2
57;2021-09-24;758;1447;987;751223;725808;12182;83.4;80.6;1.4
57;2021-09-25;520;1931;526;751743;727739;12708;83.5;80.8;1.4
57;2021-09-26;110;304;88;751853;728043;12796;83.5;80.9;1.4
57;2021-09-27;418;836;792;752271;728879;13588;83.5;80.9;1.5
57;2021-09-28;316;608;944;752587;729487;14532;83.6;81.0;1.6
57;2021-09-29;517;1074;1136;753104;730561;15668;83.6;81.1;1.7
57;2021-09-30;334;619;1020;753438;731180;16688;83.7;81.2;1.9
57;2021-10-01;824;1307;1649;754262;732487;18337;83.8;81.3;2.0
57;2021-10-02;695;1497;844;754957;733984;19181;83.8;81.5;2.1
57;2021-10-03;118;215;143;755075;734199;19324;83.9;81.5;2.1
57;2021-10-04;532;605;1087;755607;734804;20411;83.9;81.6;2.3
57;2021-10-05;367;566;1157;755974;735370;21568;84.0;81.7;2.4
57;2021-10-06;520;747;1329;756494;736117;22897;84.0;81.8;2.5
57;2021-10-07;365;621;1139;756859;736738;24036;84.1;81.8;2.7
57;2021-10-08;554;1045;1960;757413;737783;25996;84.1;81.9;2.9
57;2021-10-09;625;1142;1359;758038;738925;27355;84.2;82.1;3.0
57;2021-10-10;96;122;112;758134;739047;27467;84.2;82.1;3.1
57;2021-10-11;415;592;1175;758549;739639;28642;84.2;82.1;3.2
57;2021-10-12;356;477;1103;758905;740116;29745;84.3;82.2;3.3
57;2021-10-13;599;703;1421;759504;740819;31166;84.3;82.3;3.5
57;2021-10-14;349;479;1130;759853;741298;32296;84.4;82.3;3.6
57;2021-10-15;655;988;2573;760508;742286;34869;84.5;82.4;3.9
57;2021-10-16;653;749;1715;761161;743035;36584;84.5;82.5;4.1
57;2021-10-17;97;129;216;761258;743164;36800;84.5;82.5;4.1
57;2021-10-18;433;545;1404;761691;743709;38204;84.6;82.6;4.2
57;2021-10-19;329;416;1165;762020;744125;39369;84.6;82.6;4.4
57;2021-10-20;469;497;1667;762489;744622;41036;84.7;82.7;4.6
57;2021-10-21;296;461;1043;762785;745083;42079;84.7;82.7;4.7
57;2021-10-22;623;745;2675;763408;745828;44754;84.8;82.8;5.0
57;2021-10-23;573;732;1719;763981;746560;46473;84.8;82.9;5.2
57;2021-10-24;83;109;163;764064;746669;46636;84.9;82.9;5.2
57;2021-10-25;354;436;1545;764418;747105;48181;84.9;83.0;5.4
57;2021-10-26;249;311;1349;764667;747416;49530;84.9;83.0;5.5
57;2021-10-27;384;467;1793;765051;747883;51323;85.0;83.1;5.7
57;2021-10-28;250;283;1252;765301;748166;52575;85.0;83.1;5.8
57;2021-10-29;471;582;2362;765772;748748;54937;85.0;83.2;6.1
57;2021-10-30;404;548;1411;766176;749296;56348;85.1;83.2;6.3
57;2021-10-31;53;90;140;766229;749386;56488;85.1;83.2;6.3
57;2021-11-01;124;79;90;766353;749465;56578;85.1;83.2;6.3
57;2021-11-02;380;421;1424;766733;749886;58002;85.2;83.3;6.4
57;2021-11-03;387;559;2245;767120;750445;60247;85.2;83.3;6.7
57;2021-11-04;284;405;1827;767404;750850;62074;85.2;83.4;6.9
57;2021-11-05;484;653;2761;767888;751503;64835;85.3;83.5;7.2
57;2021-11-06;434;715;2009;768322;752218;66844;85.3;83.5;7.4
57;2021-11-07;50;79;170;768372;752297;67014;85.3;83.5;7.4
57;2021-11-08;300;507;2899;768672;752804;69913;85.4;83.6;7.8
57;2021-11-09;262;334;2599;768934;753138;72512;85.4;83.6;8.1
57;2021-11-10;382;531;3240;769316;753669;75752;85.4;83.7;8.4
57;2021-11-11;52;94;336;769368;753763;76088;85.4;83.7;8.5
57;2021-11-12;468;712;4405;769836;754475;80493;85.5;83.8;8.9
57;2021-11-13;392;608;2861;770228;755083;83354;85.5;83.9;9.3
57;2021-11-14;67;117;487;770295;755200;83841;85.5;83.9;9.3
57;2021-11-15;295;424;2882;770590;755624;86723;85.6;83.9;9.6
57;2021-11-16;296;350;2729;770886;755974;89452;85.6;84.0;9.9
57;2021-11-17;428;477;3167;771314;756451;92619;85.7;84.0;10.3
57;2021-11-18;281;335;3057;771595;756786;95676;85.7;84.0;10.6
57;2021-11-19;493;590;4491;772088;757376;100167;85.7;84.1;11.1
57;2021-11-20;508;520;3058;772596;757896;103225;85.8;84.2;11.5
57;2021-11-21;48;56;203;772644;757952;103428;85.8;84.2;11.5
57;2021-11-22;315;255;3416;772959;758207;106844;85.8;84.2;11.9
57;2021-11-23;420;402;3451;773379;758609;110295;85.9;84.2;12.2
57;2021-11-24;383;480;3693;773762;759089;113988;85.9;84.3;12.7
57;2021-11-25;376;371;4373;774138;759460;118361;86.0;84.3;13.1
57;2021-11-26;466;564;7009;774604;760024;125370;86.0;84.4;13.9
57;2021-11-27;452;595;6081;775056;760619;131451;86.1;84.5;14.6
57;2021-11-28;80;96;2436;775136;760715;133887;86.1;84.5;14.9
57;2021-11-29;312;371;5714;775448;761086;139601;86.1;84.5;15.5
57;2021-11-30;349;397;7666;775797;761483;147267;86.2;84.6;16.4
57;2021-12-01;250;418;6441;776047;761901;153708;86.2;84.6;17.1
57;2021-12-02;353;316;9549;776400;762217;163257;86.2;84.6;18.1
57;2021-12-03;396;548;11062;776796;762765;174319;86.3;84.7;19.4
57;2021-12-04;489;586;8929;777285;763351;183248;86.3;84.8;20.4
57;2021-12-05;178;152;2951;777463;763503;186199;86.3;84.8;20.7
57;2021-12-06;383;527;6692;777846;764030;192891;86.4;84.9;21.4
57;2021-12-07;362;471;9371;778208;764501;202262;86.4;84.9;22.5
57;2021-12-08;468;593;8955;778676;765094;211217;86.5;85.0;23.5
57;2021-12-09;434;474;10582;779110;765568;221799;86.5;85.0;24.6
57;2021-12-10;563;665;12499;779673;766233;234298;86.6;85.1;26.0
57;2021-12-11;534;762;10334;780207;766995;244632;86.6;85.2;27.2
57;2021-12-12;190;138;3208;780397;767133;247840;86.7;85.2;27.5
57;2021-12-13;407;495;8209;780804;767628;256049;86.7;85.3;28.4
57;2021-12-14;474;587;10435;781278;768215;266484;86.8;85.3;29.6
57;2021-12-15;546;591;11405;781824;768806;277889;86.8;85.4;30.9
57;2021-12-16;532;538;12091;782356;769344;289980;86.9;85.4;32.2
57;2021-12-17;603;681;13327;782959;770025;303307;87.0;85.5;33.7
57;2021-12-18;625;680;9932;783584;770705;313239;87.0;85.6;34.8
57;2021-12-19;190;187;3540;783774;770892;316779;87.0;85.6;35.2
58;2020-12-27;0;0;0;0;0;0;0.0;0.0;0.0
58;2020-12-28;0;0;0;0;0;0;0.0;0.0;0.0
58;2020-12-29;0;0;0;0;0;0;0.0;0.0;0.0
58;2020-12-30;0;0;0;0;0;0;0.0;0.0;0.0
58;2020-12-31;0;0;0;0;0;0;0.0;0.0;0.0
58;2021-01-01;0;0;0;0;0;0;0.0;0.0;0.0
58;2021-01-02;0;0;0;0;0;0;0.0;0.0;0.0
58;2021-01-03;1;0;0;1;0;0;0.0;0.0;0.0
58;2021-01-04;0;0;0;1;0;0;0.0;0.0;0.0
58;2021-01-05;1;0;0;2;0;0;0.0;0.0;0.0
58;2021-01-06;131;0;0;133;0;0;0.1;0.0;0.0
58;2021-01-07;229;0;0;362;0;0;0.2;0.0;0.0
58;2021-01-08;64;0;0;426;0;0;0.2;0.0;0.0
58;2021-01-09;1;0;0;427;0;0;0.2;0.0;0.0
58;2021-01-10;2;0;0;429;0;0;0.2;0.0;0.0
58;2021-01-11;55;0;0;484;0;0;0.3;0.0;0.0
58;2021-01-12;246;0;0;730;0;0;0.4;0.0;0.0
58;2021-01-13;391;4;0;1121;4;0;0.6;0.0;0.0
58;2021-01-14;266;2;0;1387;6;0;0.8;0.0;0.0
58;2021-01-15;149;0;0;1536;6;0;0.9;0.0;0.0
58;2021-01-16;20;2;0;1556;8;0;0.9;0.0;0.0
58;2021-01-17;1;0;0;1557;8;0;0.9;0.0;0.0
58;2021-01-18;397;1;0;1954;9;0;1.1;0.0;0.0
58;2021-01-19;896;2;0;2850;11;0;1.6;0.0;0.0
58;2021-01-20;1114;1;0;3964;12;0;2.2;0.0;0.0
58;2021-01-21;904;5;0;4868;17;0;2.7;0.0;0.0
58;2021-01-22;726;5;0;5594;22;0;3.1;0.0;0.0
58;2021-01-23;258;0;0;5852;22;0;3.3;0.0;0.0
58;2021-01-24;2;0;0;5854;22;0;3.3;0.0;0.0
58;2021-01-25;364;2;0;6218;24;0;3.5;0.0;0.0
58;2021-01-26;585;3;0;6803;27;0;3.8;0.0;0.0
58;2021-01-27;585;45;0;7388;72;0;4.1;0.0;0.0
58;2021-01-28;675;64;0;8063;136;0;4.5;0.1;0.0
58;2021-01-29;757;12;0;8820;148;0;5.0;0.1;0.0
58;2021-01-30;241;1;0;9061;149;0;5.1;0.1;0.0
58;2021-01-31;11;0;0;9072;149;0;5.1;0.1;0.0
58;2021-02-01;183;74;0;9255;223;0;5.2;0.1;0.0
58;2021-02-02;490;82;0;9745;305;0;5.5;0.2;0.0
58;2021-02-03;291;147;0;10036;452;0;5.6;0.3;0.0
58;2021-02-04;257;93;0;10293;545;0;5.8;0.3;0.0
58;2021-02-05;139;93;0;10432;638;0;5.9;0.4;0.0
58;2021-02-06;94;2;0;10526;640;0;5.9;0.4;0.0
58;2021-02-07;2;0;0;10528;640;0;5.9;0.4;0.0
58;2021-02-08;243;74;0;10771;714;0;6.0;0.4;0.0
58;2021-02-09;426;294;0;11197;1008;0;6.3;0.6;0.0
58;2021-02-10;310;352;0;11507;1360;0;6.5;0.8;0.0
58;2021-02-11;282;367;0;11789;1727;0;6.6;1.0;0.0
58;2021-02-12;201;213;0;11990;1940;0;6.7;1.1;0.0
58;2021-02-13;72;33;0;12062;1973;0;6.8;1.1;0.0
58;2021-02-14;0;2;0;12062;1975;0;6.8;1.1;0.0
58;2021-02-15;112;482;0;12174;2457;0;6.8;1.4;0.0
58;2021-02-16;193;851;0;12367;3308;0;6.9;1.9;0.0
58;2021-02-17;193;694;0;12560;4002;0;7.1;2.2;0.0
58;2021-02-18;161;744;0;12721;4746;0;7.1;2.7;0.0
58;2021-02-19;235;685;0;12956;5431;0;7.3;3.0;0.0
58;2021-02-20;61;234;0;13017;5665;0;7.3;3.2;0.0
58;2021-02-21;0;31;0;13017;5696;0;7.3;3.2;0.0
58;2021-02-22;82;358;0;13099;6054;0;7.4;3.4;0.0
58;2021-02-23;53;581;0;13152;6635;0;7.4;3.7;0.0
58;2021-02-24;53;539;0;13205;7174;0;7.4;4.0;0.0
58;2021-02-25;239;623;0;13444;7797;0;7.5;4.4;0.0
58;2021-02-26;232;567;0;13676;8364;0;7.7;4.7;0.0
58;2021-02-27;102;197;0;13778;8561;0;7.7;4.8;0.0
58;2021-02-28;13;8;0;13791;8569;0;7.7;4.8;0.0
58;2021-03-01;143;216;0;13934;8785;0;7.8;4.9;0.0
58;2021-03-02;375;553;0;14309;9338;0;8.0;5.2;0.0
58;2021-03-03;499;279;0;14808;9617;0;8.3;5.4;0.0
58;2021-03-04;641;250;0;15449;9867;0;8.7;5.5;0.0
58;2021-03-05;739;176;0;16188;10043;0;9.1;5.6;0.0
58;2021-03-06;540;83;0;16728;10126;0;9.4;5.7;0.0
58;2021-03-07;64;5;0;16792;10131;0;9.4;5.7;0.0
58;2021-03-08;160;258;0;16952;10389;0;9.5;5.8;0.0
58;2021-03-09;504;472;0;17456;10861;0;9.8;6.1;0.0
58;2021-03-10;806;244;0;18262;11105;0;10.3;6.2;0.0
58;2021-03-11;831;266;0;19093;11371;0;10.7;6.4;0.0
58;2021-03-12;773;177;0;19866;11548;0;11.2;6.5;0.0
58;2021-03-13;478;67;0;20344;11615;0;11.4;6.5;0.0
58;2021-03-14;36;1;0;20380;11616;0;11.4;6.5;0.0
58;2021-03-15;479;109;0;20859;11725;0;11.7;6.6;0.0
58;2021-03-16;654;219;0;21513;11944;0;12.1;6.7;0.0
58;2021-03-17;659;150;0;22172;12094;0;12.4;6.8;0.0
58;2021-03-18;582;162;0;22754;12256;0;12.8;6.9;0.0
58;2021-03-19;541;107;0;23295;12363;0;13.1;6.9;0.0
58;2021-03-20;313;64;0;23608;12427;0;13.3;7.0;0.0
58;2021-03-21;15;0;0;23623;12427;0;13.3;7.0;0.0
58;2021-03-22;723;23;0;24346;12450;0;13.7;7.0;0.0
58;2021-03-23;1413;44;0;25759;12494;0;14.5;7.0;0.0
58;2021-03-24;1213;74;0;26972;12568;0;15.1;7.1;0.0
58;2021-03-25;1622;43;0;28594;12611;0;16.1;7.1;0.0
58;2021-03-26;1309;56;0;29903;12667;0;16.8;7.1;0.0
58;2021-03-27;380;14;0;30283;12681;0;17.0;7.1;0.0
58;2021-03-28;20;1;0;30303;12682;0;17.0;7.1;0.0
58;2021-03-29;584;144;0;30887;12826;0;17.3;7.2;0.0
58;2021-03-30;1081;238;0;31968;13064;0;17.9;7.3;0.0
58;2021-03-31;973;328;0;32941;13392;0;18.5;7.5;0.0
58;2021-04-01;1436;353;0;34377;13745;0;19.3;7.7;0.0
58;2021-04-02;1367;306;0;35744;14051;0;20.1;7.9;0.0
58;2021-04-03;573;157;0;36317;14208;0;20.4;8.0;0.0
58;2021-04-04;4;2;0;36321;14210;0;20.4;8.0;0.0
58;2021-04-05;49;2;0;36370;14212;0;20.4;8.0;0.0
58;2021-04-06;730;335;0;37100;14547;0;20.8;8.2;0.0
58;2021-04-07;670;489;0;37770;15036;0;21.2;8.4;0.0
58;2021-04-08;1372;406;0;39142;15442;0;22.0;8.7;0.0
58;2021-04-09;1629;393;0;40771;15835;0;22.9;8.9;0.0
58;2021-04-10;576;191;0;41347;16026;0;23.2;9.0;0.0
58;2021-04-11;30;3;0;41377;16029;0;23.2;9.0;0.0
58;2021-04-12;1071;460;0;42448;16489;0;23.8;9.3;0.0
58;2021-04-13;1379;588;0;43827;17077;0;24.6;9.6;0.0
58;2021-04-14;1232;620;0;45059;17697;0;25.3;9.9;0.0
58;2021-04-15;1261;585;0;46320;18282;0;26.0;10.3;0.0
58;2021-04-16;1529;487;0;47849;18769;0;26.9;10.5;0.0
58;2021-04-17;681;234;0;48530;19003;0;27.2;10.7;0.0
58;2021-04-18;19;10;0;48549;19013;0;27.3;10.7;0.0
58;2021-04-19;490;543;0;49039;19556;0;27.5;11.0;0.0
58;2021-04-20;477;946;0;49516;20502;0;27.8;11.5;0.0
58;2021-04-21;541;829;0;50057;21331;0;28.1;12.0;0.0
58;2021-04-22;711;1323;0;50768;22654;0;28.5;12.7;0.0
58;2021-04-23;889;702;0;51657;23356;0;29.0;13.1;0.0
58;2021-04-24;215;222;0;51872;23578;0;29.1;13.2;0.0
58;2021-04-25;16;1;0;51888;23579;0;29.1;13.2;0.0
58;2021-04-26;719;274;0;52607;23853;0;29.5;13.4;0.0
58;2021-04-27;1333;1024;0;53940;24877;0;30.3;14.0;0.0
58;2021-04-28;1459;889;0;55399;25766;0;31.1;14.5;0.0
58;2021-04-29;1330;978;0;56729;26744;0;31.8;15.0;0.0
58;2021-04-30;1160;875;0;57889;27619;0;32.5;15.5;0.0
58;2021-05-01;46;66;0;57935;27685;0;32.5;15.5;0.0
58;2021-05-02;18;5;0;57953;27690;0;32.5;15.5;0.0
58;2021-05-03;993;400;0;58946;28090;0;33.1;15.8;0.0
58;2021-05-04;1058;1212;0;60004;29302;0;33.7;16.4;0.0
58;2021-05-05;934;998;0;60938;30300;0;34.2;17.0;0.0
58;2021-05-06;1353;940;0;62291;31240;0;35.0;17.5;0.0
58;2021-05-07;1114;985;0;63405;32225;0;35.6;18.1;0.0
58;2021-05-08;144;67;0;63549;32292;0;35.7;18.1;0.0
58;2021-05-09;20;31;0;63569;32323;0;35.7;18.1;0.0
58;2021-05-10;930;877;0;64499;33200;0;36.2;18.6;0.0
58;2021-05-11;1385;1821;0;65884;35021;0;37.0;19.7;0.0
58;2021-05-12;1783;1470;0;67667;36491;0;38.0;20.5;0.0
58;2021-05-13;149;174;0;67816;36665;0;38.1;20.6;0.0
58;2021-05-14;2156;807;0;69972;37472;0;39.3;21.0;0.0
58;2021-05-15;1685;422;0;71657;37894;0;40.2;21.3;0.0
58;2021-05-16;124;33;0;71781;37927;0;40.3;21.3;0.0
58;2021-05-17;758;557;0;72539;38484;0;40.7;21.6;0.0
58;2021-05-18;1386;1110;0;73925;39594;0;41.5;22.2;0.0
58;2021-05-19;1758;510;0;75683;40104;0;42.5;22.5;0.0
58;2021-05-20;1743;626;0;77426;40730;0;43.5;22.9;0.0
58;2021-05-21;910;647;0;78336;41377;0;44.0;23.2;0.0
58;2021-05-22;416;231;0;78752;41608;0;44.2;23.4;0.0
58;2021-05-23;46;25;0;78798;41633;0;44.2;23.4;0.0
58;2021-05-24;164;53;0;78962;41686;0;44.3;23.4;0.0
58;2021-05-25;1441;1021;0;80403;42707;0;45.1;24.0;0.0
58;2021-05-26;967;741;0;81370;43448;0;45.7;24.4;0.0
58;2021-05-27;935;907;0;82305;44355;0;46.2;24.9;0.0
58;2021-05-28;639;843;0;82944;45198;0;46.6;25.4;0.0
58;2021-05-29;366;231;0;83310;45429;0;46.8;25.5;0.0
58;2021-05-30;97;19;0;83407;45448;0;46.8;25.5;0.0
58;2021-05-31;832;389;0;84239;45837;0;47.3;25.7;0.0
58;2021-06-01;1490;1531;0;85729;47368;0;48.1;26.6;0.0
58;2021-06-02;1574;987;0;87303;48355;0;49.0;27.1;0.0
58;2021-06-03;1143;886;0;88446;49241;0;49.7;27.6;0.0
58;2021-06-04;976;893;0;89422;50134;0;50.2;28.1;0.0
58;2021-06-05;443;284;0;89865;50418;0;50.4;28.3;0.0
58;2021-06-06;54;53;0;89919;50471;0;50.5;28.3;0.0
58;2021-06-07;750;745;0;90669;51216;0;50.9;28.8;0.0
58;2021-06-08;1310;1716;0;91979;52932;0;51.6;29.7;0.0
58;2021-06-09;1445;968;0;93424;53900;0;52.4;30.3;0.0
58;2021-06-10;1173;930;0;94597;54830;0;53.1;30.8;0.0
58;2021-06-11;987;909;0;95584;55739;0;53.7;31.3;0.0
58;2021-06-12;1084;421;0;96668;56160;0;54.3;31.5;0.0
58;2021-06-13;47;43;0;96715;56203;0;54.3;31.6;0.0
58;2021-06-14;519;1033;0;97234;57236;0;54.6;32.1;0.0
58;2021-06-15;1423;1774;0;98657;59010;0;55.4;33.1;0.0
58;2021-06-16;1666;992;0;100323;60002;0;56.3;33.7;0.0
58;2021-06-17;1798;1133;0;102121;61135;0;57.3;34.3;0.0
58;2021-06-18;890;1150;0;103011;62285;0;57.8;35.0;0.0
58;2021-06-19;567;386;0;103578;62671;0;58.1;35.2;0.0
58;2021-06-20;21;10;0;103599;62681;0;58.2;35.2;0.0
58;2021-06-21;452;646;0;104051;63327;0;58.4;35.6;0.0
58;2021-06-22;953;2028;0;105004;65355;0;58.9;36.7;0.0
58;2021-06-23;1298;1566;0;106302;66921;0;59.7;37.6;0.0
58;2021-06-24;681;981;0;106983;67902;0;60.1;38.1;0.0
58;2021-06-25;759;1712;0;107742;69614;0;60.5;39.1;0.0
58;2021-06-26;513;1300;0;108255;70914;0;60.8;39.8;0.0
58;2021-06-27;31;56;0;108286;70970;0;60.8;39.8;0.0
58;2021-06-28;394;981;0;108680;71951;0;61.0;40.4;0.0
58;2021-06-29;580;2104;0;109260;74055;0;61.3;41.6;0.0
58;2021-06-30;935;1662;0;110195;75717;0;61.9;42.5;0.0
58;2021-07-01;704;1696;0;110899;77413;0;62.3;43.5;0.0
58;2021-07-02;408;931;0;111307;78344;0;62.5;44.0;0.0
58;2021-07-03;237;652;0;111544;78996;0;62.6;44.3;0.0
58;2021-07-04;22;74;0;111566;79070;0;62.6;44.4;0.0
58;2021-07-05;500;841;0;112066;79911;0;62.9;44.9;0.0
58;2021-07-06;630;2099;0;112696;82010;0;63.3;46.0;0.0
58;2021-07-07;383;1099;0;113079;83109;0;63.5;46.7;0.0
58;2021-07-08;429;1075;0;113508;84184;0;63.7;47.3;0.0
58;2021-07-09;716;1459;0;114224;85643;0;64.1;48.1;0.0
58;2021-07-10;278;577;0;114502;86220;0;64.3;48.4;0.0
58;2021-07-11;174;135;0;114676;86355;0;64.4;48.5;0.0
58;2021-07-12;220;1073;0;114896;87428;0;64.5;49.1;0.0
58;2021-07-13;915;2554;0;115811;89982;0;65.0;50.5;0.0
58;2021-07-14;100;120;0;115911;90102;0;65.1;50.6;0.0
58;2021-07-15;1099;1931;0;117010;92033;0;65.7;51.7;0.0
58;2021-07-16;1329;1465;0;118339;93498;0;66.4;52.5;0.0
58;2021-07-17;482;443;0;118821;93941;0;66.7;52.7;0.0
58;2021-07-18;116;41;0;118937;93982;0;66.8;52.8;0.0
58;2021-07-19;1370;970;0;120307;94952;0;67.5;53.3;0.0
58;2021-07-20;1337;2357;0;121644;97309;0;68.3;54.6;0.0
58;2021-07-21;1154;1991;0;122798;99300;0;68.9;55.7;0.0
58;2021-07-22;1134;1614;0;123932;100914;0;69.6;56.7;0.0
58;2021-07-23;1201;1389;0;125133;102303;0;70.2;57.4;0.0
58;2021-07-24;924;1257;0;126057;103560;0;70.8;58.1;0.0
58;2021-07-25;96;61;0;126153;103621;0;70.8;58.2;0.0
58;2021-07-26;914;822;0;127067;104443;0;71.3;58.6;0.0
58;2021-07-27;1487;2382;0;128554;106825;0;72.2;60.0;0.0
58;2021-07-28;1462;1781;0;130016;108606;0;73.0;61.0;0.0
58;2021-07-29;1525;1493;0;131541;110099;0;73.8;61.8;0.0
58;2021-07-30;1372;1282;1;132913;111381;1;74.6;62.5;0.0
58;2021-07-31;595;550;0;133508;111931;1;74.9;62.8;0.0
58;2021-08-01;57;26;0;133565;111957;1;75.0;62.9;0.0
58;2021-08-02;1465;859;0;135030;112816;1;75.8;63.3;0.0
58;2021-08-03;1728;1590;0;136758;114406;1;76.8;64.2;0.0
58;2021-08-04;1189;1088;0;137947;115494;1;77.4;64.8;0.0
58;2021-08-05;1352;1108;0;139299;116602;1;78.2;65.5;0.0
58;2021-08-06;1184;984;0;140483;117586;1;78.9;66.0;0.0
58;2021-08-07;349;432;0;140832;118018;1;79.1;66.3;0.0
58;2021-08-08;34;79;0;140866;118097;1;79.1;66.3;0.0
58;2021-08-09;937;1172;0;141803;119269;1;79.6;67.0;0.0
58;2021-08-10;1538;1254;0;143341;120523;1;80.5;67.7;0.0
58;2021-08-11;990;735;0;144331;121258;1;81.0;68.1;0.0
58;2021-08-12;920;1055;0;145251;122313;1;81.5;68.7;0.0
58;2021-08-13;819;882;0;146070;123195;1;82.0;69.2;0.0
58;2021-08-14;232;363;0;146302;123558;1;82.1;69.4;0.0
58;2021-08-15;23;43;0;146325;123601;1;82.1;69.4;0.0
58;2021-08-16;344;1251;0;146669;124852;1;82.3;70.1;0.0
58;2021-08-17;723;1258;0;147392;126110;1;82.7;70.8;0.0
58;2021-08-18;672;1095;0;148064;127205;1;83.1;71.4;0.0
58;2021-08-19;641;1274;0;148705;128479;1;83.5;72.1;0.0
58;2021-08-20;601;1159;1;149306;129638;2;83.8;72.8;0.0
58;2021-08-21;226;489;0;149532;130127;2;83.9;73.1;0.0
58;2021-08-22;16;112;0;149548;130239;2;84.0;73.1;0.0
58;2021-08-23;362;793;0;149910;131032;2;84.2;73.6;0.0
58;2021-08-24;420;1282;0;150330;132314;2;84.4;74.3;0.0
58;2021-08-25;405;1358;0;150735;133672;2;84.6;75.0;0.0
58;2021-08-26;488;1501;0;151223;135173;2;84.9;75.9;0.0
58;2021-08-27;446;1379;0;151669;136552;2;85.1;76.7;0.0
58;2021-08-28;228;661;0;151897;137213;2;85.3;77.0;0.0
58;2021-08-29;10;52;0;151907;137265;2;85.3;77.1;0.0
58;2021-08-30;321;771;26;152228;138036;28;85.5;77.5;0.0
58;2021-08-31;442;1352;73;152670;139388;101;85.7;78.2;0.1
58;2021-09-01;374;1324;161;153044;140712;262;85.9;79.0;0.1
58;2021-09-02;265;1085;117;153309;141797;379;86.1;79.6;0.2
58;2021-09-03;334;1180;204;153643;142977;583;86.3;80.3;0.3
58;2021-09-04;199;570;64;153842;143547;647;86.4;80.6;0.4
58;2021-09-05;8;42;2;153850;143589;649;86.4;80.6;0.4
58;2021-09-06;136;398;163;153986;143987;812;86.4;80.8;0.5
58;2021-09-07;263;695;174;154249;144682;986;86.6;81.2;0.6
58;2021-09-08;233;912;262;154482;145594;1248;86.7;81.7;0.7
58;2021-09-09;233;455;254;154715;146049;1502;86.9;82.0;0.8
58;2021-09-10;238;626;282;154953;146675;1784;87.0;82.3;1.0
58;2021-09-11;108;407;87;155061;147082;1871;87.0;82.6;1.1
58;2021-09-12;5;11;11;155066;147093;1882;87.1;82.6;1.1
58;2021-09-13;183;388;298;155249;147481;2180;87.2;82.8;1.2
58;2021-09-14;267;572;356;155516;148053;2536;87.3;83.1;1.4
58;2021-09-15;184;521;281;155700;148574;2817;87.4;83.4;1.6
58;2021-09-16;190;424;337;155890;148998;3154;87.5;83.6;1.8
58;2021-09-17;195;377;237;156085;149375;3391;87.6;83.9;1.9
58;2021-09-18;106;355;82;156191;149730;3473;87.7;84.1;1.9
58;2021-09-19;6;10;3;156197;149740;3476;87.7;84.1;2.0
58;2021-09-20;160;223;287;156357;149963;3763;87.8;84.2;2.1
58;2021-09-21;132;364;309;156489;150327;4072;87.8;84.4;2.3
58;2021-09-22;147;488;484;156636;150815;4556;87.9;84.7;2.6
58;2021-09-23;131;294;315;156767;151109;4871;88.0;84.8;2.7
58;2021-09-24;118;345;254;156885;151454;5125;88.1;85.0;2.9
58;2021-09-25;77;319;109;156962;151773;5234;88.1;85.2;2.9
58;2021-09-26;10;15;20;156972;151788;5254;88.1;85.2;2.9
58;2021-09-27;88;221;217;157060;152009;5471;88.2;85.3;3.1
58;2021-09-28;119;307;298;157179;152316;5769;88.2;85.5;3.2
58;2021-09-29;98;322;372;157277;152638;6141;88.3;85.7;3.4
58;2021-09-30;77;207;261;157354;152845;6402;88.3;85.8;3.6
58;2021-10-01;98;215;200;157452;153060;6602;88.4;85.9;3.7
58;2021-10-02;85;201;167;157537;153261;6769;88.4;86.0;3.8
58;2021-10-03;0;4;8;157537;153265;6777;88.4;86.0;3.8
58;2021-10-04;69;169;185;157606;153434;6962;88.5;86.1;3.9
58;2021-10-05;131;294;438;157737;153728;7400;88.6;86.3;4.2
58;2021-10-06;71;281;276;157808;154009;7676;88.6;86.5;4.3
58;2021-10-07;85;138;304;157893;154147;7980;88.6;86.5;4.5
58;2021-10-08;109;217;309;158002;154364;8289;88.7;86.7;4.7
58;2021-10-09;67;134;137;158069;154498;8426;88.7;86.7;4.7
58;2021-10-10;3;14;16;158072;154512;8442;88.7;86.7;4.7
58;2021-10-11;50;152;260;158122;154664;8702;88.8;86.8;4.9
58;2021-10-12;107;195;430;158229;154859;9132;88.8;86.9;5.1
58;2021-10-13;122;230;521;158351;155089;9653;88.9;87.1;5.4
58;2021-10-14;67;209;333;158418;155298;9986;88.9;87.2;5.6
58;2021-10-15;73;107;289;158491;155405;10275;89.0;87.2;5.8
58;2021-10-16;61;117;142;158552;155522;10417;89.0;87.3;5.8
58;2021-10-17;3;7;7;158555;155529;10424;89.0;87.3;5.9
58;2021-10-18;33;68;242;158588;155597;10666;89.0;87.3;6.0
58;2021-10-19;67;100;431;158655;155697;11097;89.1;87.4;6.2
58;2021-10-20;132;151;624;158787;155848;11721;89.1;87.5;6.6
58;2021-10-21;49;78;334;158836;155926;12055;89.2;87.5;6.8
58;2021-10-22;52;88;275;158888;156014;12330;89.2;87.6;6.9
58;2021-10-23;63;89;247;158951;156103;12577;89.2;87.6;7.1
58;2021-10-24;9;18;23;158960;156121;12600;89.2;87.6;7.1
58;2021-10-25;40;62;269;159000;156183;12869;89.3;87.7;7.2
58;2021-10-26;83;116;573;159083;156299;13442;89.3;87.7;7.5
58;2021-10-27;75;86;507;159158;156385;13949;89.3;87.8;7.8
58;2021-10-28;55;92;521;159213;156477;14470;89.4;87.8;8.1
58;2021-10-29;41;68;299;159254;156545;14769;89.4;87.9;8.3
58;2021-10-30;54;72;172;159308;156617;14941;89.4;87.9;8.4
58;2021-10-31;0;10;8;159308;156627;14949;89.4;87.9;8.4
58;2021-11-01;3;0;4;159311;156627;14953;89.4;87.9;8.4
58;2021-11-02;57;93;449;159368;156720;15402;89.5;88.0;8.6
58;2021-11-03;73;143;671;159441;156863;16073;89.5;88.1;9.0
58;2021-11-04;63;70;461;159504;156933;16534;89.5;88.1;9.3
58;2021-11-05;60;66;408;159564;156999;16942;89.6;88.1;9.5
58;2021-11-06;40;54;216;159604;157053;17158;89.6;88.2;9.6
58;2021-11-07;4;6;36;159608;157059;17194;89.6;88.2;9.7
58;2021-11-08;26;39;441;159634;157098;17635;89.6;88.2;9.9
58;2021-11-09;54;84;775;159688;157182;18410;89.6;88.2;10.3
58;2021-11-10;84;144;857;159772;157326;19267;89.7;88.3;10.8
58;2021-11-11;6;8;24;159778;157334;19291;89.7;88.3;10.8
58;2021-11-12;68;73;610;159846;157407;19901;89.7;88.4;11.2
58;2021-11-13;32;61;278;159878;157468;20179;89.8;88.4;11.3
58;2021-11-14;2;8;12;159880;157476;20191;89.8;88.4;11.3
58;2021-11-15;34;46;626;159914;157522;20817;89.8;88.4;11.7
58;2021-11-16;58;89;1014;159972;157611;21831;89.8;88.5;12.3
58;2021-11-17;69;136;951;160041;157747;22782;89.8;88.6;12.8
58;2021-11-18;58;60;856;160099;157807;23638;89.9;88.6;13.3
58;2021-11-19;55;62;743;160154;157869;24381;89.9;88.6;13.7
58;2021-11-20;39;51;361;160193;157920;24742;89.9;88.7;13.9
58;2021-11-21;3;3;48;160196;157923;24790;89.9;88.7;13.9
58;2021-11-22;39;31;682;160235;157954;25472;90.0;88.7;14.3
58;2021-11-23;74;64;1022;160309;158018;26494;90.0;88.7;14.9
58;2021-11-24;89;125;1063;160398;158143;27557;90.0;88.8;15.5
58;2021-11-25;63;65;1326;160461;158208;28883;90.1;88.8;16.2
58;2021-11-26;76;64;1099;160537;158272;29982;90.1;88.9;16.8
58;2021-11-27;44;54;627;160581;158326;30609;90.1;88.9;17.2
58;2021-11-28;9;5;104;160590;158331;30713;90.2;88.9;17.2
58;2021-11-29;60;40;1402;160650;158371;32115;90.2;88.9;18.0
58;2021-11-30;74;58;2101;160724;158429;34216;90.2;88.9;19.2
58;2021-12-01;50;66;1923;160774;158495;36139;90.3;89.0;20.3
58;2021-12-02;52;52;2188;160826;158547;38327;90.3;89.0;21.5
58;2021-12-03;51;64;1956;160877;158611;40283;90.3;89.0;22.6
58;2021-12-04;46;44;934;160923;158655;41217;90.3;89.1;23.1
58;2021-12-05;2;6;132;160925;158661;41349;90.3;89.1;23.2
58;2021-12-06;41;34;1686;160966;158695;43035;90.4;89.1;24.2
58;2021-12-07;50;70;2370;161016;158765;45405;90.4;89.1;25.5
58;2021-12-08;34;70;2029;161050;158835;47434;90.4;89.2;26.6
58;2021-12-09;46;61;2755;161096;158896;50189;90.4;89.2;28.2
58;2021-12-10;68;64;2306;161164;158960;52495;90.5;89.2;29.5
58;2021-12-11;36;56;1022;161200;159016;53517;90.5;89.3;30.0
58;2021-12-12;6;9;185;161206;159025;53702;90.5;89.3;30.1
58;2021-12-13;43;53;1869;161249;159078;55571;90.5;89.3;31.2
58;2021-12-14;53;95;3131;161302;159173;58702;90.6;89.4;33.0
58;2021-12-15;62;80;2489;161364;159253;61191;90.6;89.4;34.4
58;2021-12-16;54;95;2942;161418;159348;64133;90.6;89.5;36.0
58;2021-12-17;54;72;2450;161472;159420;66583;90.6;89.5;37.4
58;2021-12-18;60;61;1300;161532;159481;67883;90.7;89.5;38.1
58;2021-12-19;8;11;241;161540;159492;68124;90.7;89.5;38.2
59;2020-12-27;0;0;0;0;0;0;0.0;0.0;0.0
59;2020-12-28;25;0;0;25;0;0;0.0;0.0;0.0
59;2020-12-29;0;0;0;25;0;0;0.0;0.0;0.0
59;2020-12-30;1;0;0;26;0;0;0.0;0.0;0.0
59;2020-12-31;1;0;0;27;0;0;0.0;0.0;0.0
59;2021-01-01;2;0;0;29;0;0;0.0;0.0;0.0
59;2021-01-02;5;2;0;34;2;0;0.0;0.0;0.0
59;2021-01-03;3;0;0;37;2;0;0.0;0.0;0.0
59;2021-01-04;80;0;0;117;2;0;0.0;0.0;0.0
59;2021-01-05;202;0;0;319;2;0;0.0;0.0;0.0
59;2021-01-06;404;2;0;723;4;0;0.0;0.0;0.0
59;2021-01-07;1276;1;0;1999;5;0;0.1;0.0;0.0
59;2021-01-08;1253;9;0;3252;14;0;0.1;0.0;0.0
59;2021-01-09;564;2;0;3816;16;0;0.2;0.0;0.0
59;2021-01-10;402;0;0;4218;16;0;0.2;0.0;0.0
59;2021-01-11;1769;7;0;5987;23;0;0.3;0.0;0.0
59;2021-01-12;2402;3;0;8389;26;0;0.4;0.0;0.0
59;2021-01-13;2315;5;0;10704;31;0;0.5;0.0;0.0
59;2021-01-14;2666;26;0;13370;57;0;0.6;0.0;0.0
59;2021-01-15;2212;17;0;15582;74;0;0.7;0.0;0.0
59;2021-01-16;735;3;0;16317;77;0;0.7;0.0;0.0
59;2021-01-17;514;4;0;16831;81;0;0.8;0.0;0.0
59;2021-01-18;3441;13;0;20272;94;0;0.9;0.0;0.0
59;2021-01-19;4723;14;0;24995;108;0;1.1;0.0;0.0
59;2021-01-20;4092;13;0;29087;121;0;1.3;0.0;0.0
59;2021-01-21;4717;43;0;33804;164;0;1.5;0.0;0.0
59;2021-01-22;4063;13;0;37867;177;0;1.7;0.0;0.0
59;2021-01-23;1221;2;0;39088;179;0;1.8;0.0;0.0
59;2021-01-24;163;0;0;39251;179;0;1.8;0.0;0.0
59;2021-01-25;2756;53;0;42007;232;0;1.9;0.0;0.0
59;2021-01-26;2836;129;0;44843;361;0;2.0;0.0;0.0
59;2021-01-27;1780;293;0;46623;654;0;2.1;0.0;0.0
59;2021-01-28;3470;747;0;50093;1401;0;2.3;0.1;0.0
59;2021-01-29;2569;774;0;52662;2175;0;2.4;0.1;0.0
59;2021-01-30;298;177;0;52960;2352;0;2.4;0.1;0.0
59;2021-01-31;26;1;0;52986;2353;0;2.4;0.1;0.0
59;2021-02-01;90;839;0;53076;3192;0;2.4;0.1;0.0
59;2021-02-02;701;1445;0;53777;4637;0;2.5;0.2;0.0
59;2021-02-03;3541;1429;0;57318;6066;0;2.6;0.3;0.0
59;2021-02-04;2830;1707;0;60148;7773;0;2.7;0.4;0.0
59;2021-02-05;1053;1386;0;61201;9159;0;2.8;0.4;0.0
59;2021-02-06;218;378;0;61419;9537;0;2.8;0.4;0.0
59;2021-02-07;250;47;0;61669;9584;0;2.8;0.4;0.0
59;2021-02-08;673;1569;0;62342;11153;0;2.8;0.5;0.0
59;2021-02-09;1011;1791;0;63353;12944;0;2.9;0.6;0.0
59;2021-02-10;1011;1622;0;64364;14566;0;2.9;0.7;0.0
59;2021-02-11;1340;1822;0;65704;16388;0;3.0;0.7;0.0
59;2021-02-12;1449;1588;0;67153;17976;0;3.1;0.8;0.0
59;2021-02-13;194;708;0;67347;18684;0;3.1;0.9;0.0
59;2021-02-14;15;41;0;67362;18725;0;3.1;0.9;0.0
59;2021-02-15;1335;3095;0;68697;21820;0;3.1;1.0;0.0
59;2021-02-16;1430;3695;0;70127;25515;0;3.2;1.2;0.0
59;2021-02-17;1592;3819;0;71719;29334;0;3.3;1.3;0.0
59;2021-02-18;3024;5180;0;74743;34514;0;3.4;1.6;0.0
59;2021-02-19;3209;3636;0;77952;38150;0;3.6;1.7;0.0
59;2021-02-20;1382;1558;0;79334;39708;0;3.6;1.8;0.0
59;2021-02-21;246;244;0;79580;39952;0;3.6;1.8;0.0
59;2021-02-22;1407;2551;0;80987;42503;0;3.7;1.9;0.0
59;2021-02-23;2605;2855;0;83592;45358;0;3.8;2.1;0.0
59;2021-02-24;3994;3888;0;87586;49246;0;4.0;2.2;0.0
59;2021-02-25;6729;3561;0;94315;52807;0;4.3;2.4;0.0
59;2021-02-26;6356;1826;0;100671;54633;0;4.6;2.5;0.0
59;2021-02-27;3023;186;0;103694;54819;0;4.7;2.5;0.0
59;2021-02-28;204;62;0;103898;54881;0;4.7;2.5;0.0
59;2021-03-01;3583;652;0;107481;55533;0;4.9;2.5;0.0
59;2021-03-02;4764;572;0;112245;56105;0;5.1;2.6;0.0
59;2021-03-03;5650;989;0;117895;57094;0;5.4;2.6;0.0
59;2021-03-04;6992;928;0;124887;58022;0;5.7;2.6;0.0
59;2021-03-05;7747;980;0;132634;59002;0;6.0;2.7;0.0
59;2021-03-06;11372;562;0;144006;59564;0;6.6;2.7;0.0
59;2021-03-07;7480;364;0;151486;59928;0;6.9;2.7;0.0
59;2021-03-08;4366;1079;0;155852;61007;0;7.1;2.8;0.0
59;2021-03-09;6388;1392;0;162240;62399;0;7.4;2.8;0.0
59;2021-03-10;6841;1216;0;169081;63615;0;7.7;2.9;0.0
59;2021-03-11;9270;1931;0;178351;65546;0;8.1;3.0;0.0
59;2021-03-12;11932;1599;0;190283;67145;0;8.7;3.1;0.0
59;2021-03-13;16250;1102;0;206533;68247;0;9.4;3.1;0.0
59;2021-03-14;6788;374;0;213321;68621;0;9.7;3.1;0.0
59;2021-03-15;5503;1492;0;218824;70113;0;10.0;3.2;0.0
59;2021-03-16;3700;1368;0;222524;71481;0;10.1;3.3;0.0
59;2021-03-17;3791;2037;0;226315;73518;0;10.3;3.4;0.0
59;2021-03-18;3907;2383;0;230222;75901;0;10.5;3.5;0.0
59;2021-03-19;7643;1860;0;237865;77761;0;10.8;3.5;0.0
59;2021-03-20;15512;1294;0;253377;79055;0;11.5;3.6;0.0
59;2021-03-21;6343;462;0;259720;79517;0;11.8;3.6;0.0
59;2021-03-22;5285;1740;0;265005;81257;0;12.1;3.7;0.0
59;2021-03-23;7679;2817;0;272684;84074;0;12.4;3.8;0.0
59;2021-03-24;6949;2983;0;279633;87057;0;12.7;4.0;0.0
59;2021-03-25;10496;2562;0;290129;89619;0;13.2;4.1;0.0
59;2021-03-26;12207;2876;0;302336;92495;0;13.8;4.2;0.0
59;2021-03-27;15160;1155;0;317496;93650;0;14.5;4.3;0.0
59;2021-03-28;7845;366;0;325341;94016;0;14.8;4.3;0.0
59;2021-03-29;5498;3144;0;330839;97160;0;15.1;4.4;0.0
59;2021-03-30;7568;3748;0;338407;100908;0;15.4;4.6;0.0
59;2021-03-31;6246;4138;0;344653;105046;0;15.7;4.8;0.0
59;2021-04-01;7536;4931;0;352189;109977;0;16.0;5.0;0.0
59;2021-04-02;7724;5446;0;359913;115423;0;16.4;5.3;0.0
59;2021-04-03;12652;4235;0;372565;119658;0;17.0;5.5;0.0
59;2021-04-04;5215;2164;0;377780;121822;0;17.2;5.6;0.0
59;2021-04-05;5600;1473;0;383380;123295;0;17.5;5.6;0.0
59;2021-04-06;5482;4423;0;388862;127718;0;17.7;5.8;0.0
59;2021-04-07;7695;5339;0;396557;133057;0;18.1;6.1;0.0
59;2021-04-08;10320;5791;0;406877;138848;0;18.5;6.3;0.0
59;2021-04-09;13289;5839;0;420166;144687;0;19.1;6.6;0.0
59;2021-04-10;11218;6118;0;431384;150805;0;19.7;6.9;0.0
59;2021-04-11;4471;3522;0;435855;154327;0;19.9;7.0;0.0
59;2021-04-12;6222;4219;0;442077;158546;0;20.1;7.2;0.0
59;2021-04-13;8982;4714;0;451059;163260;0;20.6;7.4;0.0
59;2021-04-14;8737;4299;0;459796;167559;0;21.0;7.6;0.0
59;2021-04-15;10218;4840;0;470014;172399;0;21.4;7.9;0.0
59;2021-04-16;10710;5399;0;480724;177798;0;21.9;8.1;0.0
59;2021-04-17;7112;8740;0;487836;186538;0;22.2;8.5;0.0
59;2021-04-18;3078;4218;0;490914;190756;0;22.4;8.7;0.0
59;2021-04-19;4889;4150;0;495803;194906;0;22.6;8.9;0.0
59;2021-04-20;6895;4267;0;502698;199173;0;22.9;9.1;0.0
59;2021-04-21;6305;4539;0;509003;203712;0;23.2;9.3;0.0
59;2021-04-22;8373;5579;0;517376;209291;0;23.6;9.5;0.0
59;2021-04-23;8338;5744;0;525714;215035;0;24.0;9.8;0.0
59;2021-04-24;5422;7977;0;531136;223012;0;24.2;10.2;0.0
59;2021-04-25;3133;5886;0;534269;228898;0;24.3;10.4;0.0
59;2021-04-26;6260;3739;0;540529;232637;0;24.6;10.6;0.0
59;2021-04-27;8205;5255;0;548734;237892;0;25.0;10.8;0.0
59;2021-04-28;8644;6609;0;557378;244501;0;25.4;11.1;0.0
59;2021-04-29;9253;8612;0;566631;253113;0;25.8;11.5;0.0
59;2021-04-30;10258;8518;0;576889;261631;0;26.3;11.9;0.0
59;2021-05-01;11336;7126;0;588225;268757;0;26.8;12.2;0.0
59;2021-05-02;8156;5568;0;596381;274325;0;27.2;12.5;0.0
59;2021-05-03;9020;4977;0;605401;279302;0;27.6;12.7;0.0
59;2021-05-04;10938;6029;0;616339;285331;0;28.1;13.0;0.0
59;2021-05-05;9856;6281;0;626195;291612;0;28.5;13.3;0.0
59;2021-05-06;10842;8305;0;637037;299917;0;29.0;13.7;0.0
59;2021-05-07;12515;9451;0;649552;309368;0;29.6;14.1;0.0
59;2021-05-08;13744;3948;0;663296;313316;0;30.2;14.3;0.0
59;2021-05-09;10609;3216;0;673905;316532;0;30.7;14.4;0.0
59;2021-05-10;11615;6501;0;685520;323033;0;31.2;14.7;0.0
59;2021-05-11;14304;8310;0;699824;331343;0;31.9;15.1;0.0
59;2021-05-12;15747;8505;0;715571;339848;0;32.6;15.5;0.0
59;2021-05-13;17688;3333;0;733259;343181;0;33.4;15.6;0.0
59;2021-05-14;15443;6790;0;748702;349971;0;34.1;15.9;0.0
59;2021-05-15;22735;5109;0;771437;355080;0;35.2;16.2;0.0
59;2021-05-16;19878;2308;0;791315;357388;0;36.1;16.3;0.0
59;2021-05-17;14441;5085;0;805756;362473;0;36.7;16.5;0.0
59;2021-05-18;16550;5633;0;822306;368106;0;37.5;16.8;0.0
59;2021-05-19;17717;5120;0;840023;373226;0;38.3;17.0;0.0
59;2021-05-20;17371;6877;0;857394;380103;0;39.1;17.3;0.0
59;2021-05-21;17604;8087;0;874998;388190;0;39.9;17.7;0.0
59;2021-05-22;23091;5537;0;898089;393727;0;40.9;17.9;0.0
59;2021-05-23;16715;2193;0;914804;395920;0;41.7;18.0;0.0
59;2021-05-24;14845;1915;0;929649;397835;0;42.4;18.1;0.0
59;2021-05-25;14541;6642;0;944190;404477;0;43.0;18.4;0.0
59;2021-05-26;14967;7033;0;959157;411510;0;43.7;18.8;0.0
59;2021-05-27;15424;9057;0;974581;420567;0;44.4;19.2;0.0
59;2021-05-28;15163;11236;0;989744;431803;0;45.1;19.7;0.0
59;2021-05-29;13848;8591;0;1003592;440394;0;45.7;20.1;0.0
59;2021-05-30;7837;1774;0;1011429;442168;0;46.1;20.1;0.0
59;2021-05-31;13616;7702;0;1025045;449870;0;46.7;20.5;0.0
59;2021-06-01;14807;10312;0;1039852;460182;0;47.4;21.0;0.0
59;2021-06-02;14353;9722;0;1054205;469904;0;48.0;21.4;0.0
59;2021-06-03;15014;11845;0;1069219;481749;0;48.7;22.0;0.0
59;2021-06-04;15280;13208;0;1084499;494957;0;49.4;22.6;0.0
59;2021-06-05;14218;9106;0;1098717;504063;0;50.1;23.0;0.0
59;2021-06-06;8151;3064;0;1106868;507127;0;50.4;23.1;0.0
59;2021-06-07;10031;9144;0;1116899;516271;0;50.9;23.5;0.0
59;2021-06-08;11334;10880;0;1128233;527151;0;51.4;24.0;0.0
59;2021-06-09;10608;11587;0;1138841;538738;0;51.9;24.6;0.0
59;2021-06-10;11259;11954;0;1150100;550692;0;52.4;25.1;0.0
59;2021-06-11;10941;15568;0;1161041;566260;0;52.9;25.8;0.0
59;2021-06-12;10673;13157;0;1171714;579417;0;53.4;26.4;0.0
59;2021-06-13;5940;6676;0;1177654;586093;0;53.7;26.7;0.0
59;2021-06-14;6285;12248;0;1183939;598341;0;54.0;27.3;0.0
59;2021-06-15;8150;15558;0;1192089;613899;0;54.3;28.0;0.0
59;2021-06-16;9052;13285;0;1201141;627184;0;54.7;28.6;0.0
59;2021-06-17;9045;15279;0;1210186;642463;0;55.1;29.3;0.0
59;2021-06-18;8984;19197;0;1219170;661660;0;55.6;30.2;0.0
59;2021-06-19;8618;16434;0;1227788;678094;0;56.0;30.9;0.0
59;2021-06-20;4441;9236;0;1232229;687330;0;56.2;31.3;0.0
59;2021-06-21;5241;15161;0;1237470;702491;0;56.4;32.0;0.0
59;2021-06-22;6160;18264;0;1243630;720755;0;56.7;32.8;0.0
59;2021-06-23;5982;18575;0;1249612;739330;0;56.9;33.7;0.0
59;2021-06-24;7101;19998;0;1256713;759328;0;57.3;34.6;0.0
59;2021-06-25;6343;21023;0;1263056;780351;0;57.6;35.6;0.0
59;2021-06-26;6208;23115;0;1269264;803466;0;57.8;36.6;0.0
59;2021-06-27;4216;15859;0;1273480;819325;0;58.0;37.3;0.0
59;2021-06-28;4768;18987;0;1278248;838312;0;58.2;38.2;0.0
59;2021-06-29;5359;20048;0;1283607;858360;0;58.5;39.1;0.0
59;2021-06-30;6110;19702;0;1289717;878062;0;58.8;40.0;0.0
59;2021-07-01;7056;20295;0;1296773;898357;0;59.1;40.9;0.0
59;2021-07-02;7228;22599;0;1304001;920956;0;59.4;42.0;0.0
59;2021-07-03;5453;23758;0;1309454;944714;0;59.7;43.1;0.0
59;2021-07-04;4033;14729;0;1313487;959443;0;59.9;43.7;0.0
59;2021-07-05;5564;16544;0;1319051;975987;0;60.1;44.5;0.0
59;2021-07-06;6485;18469;0;1325536;994456;0;60.4;45.3;0.0
59;2021-07-07;6819;17169;0;1332355;1011625;0;60.7;46.1;0.0
59;2021-07-08;8067;17385;0;1340422;1029010;0;61.1;46.9;0.0
59;2021-07-09;7594;19779;0;1348016;1048789;0;61.4;47.8;0.0
59;2021-07-10;7223;17803;0;1355239;1066592;0;61.8;48.6;0.0
59;2021-07-11;4052;9288;0;1359291;1075880;0;61.9;49.0;0.0
59;2021-07-12;5777;17493;0;1365068;1093373;0;62.2;49.8;0.0
59;2021-07-13;9837;20611;0;1374905;1113984;0;62.7;50.8;0.0
59;2021-07-14;9991;8182;0;1384896;1122166;0;63.1;51.1;0.0
59;2021-07-15;11815;20248;0;1396711;1142414;0;63.6;52.1;0.0
59;2021-07-16;13251;20352;0;1409962;1162766;0;64.3;53.0;0.0
59;2021-07-17;12574;16753;0;1422536;1179519;0;64.8;53.8;0.0
59;2021-07-18;7622;8165;0;1430158;1187684;0;65.2;54.1;0.0
59;2021-07-19;10521;15953;0;1440679;1203637;0;65.7;54.8;0.0
59;2021-07-20;13559;17048;0;1454238;1220685;0;66.3;55.6;0.0
59;2021-07-21;14912;15640;0;1469150;1236325;0;66.9;56.3;0.0
59;2021-07-22;17283;15422;0;1486433;1251747;0;67.7;57.0;0.0
59;2021-07-23;16082;15968;0;1502515;1267715;0;68.5;57.8;0.0
59;2021-07-24;16081;12358;0;1518596;1280073;0;69.2;58.3;0.0
59;2021-07-25;11220;6962;0;1529816;1287035;0;69.7;58.7;0.0
59;2021-07-26;12941;12395;0;1542757;1299430;0;70.3;59.2;0.0
59;2021-07-27;16117;12071;0;1558874;1311501;0;71.0;59.8;0.0
59;2021-07-28;17446;11834;0;1576320;1323335;0;71.8;60.3;0.0
59;2021-07-29;17375;11857;0;1593695;1335192;0;72.6;60.8;0.0
59;2021-07-30;15991;11617;0;1609686;1346809;0;73.4;61.4;0.0
59;2021-07-31;13529;8920;0;1623215;1355729;0;74.0;61.8;0.0
59;2021-08-01;9291;4360;0;1632506;1360089;0;74.4;62.0;0.0
59;2021-08-02;12275;10051;0;1644781;1370140;0;75.0;62.4;0.0
59;2021-08-03;13646;10208;0;1658427;1380348;0;75.6;62.9;0.0
59;2021-08-04;11740;8805;0;1670167;1389153;0;76.1;63.3;0.0
59;2021-08-05;12945;10043;0;1683112;1399196;0;76.7;63.8;0.0
59;2021-08-06;12559;11333;0;1695671;1410529;0;77.3;64.3;0.0
59;2021-08-07;9303;8920;0;1704974;1419449;0;77.7;64.7;0.0
59;2021-08-08;6420;5063;0;1711394;1424512;0;78.0;64.9;0.0
59;2021-08-09;8334;11058;0;1719728;1435570;0;78.4;65.4;0.0
59;2021-08-10;10255;11203;0;1729983;1446773;0;78.8;65.9;0.0
59;2021-08-11;8721;9923;0;1738704;1456696;0;79.2;66.4;0.0
59;2021-08-12;9056;12500;0;1747760;1469196;0;79.6;67.0;0.0
59;2021-08-13;8400;11920;0;1756160;1481116;0;80.0;67.5;0.0
59;2021-08-14;5677;10458;0;1761837;1491574;0;80.3;68.0;0.0
59;2021-08-15;3040;4380;0;1764877;1495954;0;80.4;68.2;0.0
59;2021-08-16;5781;14043;0;1770658;1509997;0;80.7;68.8;0.0
59;2021-08-17;6983;13234;0;1777641;1523231;0;81.0;69.4;0.0
59;2021-08-18;5811;12019;0;1783452;1535250;0;81.3;70.0;0.0
59;2021-08-19;6198;13929;0;1789650;1549179;0;81.6;70.6;0.0
59;2021-08-20;5729;14597;0;1795379;1563776;0;81.8;71.3;0.0
59;2021-08-21;4080;10368;0;1799459;1574144;0;82.0;71.7;0.0
59;2021-08-22;2588;7165;0;1802047;1581309;0;82.1;72.1;0.0
59;2021-08-23;4619;15566;0;1806666;1596875;0;82.3;72.8;0.0
59;2021-08-24;5257;15308;0;1811923;1612183;0;82.6;73.5;0.0
59;2021-08-25;4543;13192;0;1816466;1625375;0;82.8;74.1;0.0
59;2021-08-26;5001;14328;0;1821467;1639703;0;83.0;74.7;0.0
59;2021-08-27;4813;15170;0;1826280;1654873;0;83.2;75.4;0.0
59;2021-08-28;3603;11891;0;1829883;1666764;0;83.4;76.0;0.0
59;2021-08-29;1760;7853;0;1831643;1674617;0;83.5;76.3;0.0
59;2021-08-30;3709;12329;273;1835352;1686946;273;83.6;76.9;0.0
59;2021-08-31;3676;12139;556;1839028;1699085;829;83.8;77.4;0.0
59;2021-09-01;3593;9551;965;1842621;1708636;1794;84.0;77.9;0.1
59;2021-09-02;3156;9807;1150;1845777;1718443;2944;84.1;78.3;0.1
59;2021-09-03;3665;10568;1287;1849442;1729011;4231;84.3;78.8;0.2
59;2021-09-04;3243;8842;593;1852685;1737853;4824;84.4;79.2;0.2
59;2021-09-05;1060;3160;202;1853745;1741013;5026;84.5;79.3;0.2
59;2021-09-06;2092;5983;1223;1855837;1746996;6249;84.6;79.6;0.3
59;2021-09-07;2188;5958;1107;1858025;1752954;7356;84.7;79.9;0.3
59;2021-09-08;2519;6461;1051;1860544;1759415;8407;84.8;80.2;0.4
59;2021-09-09;2339;5506;1071;1862883;1764921;9478;84.9;80.4;0.4
59;2021-09-10;3229;6581;1429;1866112;1771502;10907;85.0;80.7;0.5
59;2021-09-11;2456;6714;520;1868568;1778216;11427;85.2;81.0;0.5
59;2021-09-12;825;2542;147;1869393;1780758;11574;85.2;81.1;0.5
59;2021-09-13;1975;4123;1403;1871368;1784881;12977;85.3;81.3;0.6
59;2021-09-14;2295;4204;1927;1873663;1789085;14904;85.4;81.5;0.7
59;2021-09-15;2264;5265;1407;1875927;1794350;16311;85.5;81.8;0.7
59;2021-09-16;2079;4074;1985;1878006;1798424;18296;85.6;82.0;0.8
59;2021-09-17;2786;5186;1997;1880792;1803610;20293;85.7;82.2;0.9
59;2021-09-18;1672;5579;660;1882464;1809189;20953;85.8;82.4;1.0
59;2021-09-19;326;1191;146;1882790;1810380;21099;85.8;82.5;1.0
59;2021-09-20;1390;3134;1713;1884180;1813514;22812;85.9;82.6;1.0
59;2021-09-21;1272;2812;2100;1885452;1816326;24912;85.9;82.8;1.1
59;2021-09-22;1387;4636;1901;1886839;1820962;26813;86.0;83.0;1.2
59;2021-09-23;1406;2712;2188;1888245;1823674;29001;86.0;83.1;1.3
59;2021-09-24;1816;4062;2033;1890061;1827736;31034;86.1;83.3;1.4
59;2021-09-25;1143;3811;777;1891204;1831547;31811;86.2;83.5;1.4
59;2021-09-26;280;1087;146;1891484;1832634;31957;86.2;83.5;1.5
59;2021-09-27;1015;2396;1803;1892499;1835030;33760;86.2;83.6;1.5
59;2021-09-28;1042;2109;1709;1893541;1837139;35469;86.3;83.7;1.6
59;2021-09-29;1254;2881;1747;1894795;1840020;37216;86.3;83.8;1.7
59;2021-09-30;1176;2180;1938;1895971;1842200;39154;86.4;83.9;1.8
59;2021-10-01;2023;3235;2581;1897994;1845435;41735;86.5;84.1;1.9
59;2021-10-02;1449;3027;1290;1899443;1848462;43025;86.6;84.2;2.0
59;2021-10-03;230;589;173;1899673;1849051;43198;86.6;84.3;2.0
59;2021-10-04;1208;1929;2422;1900881;1850980;45620;86.6;84.3;2.1
59;2021-10-05;1118;2041;2412;1901999;1853021;48032;86.7;84.4;2.2
59;2021-10-06;1306;2359;2747;1903305;1855380;50779;86.7;84.5;2.3
59;2021-10-07;987;1791;2608;1904292;1857171;53387;86.8;84.6;2.4
59;2021-10-08;1701;3183;3407;1905993;1860354;56794;86.9;84.8;2.6
59;2021-10-09;1257;2161;1783;1907250;1862515;58577;86.9;84.9;2.7
59;2021-10-10;264;430;352;1907514;1862945;58929;86.9;84.9;2.7
59;2021-10-11;1082;1560;2956;1908596;1864505;61885;87.0;85.0;2.8
59;2021-10-12;1067;1588;3182;1909663;1866093;65067;87.0;85.0;3.0
59;2021-10-13;1210;1851;3118;1910873;1867944;68185;87.1;85.1;3.1
59;2021-10-14;975;1502;2786;1911848;1869446;70971;87.1;85.2;3.2
59;2021-10-15;1498;2455;4036;1913346;1871901;75007;87.2;85.3;3.4
59;2021-10-16;1168;1642;1945;1914514;1873543;76952;87.2;85.4;3.5
59;2021-10-17;258;325;324;1914772;1873868;77276;87.3;85.4;3.5
59;2021-10-18;988;1218;3047;1915760;1875086;80323;87.3;85.4;3.7
59;2021-10-19;914;1315;3428;1916674;1876401;83751;87.3;85.5;3.8
59;2021-10-20;1071;1479;3608;1917745;1877880;87359;87.4;85.6;4.0
59;2021-10-21;816;1351;3247;1918561;1879231;90606;87.4;85.6;4.1
59;2021-10-22;1236;1798;4315;1919797;1881029;94921;87.5;85.7;4.3
59;2021-10-23;1044;1404;2365;1920841;1882433;97286;87.5;85.8;4.4
59;2021-10-24;174;231;416;1921015;1882664;97702;87.5;85.8;4.5
59;2021-10-25;937;1175;3347;1921952;1883839;101049;87.6;85.8;4.6
59;2021-10-26;820;1081;3529;1922772;1884920;104578;87.6;85.9;4.8
59;2021-10-27;967;1347;4002;1923739;1886267;108580;87.7;86.0;4.9
59;2021-10-28;793;846;3250;1924532;1887113;111830;87.7;86.0;5.1
59;2021-10-29;1108;1469;4694;1925640;1888582;116524;87.8;86.1;5.3
59;2021-10-30;728;1274;2434;1926368;1889856;118958;87.8;86.1;5.4
59;2021-10-31;109;165;268;1926477;1890021;119226;87.8;86.1;5.4
59;2021-11-01;141;78;83;1926618;1890099;119309;87.8;86.1;5.4
59;2021-11-02;985;1418;4250;1927603;1891517;123559;87.8;86.2;5.6
59;2021-11-03;1027;1438;4799;1928630;1892955;128358;87.9;86.3;5.8
59;2021-11-04;803;943;3711;1929433;1893898;132069;87.9;86.3;6.0
59;2021-11-05;1132;1577;5318;1930565;1895475;137387;88.0;86.4;6.3
59;2021-11-06;858;1213;3099;1931423;1896688;140486;88.0;86.4;6.4
59;2021-11-07;123;226;428;1931546;1896914;140914;88.0;86.4;6.4
59;2021-11-08;692;1082;4774;1932238;1897996;145688;88.1;86.5;6.6
59;2021-11-09;829;1171;6191;1933067;1899167;151879;88.1;86.5;6.9
59;2021-11-10;1148;1477;6874;1934215;1900644;158753;88.1;86.6;7.2
59;2021-11-11;43;74;208;1934258;1900718;158961;88.1;86.6;7.2
59;2021-11-12;1096;1405;7564;1935354;1902123;166525;88.2;86.7;7.6
59;2021-11-13;896;1141;4125;1936250;1903264;170650;88.2;86.7;7.8
59;2021-11-14;120;116;442;1936370;1903380;171092;88.2;86.7;7.8
59;2021-11-15;766;1021;5925;1937136;1904401;177017;88.3;86.8;8.1
59;2021-11-16;883;1006;6828;1938019;1905407;183845;88.3;86.8;8.4
59;2021-11-17;1104;1321;6855;1939123;1906728;190700;88.4;86.9;8.7
59;2021-11-18;888;1001;6668;1940011;1907729;197368;88.4;86.9;9.0
59;2021-11-19;1356;1482;9001;1941367;1909211;206369;88.5;87.0;9.4
59;2021-11-20;1087;1216;5056;1942454;1910427;211425;88.5;87.1;9.6
59;2021-11-21;120;152;472;1942574;1910579;211897;88.5;87.1;9.7
59;2021-11-22;814;673;6178;1943388;1911252;218075;88.6;87.1;9.9
59;2021-11-23;937;899;8008;1944325;1912151;226083;88.6;87.1;10.3
59;2021-11-24;1072;1220;7497;1945397;1913371;233580;88.7;87.2;10.6
59;2021-11-25;864;904;9592;1946261;1914275;243172;88.7;87.2;11.1
59;2021-11-26;1154;1294;15331;1947415;1915569;258503;88.7;87.3;11.8
59;2021-11-27;902;1115;11732;1948317;1916684;270235;88.8;87.3;12.3
59;2021-11-28;151;212;4719;1948468;1916896;274954;88.8;87.4;12.5
59;2021-11-29;696;760;15811;1949164;1917656;290765;88.8;87.4;13.3
59;2021-11-30;889;931;20672;1950053;1918587;311437;88.9;87.4;14.2
59;2021-12-01;740;1094;20220;1950793;1919681;331657;88.9;87.5;15.1
59;2021-12-02;675;681;22064;1951468;1920362;353721;88.9;87.5;16.1
59;2021-12-03;849;1132;26580;1952317;1921494;380301;89.0;87.6;17.3
59;2021-12-04;643;1041;19497;1952960;1922535;399798;89.0;87.6;18.2
59;2021-12-05;176;238;7965;1953136;1922773;407763;89.0;87.6;18.6
59;2021-12-06;634;837;23608;1953770;1923610;431371;89.0;87.7;19.7
59;2021-12-07;689;950;27379;1954459;1924560;458750;89.1;87.7;20.9
59;2021-12-08;725;1074;25098;1955184;1925634;483848;89.1;87.8;22.0
59;2021-12-09;741;881;27807;1955925;1926515;511655;89.1;87.8;23.3
59;2021-12-10;760;1296;31554;1956685;1927811;543209;89.2;87.9;24.8
59;2021-12-11;673;1132;23028;1957358;1928943;566237;89.2;87.9;25.8
59;2021-12-12;238;221;8744;1957596;1929164;574981;89.2;87.9;26.2
59;2021-12-13;668;976;25954;1958264;1930140;600935;89.2;88.0;27.4
59;2021-12-14;803;917;30370;1959067;1931057;631305;89.3;88.0;28.8
59;2021-12-15;775;1169;27702;1959842;1932226;659007;89.3;88.1;30.0
59;2021-12-16;774;945;30681;1960616;1933171;689688;89.3;88.1;31.4
59;2021-12-17;888;1317;34434;1961504;1934488;724122;89.4;88.2;33.0
59;2021-12-18;800;1077;23529;1962304;1935565;747651;89.4;88.2;34.1
59;2021-12-19;341;270;9445;1962645;1935835;757096;89.4;88.2;34.5
60;2020-12-27;0;0;0;0;0;0;0.0;0.0;0.0
60;2020-12-28;1;0;0;1;0;0;0.0;0.0;0.0
60;2020-12-29;1;0;0;2;0;0;0.0;0.0;0.0
60;2020-12-30;2;0;0;4;0;0;0.0;0.0;0.0
60;2020-12-31;0;0;0;4;0;0;0.0;0.0;0.0
60;2021-01-01;0;0;0;4;0;0;0.0;0.0;0.0
60;2021-01-02;4;0;0;8;0;0;0.0;0.0;0.0
60;2021-01-03;1;0;0;9;0;0;0.0;0.0;0.0
60;2021-01-04;4;0;0;13;0;0;0.0;0.0;0.0
60;2021-01-05;45;1;0;58;1;0;0.0;0.0;0.0
60;2021-01-06;203;4;0;261;5;0;0.0;0.0;0.0
60;2021-01-07;238;4;0;499;9;0;0.1;0.0;0.0
60;2021-01-08;398;4;0;897;13;0;0.1;0.0;0.0
60;2021-01-09;23;0;0;920;13;0;0.1;0.0;0.0
60;2021-01-10;70;0;0;990;13;0;0.1;0.0;0.0
60;2021-01-11;394;3;0;1384;16;0;0.2;0.0;0.0
60;2021-01-12;590;6;0;1974;22;0;0.3;0.0;0.0
60;2021-01-13;576;8;0;2550;30;0;0.4;0.0;0.0
60;2021-01-14;592;11;0;3142;41;0;0.5;0.0;0.0
60;2021-01-15;744;12;0;3886;53;0;0.6;0.0;0.0
60;2021-01-16;132;1;0;4018;54;0;0.6;0.0;0.0
60;2021-01-17;41;0;0;4059;54;0;0.6;0.0;0.0
60;2021-01-18;928;14;0;4987;68;0;0.7;0.0;0.0
60;2021-01-19;1233;18;0;6220;86;0;0.9;0.0;0.0
60;2021-01-20;1760;13;0;7980;99;0;1.1;0.0;0.0
60;2021-01-21;2177;13;0;10157;112;0;1.5;0.0;0.0
60;2021-01-22;1459;22;0;11616;134;0;1.7;0.0;0.0
60;2021-01-23;469;4;0;12085;138;0;1.7;0.0;0.0
60;2021-01-24;71;1;0;12156;139;0;1.7;0.0;0.0
60;2021-01-25;914;12;0;13070;151;0;1.9;0.0;0.0
60;2021-01-26;889;16;0;13959;167;0;2.0;0.0;0.0
60;2021-01-27;657;29;0;14616;196;0;2.1;0.0;0.0
60;2021-01-28;477;171;0;15093;367;0;2.2;0.1;0.0
60;2021-01-29;160;126;0;15253;493;0;2.2;0.1;0.0
60;2021-01-30;33;9;0;15286;502;0;2.2;0.1;0.0
60;2021-01-31;24;56;0;15310;558;0;2.2;0.1;0.0
60;2021-02-01;77;140;0;15387;698;0;2.2;0.1;0.0
60;2021-02-02;46;193;0;15433;891;0;2.2;0.1;0.0
60;2021-02-03;178;295;0;15611;1186;0;2.2;0.2;0.0
60;2021-02-04;191;376;0;15802;1562;0;2.3;0.2;0.0
60;2021-02-05;314;472;0;16116;2034;0;2.3;0.3;0.0
60;2021-02-06;76;85;0;16192;2119;0;2.3;0.3;0.0
60;2021-02-07;29;46;0;16221;2165;0;2.3;0.3;0.0
60;2021-02-08;342;534;0;16563;2699;0;2.4;0.4;0.0
60;2021-02-09;356;521;0;16919;3220;0;2.4;0.5;0.0
60;2021-02-10;593;1055;0;17512;4275;0;2.5;0.6;0.0
60;2021-02-11;965;1125;0;18477;5400;0;2.7;0.8;0.0
60;2021-02-12;881;823;0;19358;6223;0;2.8;0.9;0.0
60;2021-02-13;113;260;0;19471;6483;0;2.8;0.9;0.0
60;2021-02-14;24;89;0;19495;6572;0;2.8;0.9;0.0
60;2021-02-15;633;844;0;20128;7416;0;2.9;1.1;0.0
60;2021-02-16;638;971;0;20766;8387;0;3.0;1.2;0.0
60;2021-02-17;652;942;0;21418;9329;0;3.1;1.3;0.0
60;2021-02-18;681;891;0;22099;10220;0;3.2;1.5;0.0
60;2021-02-19;655;821;0;22754;11041;0;3.3;1.6;0.0
60;2021-02-20;109;208;0;22863;11249;0;3.3;1.6;0.0
60;2021-02-21;27;119;0;22890;11368;0;3.3;1.6;0.0
60;2021-02-22;463;845;0;23353;12213;0;3.4;1.8;0.0
60;2021-02-23;573;777;0;23926;12990;0;3.4;1.9;0.0
60;2021-02-24;801;578;0;24727;13568;0;3.5;1.9;0.0
60;2021-02-25;1156;402;0;25883;13970;0;3.7;2.0;0.0
60;2021-02-26;1294;241;0;27177;14211;0;3.9;2.0;0.0
60;2021-02-27;631;56;0;27808;14267;0;4.0;2.0;0.0
60;2021-02-28;6;12;0;27814;14279;0;4.0;2.0;0.0
60;2021-03-01;849;78;0;28663;14357;0;4.1;2.1;0.0
60;2021-03-02;1001;194;0;29664;14551;0;4.3;2.1;0.0
60;2021-03-03;1353;444;0;31017;14995;0;4.5;2.2;0.0
60;2021-03-04;1824;506;0;32841;15501;0;4.7;2.2;0.0
60;2021-03-05;1984;325;0;34825;15826;0;5.0;2.3;0.0
60;2021-03-06;2171;170;0;36996;15996;0;5.3;2.3;0.0
60;2021-03-07;1113;65;0;38109;16061;0;5.5;2.3;0.0
60;2021-03-08;1167;366;0;39276;16427;0;5.6;2.4;0.0
60;2021-03-09;1933;393;0;41209;16820;0;5.9;2.4;0.0
60;2021-03-10;1974;457;0;43183;17277;0;6.2;2.5;0.0
60;2021-03-11;2430;441;0;45613;17718;0;6.5;2.5;0.0
60;2021-03-12;2749;544;0;48362;18262;0;6.9;2.6;0.0
60;2021-03-13;3737;234;0;52099;18496;0;7.5;2.7;0.0
60;2021-03-14;1655;62;0;53754;18558;0;7.7;2.7;0.0
60;2021-03-15;2133;505;0;55887;19063;0;8.0;2.7;0.0
60;2021-03-16;1534;606;0;57421;19669;0;8.2;2.8;0.0
60;2021-03-17;1648;595;0;59069;20264;0;8.5;2.9;0.0
60;2021-03-18;1668;709;0;60737;20973;0;8.7;3.0;0.0
60;2021-03-19;2576;525;0;63313;21498;0;9.1;3.1;0.0
60;2021-03-20;3116;202;0;66429;21700;0;9.5;3.1;0.0
60;2021-03-21;1964;88;0;68393;21788;0;9.8;3.1;0.0
60;2021-03-22;2155;696;0;70548;22484;0;10.1;3.2;0.0
60;2021-03-23;3212;718;0;73760;23202;0;10.6;3.3;0.0
60;2021-03-24;3083;865;0;76843;24067;0;11.0;3.5;0.0
60;2021-03-25;3881;853;0;80724;24920;0;11.6;3.6;0.0
60;2021-03-26;4319;900;0;85043;25820;0;12.2;3.7;0.0
60;2021-03-27;3980;320;0;89023;26140;0;12.8;3.8;0.0
60;2021-03-28;2277;91;0;91300;26231;0;13.1;3.8;0.0
60;2021-03-29;2690;1079;0;93990;27310;0;13.5;3.9;0.0
60;2021-03-30;3379;1091;0;97369;28401;0;14.0;4.1;0.0
60;2021-03-31;2726;1172;0;100095;29573;0;14.4;4.2;0.0
60;2021-04-01;2814;1179;0;102909;30752;0;14.8;4.4;0.0
60;2021-04-02;3289;1217;0;106198;31969;0;15.2;4.6;0.0
60;2021-04-03;3010;1011;0;109208;32980;0;15.7;4.7;0.0
60;2021-04-04;839;476;0;110047;33456;0;15.8;4.8;0.0
60;2021-04-05;521;97;0;110568;33553;0;15.9;4.8;0.0
60;2021-04-06;1955;1695;0;112523;35248;0;16.1;5.1;0.0
60;2021-04-07;2124;1751;0;114647;36999;0;16.5;5.3;0.0
60;2021-04-08;2789;1527;0;117436;38526;0;16.9;5.5;0.0
60;2021-04-09;3204;1555;0;120640;40081;0;17.3;5.8;0.0
60;2021-04-10;2878;1519;0;123518;41600;0;17.7;6.0;0.0
60;2021-04-11;962;926;0;124480;42526;0;17.9;6.1;0.0
60;2021-04-12;2155;1735;0;126635;44261;0;18.2;6.4;0.0
60;2021-04-13;2866;1793;0;129501;46054;0;18.6;6.6;0.0
60;2021-04-14;3064;1818;0;132565;47872;0;19.0;6.9;0.0
60;2021-04-15;3514;1855;0;136079;49727;0;19.5;7.1;0.0
60;2021-04-16;3295;1948;0;139374;51675;0;20.0;7.4;0.0
60;2021-04-17;2711;2061;0;142085;53736;0;20.4;7.7;0.0
60;2021-04-18;549;1708;0;142634;55444;0;20.5;8.0;0.0
60;2021-04-19;1777;2190;0;144411;57634;0;20.7;8.3;0.0
60;2021-04-20;2298;2588;0;146709;60222;0;21.1;8.6;0.0
60;2021-04-21;2645;2185;0;149354;62407;0;21.4;9.0;0.0
60;2021-04-22;2679;2511;0;152033;64918;0;21.8;9.3;0.0
60;2021-04-23;2674;2451;0;154707;67369;0;22.2;9.7;0.0
60;2021-04-24;2363;3238;0;157070;70607;0;22.5;10.1;0.0
60;2021-04-25;1237;1809;0;158307;72416;0;22.7;10.4;0.0
60;2021-04-26;1902;2532;0;160209;74948;0;23.0;10.8;0.0
60;2021-04-27;2485;2818;0;162694;77766;0;23.3;11.2;0.0
60;2021-04-28;3138;2369;0;165832;80135;0;23.8;11.5;0.0
60;2021-04-29;3397;2695;0;169229;82830;0;24.3;11.9;0.0
60;2021-04-30;3588;2806;0;172817;85636;0;24.8;12.3;0.0
60;2021-05-01;2356;1107;0;175173;86743;0;25.1;12.4;0.0
60;2021-05-02;2159;838;0;177332;87581;0;25.4;12.6;0.0
60;2021-05-03;3252;1936;0;180584;89517;0;25.9;12.8;0.0
60;2021-05-04;3369;2384;0;183953;91901;0;26.4;13.2;0.0
60;2021-05-05;3549;2758;0;187502;94659;0;26.9;13.6;0.0
60;2021-05-06;4211;2626;0;191713;97285;0;27.5;14.0;0.0
60;2021-05-07;4083;2646;0;195796;99931;0;28.1;14.3;0.0
60;2021-05-08;3537;1047;0;199333;100978;0;28.6;14.5;0.0
60;2021-05-09;3316;913;0;202649;101891;0;29.1;14.6;0.0
60;2021-05-10;2750;2372;0;205399;104263;0;29.5;15.0;0.0
60;2021-05-11;4081;2520;0;209480;106783;0;30.1;15.3;0.0
60;2021-05-12;4783;2595;0;214263;109378;0;30.7;15.7;0.0
60;2021-05-13;4755;1046;0;219018;110424;0;31.4;15.8;0.0
60;2021-05-14;5488;1794;0;224506;112218;0;32.2;16.1;0.0
60;2021-05-15;5897;1637;0;230403;113855;0;33.1;16.3;0.0
60;2021-05-16;4598;634;0;235001;114489;0;33.7;16.4;0.0
60;2021-05-17;3607;1591;0;238608;116080;0;34.2;16.7;0.0
60;2021-05-18;4181;2105;0;242789;118185;0;34.8;17.0;0.0
60;2021-05-19;4875;1892;0;247664;120077;0;35.5;17.2;0.0
60;2021-05-20;5367;1833;0;253031;121910;0;36.3;17.5;0.0
60;2021-05-21;5757;1933;0;258788;123843;0;37.1;17.8;0.0
60;2021-05-22;4880;1840;0;263668;125683;0;37.8;18.0;0.0
60;2021-05-23;3446;565;0;267114;126248;0;38.3;18.1;0.0
60;2021-05-24;2921;537;0;270035;126785;0;38.7;18.2;0.0
60;2021-05-25;4307;2055;0;274342;128840;0;39.4;18.5;0.0
60;2021-05-26;4800;1840;0;279142;130680;0;40.1;18.8;0.0
60;2021-05-27;5122;2128;0;284264;132808;0;40.8;19.1;0.0
60;2021-05-28;4873;2650;0;289137;135458;0;41.5;19.4;0.0
60;2021-05-29;4732;2254;0;293869;137712;0;42.2;19.8;0.0
60;2021-05-30;1325;369;0;295194;138081;0;42.4;19.8;0.0
60;2021-05-31;4156;2107;0;299350;140188;0;43.0;20.1;0.0
60;2021-06-01;4889;3057;0;304239;143245;0;43.7;20.6;0.0
60;2021-06-02;4468;2514;0;308707;145759;0;44.3;20.9;0.0
60;2021-06-03;4487;2619;0;313194;148378;0;44.9;21.3;0.0
60;2021-06-04;5072;3030;0;318266;151408;0;45.7;21.7;0.0
60;2021-06-05;4565;3347;0;322831;154755;0;46.3;22.2;0.0
60;2021-06-06;2276;898;0;325107;155653;0;46.6;22.3;0.0
60;2021-06-07;2988;2809;0;328095;158462;0;47.1;22.7;0.0
60;2021-06-08;4107;3258;0;332202;161720;0;47.7;23.2;0.0
60;2021-06-09;3696;3597;0;335898;165317;0;48.2;23.7;0.0
60;2021-06-10;3944;3866;0;339842;169183;0;48.8;24.3;0.0
60;2021-06-11;4214;4442;0;344056;173625;0;49.4;24.9;0.0
60;2021-06-12;4009;4196;0;348065;177821;0;49.9;25.5;0.0
60;2021-06-13;1267;2285;0;349332;180106;0;50.1;25.8;0.0
60;2021-06-14;2242;3649;0;351574;183755;0;50.4;26.4;0.0
60;2021-06-15;3297;4543;0;354871;188298;0;50.9;27.0;0.0
60;2021-06-16;3419;4727;0;358290;193025;0;51.4;27.7;0.0
60;2021-06-17;3300;5123;0;361590;198148;0;51.9;28.4;0.0
60;2021-06-18;3482;4870;0;365072;203018;0;52.4;29.1;0.0
60;2021-06-19;3397;4825;0;368469;207843;0;52.9;29.8;0.0
60;2021-06-20;1389;1917;0;369858;209760;0;53.1;30.1;0.0
60;2021-06-21;1625;4349;0;371483;214109;0;53.3;30.7;0.0
60;2021-06-22;2077;5551;0;373560;219660;0;53.6;31.5;0.0
60;2021-06-23;2188;5456;0;375748;225116;0;53.9;32.3;0.0
60;2021-06-24;2083;5744;0;377831;230860;0;54.2;33.1;0.0
60;2021-06-25;2127;6099;0;379958;236959;0;54.5;34.0;0.0
60;2021-06-26;2039;6778;0;381997;243737;0;54.8;35.0;0.0
60;2021-06-27;745;2611;0;382742;246348;0;54.9;35.3;0.0
60;2021-06-28;1839;4322;0;384581;250670;0;55.2;36.0;0.0
60;2021-06-29;2242;5706;0;386823;256376;0;55.5;36.8;0.0
60;2021-06-30;2468;5665;0;389291;262041;0;55.9;37.6;0.0
60;2021-07-01;2260;5421;0;391551;267462;0;56.2;38.4;0.0
60;2021-07-02;2642;6222;0;394193;273684;0;56.6;39.3;0.0
60;2021-07-03;2440;6027;0;396633;279711;0;56.9;40.1;0.0
60;2021-07-04;798;2681;0;397431;282392;0;57.0;40.5;0.0
60;2021-07-05;1808;4632;0;399239;287024;0;57.3;41.2;0.0
60;2021-07-06;2404;5089;0;401643;292113;0;57.6;41.9;0.0
60;2021-07-07;2520;5704;0;404163;297817;0;58.0;42.7;0.0
60;2021-07-08;3001;5381;0;407164;303198;0;58.4;43.5;0.0
60;2021-07-09;2976;6137;0;410140;309335;0;58.9;44.4;0.0
60;2021-07-10;2721;6142;0;412861;315477;0;59.2;45.3;0.0
60;2021-07-11;1214;2096;0;414075;317573;0;59.4;45.6;0.0
60;2021-07-12;1702;5316;0;415777;322889;0;59.7;46.3;0.0
60;2021-07-13;3551;5685;0;419328;328574;0;60.2;47.1;0.0
60;2021-07-14;2857;1836;0;422185;330410;0;60.6;47.4;0.0
60;2021-07-15;4327;5818;0;426512;336228;0;61.2;48.2;0.0
60;2021-07-16;4547;6131;0;431059;342359;0;61.9;49.1;0.0
60;2021-07-17;4481;5666;0;435540;348025;0;62.5;49.9;0.0
60;2021-07-18;2248;2270;0;437788;350295;0;62.8;50.3;0.0
60;2021-07-19;3372;4446;0;441160;354741;0;63.3;50.9;0.0
60;2021-07-20;5064;5536;0;446224;360277;0;64.0;51.7;0.0
60;2021-07-21;5446;5119;0;451670;365396;0;64.8;52.4;0.0
60;2021-07-22;5803;5091;0;457473;370487;0;65.6;53.2;0.0
60;2021-07-23;6081;5706;0;463554;376193;0;66.5;54.0;0.0
60;2021-07-24;4819;5140;0;468373;381333;0;67.2;54.7;0.0
60;2021-07-25;2640;1954;0;471013;383287;0;67.6;55.0;0.0
60;2021-07-26;3913;4163;0;474926;387450;0;68.1;55.6;0.0
60;2021-07-27;5449;5106;0;480375;392556;0;68.9;56.3;0.0
60;2021-07-28;5881;4376;0;486256;396932;0;69.8;57.0;0.0
60;2021-07-29;6106;4358;0;492362;401290;0;70.6;57.6;0.0
60;2021-07-30;5904;4704;0;498266;405994;0;71.5;58.3;0.0
60;2021-07-31;4546;4398;0;502812;410392;0;72.1;58.9;0.0
60;2021-08-01;1777;952;0;504589;411344;0;72.4;59.0;0.0
60;2021-08-02;3833;3105;0;508422;414449;0;73.0;59.5;0.0
60;2021-08-03;4350;3438;0;512772;417887;0;73.6;60.0;0.0
60;2021-08-04;4017;3341;0;516789;421228;0;74.2;60.4;0.0
60;2021-08-05;3712;2972;0;520501;424200;0;74.7;60.9;0.0
60;2021-08-06;4458;3819;0;524959;428019;0;75.3;61.4;0.0
60;2021-08-07;3488;3600;0;528447;431619;0;75.8;61.9;0.0
60;2021-08-08;1521;1081;0;529968;432700;0;76.0;62.1;0.0
60;2021-08-09;2484;3388;0;532452;436088;0;76.4;62.6;0.0
60;2021-08-10;3728;4274;0;536180;440362;0;76.9;63.2;0.0
60;2021-08-11;3203;4121;0;539383;444483;0;77.4;63.8;0.0
60;2021-08-12;2818;3621;0;542201;448104;0;77.8;64.3;0.0
60;2021-08-13;3007;3683;0;545208;451787;0;78.2;64.8;0.0
60;2021-08-14;2566;3041;0;547774;454828;0;78.6;65.3;0.0
60;2021-08-15;1258;631;0;549032;455459;0;78.8;65.4;0.0
60;2021-08-16;2316;4491;0;551348;459950;0;79.1;66.0;0.0
60;2021-08-17;2718;4711;0;554066;464661;0;79.5;66.7;0.0
60;2021-08-18;2215;4096;0;556281;468757;0;79.8;67.3;0.0
60;2021-08-19;1982;3861;0;558263;472618;0;80.1;67.8;0.0
60;2021-08-20;2000;4645;0;560263;477263;0;80.4;68.5;0.0
60;2021-08-21;1619;3836;0;561882;481099;0;80.6;69.0;0.0
60;2021-08-22;574;1449;0;562456;482548;0;80.7;69.2;0.0
60;2021-08-23;1269;4090;0;563725;486638;0;80.9;69.8;0.0
60;2021-08-24;1585;5315;0;565310;491953;0;81.1;70.6;0.0
60;2021-08-25;1736;4568;0;567046;496521;0;81.4;71.2;0.0
60;2021-08-26;1623;4232;1;568669;500753;1;81.6;71.9;0.0
60;2021-08-27;1580;4958;0;570249;505711;1;81.8;72.6;0.0
60;2021-08-28;1502;4761;0;571751;510472;1;82.0;73.2;0.0
60;2021-08-29;573;1982;0;572324;512454;1;82.1;73.5;0.0
60;2021-08-30;1301;3393;46;573625;515847;47;82.3;74.0;0.0
60;2021-08-31;1768;4288;62;575393;520135;109;82.6;74.6;0.0
60;2021-09-01;1529;3322;164;576922;523457;273;82.8;75.1;0.0
60;2021-09-02;1213;3050;184;578135;526507;457;83.0;75.5;0.1
60;2021-09-03;1145;3336;212;579280;529843;669;83.1;76.0;0.1
60;2021-09-04;1593;3942;155;580873;533785;824;83.3;76.6;0.1
60;2021-09-05;367;1246;37;581240;535031;861;83.4;76.8;0.1
60;2021-09-06;885;2555;238;582125;537586;1099;83.5;77.1;0.2
60;2021-09-07;901;2910;300;583026;540496;1399;83.7;77.6;0.2
60;2021-09-08;960;3042;304;583986;543538;1703;83.8;78.0;0.2
60;2021-09-09;747;2453;225;584733;545991;1928;83.9;78.3;0.3
60;2021-09-10;1123;2971;281;585856;548962;2209;84.1;78.8;0.3
60;2021-09-11;1078;3495;163;586934;552457;2372;84.2;79.3;0.3
60;2021-09-12;284;1071;59;587218;553528;2431;84.3;79.4;0.3
60;2021-09-13;651;1765;275;587869;555293;2706;84.4;79.7;0.4
60;2021-09-14;826;1620;390;588695;556913;3096;84.5;79.9;0.4
60;2021-09-15;648;1571;342;589343;558484;3438;84.6;80.1;0.5
60;2021-09-16;950;1511;586;590293;559995;4024;84.7;80.4;0.6
60;2021-09-17;795;1662;566;591088;561657;4590;84.8;80.6;0.7
60;2021-09-18;835;2727;273;591923;564384;4863;84.9;81.0;0.7
60;2021-09-19;169;488;90;592092;564872;4953;85.0;81.1;0.7
60;2021-09-20;466;1182;415;592558;566054;5368;85.0;81.2;0.8
60;2021-09-21;538;1106;618;593096;567160;5986;85.1;81.4;0.9
60;2021-09-22;487;1443;501;593583;568603;6487;85.2;81.6;0.9
60;2021-09-23;649;914;613;594232;569517;7100;85.3;81.7;1.0
60;2021-09-24;534;1349;604;594766;570866;7704;85.3;81.9;1.1
60;2021-09-25;514;2002;237;595280;572868;7941;85.4;82.2;1.1
60;2021-09-26;81;305;19;595361;573173;7960;85.4;82.2;1.1
60;2021-09-27;365;809;461;595726;573982;8421;85.5;82.4;1.2
60;2021-09-28;343;861;572;596069;574843;8993;85.5;82.5;1.3
60;2021-09-29;449;1131;366;596518;575974;9359;85.6;82.6;1.3
60;2021-09-30;400;762;658;596918;576736;10017;85.7;82.8;1.4
60;2021-10-01;640;1171;746;597558;577907;10763;85.7;82.9;1.5
60;2021-10-02;609;1508;469;598167;579415;11232;85.8;83.1;1.6
60;2021-10-03;94;294;58;598261;579709;11290;85.8;83.2;1.6
60;2021-10-04;423;720;646;598684;580429;11936;85.9;83.3;1.7
60;2021-10-05;348;597;483;599032;581026;12419;86.0;83.4;1.8
60;2021-10-06;431;827;666;599463;581853;13085;86.0;83.5;1.9
60;2021-10-07;243;587;543;599706;582440;13628;86.1;83.6;2.0
60;2021-10-08;516;901;724;600222;583341;14352;86.1;83.7;2.1
60;2021-10-09;655;1263;872;600877;584604;15224;86.2;83.9;2.2
60;2021-10-10;61;175;95;600938;584779;15319;86.2;83.9;2.2
60;2021-10-11;323;535;729;601261;585314;16048;86.3;84.0;2.3
60;2021-10-12;249;565;581;601510;585879;16629;86.3;84.1;2.4
60;2021-10-13;398;681;897;601908;586560;17526;86.4;84.2;2.5
60;2021-10-14;290;682;909;602198;587242;18435;86.4;84.3;2.6
60;2021-10-15;424;779;994;602622;588021;19429;86.5;84.4;2.8
60;2021-10-16;564;936;772;603186;588957;20201;86.6;84.5;2.9
60;2021-10-17;46;138;80;603232;589095;20281;86.6;84.5;2.9
60;2021-10-18;292;540;833;603524;589635;21114;86.6;84.6;3.0
60;2021-10-19;277;345;1000;603801;589980;22114;86.6;84.7;3.2
60;2021-10-20;377;502;1079;604178;590482;23193;86.7;84.7;3.3
60;2021-10-21;205;477;915;604383;590959;24108;86.7;84.8;3.5
60;2021-10-22;370;565;1124;604753;591524;25232;86.8;84.9;3.6
60;2021-10-23;452;724;903;605205;592248;26135;86.8;85.0;3.8
60;2021-10-24;35;64;110;605240;592312;26245;86.8;85.0;3.8
60;2021-10-25;270;390;1047;605510;592702;27292;86.9;85.0;3.9
60;2021-10-26;154;261;861;605664;592963;28153;86.9;85.1;4.0
60;2021-10-27;312;457;1207;605976;593420;29360;87.0;85.1;4.2
60;2021-10-28;203;237;986;606179;593657;30346;87.0;85.2;4.4
60;2021-10-29;317;502;1339;606496;594159;31685;87.0;85.3;4.5
60;2021-10-30;326;588;1209;606822;594747;32894;87.1;85.3;4.7
60;2021-10-31;28;69;70;606850;594816;32964;87.1;85.3;4.7
60;2021-11-01;41;25;62;606891;594841;33026;87.1;85.4;4.7
60;2021-11-02;232;308;1047;607123;595149;34073;87.1;85.4;4.9
60;2021-11-03;315;495;1530;607438;595644;35603;87.2;85.5;5.1
60;2021-11-04;249;344;1218;607687;595988;36821;87.2;85.5;5.3
60;2021-11-05;328;415;1663;608015;596403;38484;87.2;85.6;5.5
60;2021-11-06;344;581;1125;608359;596984;39609;87.3;85.7;5.7
60;2021-11-07;26;45;122;608385;597029;39731;87.3;85.7;5.7
60;2021-11-08;190;329;1410;608575;597358;41141;87.3;85.7;5.9
60;2021-11-09;193;282;1550;608768;597640;42691;87.4;85.8;6.1
60;2021-11-10;333;451;2008;609101;598091;44699;87.4;85.8;6.4
60;2021-11-11;65;73;272;609166;598164;44971;87.4;85.8;6.5
60;2021-11-12;303;433;2131;609469;598597;47102;87.5;85.9;6.8
60;2021-11-13;387;543;1600;609856;599140;48702;87.5;86.0;7.0
60;2021-11-14;27;46;190;609883;599186;48892;87.5;86.0;7.0
60;2021-11-15;204;279;1593;610087;599465;50485;87.5;86.0;7.2
60;2021-11-16;259;248;2009;610346;599713;52494;87.6;86.1;7.5
60;2021-11-17;288;333;2038;610634;600046;54532;87.6;86.1;7.8
60;2021-11-18;234;278;1914;610868;600324;56446;87.7;86.1;8.1
60;2021-11-19;307;379;2399;611175;600703;58845;87.7;86.2;8.4
60;2021-11-20;399;496;1628;611574;601199;60473;87.8;86.3;8.7
60;2021-11-21;34;56;218;611608;601255;60691;87.8;86.3;8.7
60;2021-11-22;209;198;2059;611817;601453;62750;87.8;86.3;9.0
60;2021-11-23;201;240;2453;612018;601693;65203;87.8;86.3;9.4
60;2021-11-24;328;326;2609;612346;602019;67812;87.9;86.4;9.7
60;2021-11-25;264;223;2646;612610;602242;70458;87.9;86.4;10.1
60;2021-11-26;346;415;4435;612956;602657;74893;88.0;86.5;10.7
60;2021-11-27;371;434;4014;613327;603091;78907;88.0;86.5;11.3
60;2021-11-28;50;59;875;613377;603150;79782;88.0;86.5;11.4
60;2021-11-29;170;253;4173;613547;603403;83955;88.0;86.6;12.0
60;2021-11-30;183;249;5179;613730;603652;89134;88.1;86.6;12.8
60;2021-12-01;247;301;5808;613977;603953;94942;88.1;86.7;13.6
60;2021-12-02;239;223;6204;614216;604176;101146;88.1;86.7;14.5
60;2021-12-03;213;293;7000;614429;604469;108146;88.2;86.7;15.5
60;2021-12-04;251;430;5771;614680;604899;113917;88.2;86.8;16.3
60;2021-12-05;51;69;1677;614731;604968;115594;88.2;86.8;16.6
60;2021-12-06;182;230;5688;614913;605198;121282;88.2;86.8;17.4
60;2021-12-07;199;237;7729;615112;605435;129011;88.3;86.9;18.5
60;2021-12-08;248;310;6951;615360;605745;135962;88.3;86.9;19.5
60;2021-12-09;247;300;7370;615607;606045;143332;88.3;87.0;20.6
60;2021-12-10;265;367;8864;615872;606412;152196;88.4;87.0;21.8
60;2021-12-11;298;441;7229;616170;606853;159425;88.4;87.1;22.9
60;2021-12-12;66;76;1741;616236;606929;161166;88.4;87.1;23.1
60;2021-12-13;188;257;7234;616424;607186;168400;88.4;87.1;24.2
60;2021-12-14;264;296;9470;616688;607482;177870;88.5;87.2;25.5
60;2021-12-15;240;373;8565;616928;607855;186435;88.5;87.2;26.8
60;2021-12-16;234;304;9051;617162;608159;195486;88.6;87.3;28.0
60;2021-12-17;240;391;9416;617402;608550;204902;88.6;87.3;29.4
60;2021-12-18;302;402;7976;617704;608952;212878;88.6;87.4;30.5
60;2021-12-19;101;68;2086;617805;609020;214964;88.6;87.4;30.8
61;2020-12-27;0;0;0;0;0;0;0.0;0.0;0.0
61;2020-12-28;0;0;0;0;0;0;0.0;0.0;0.0
61;2020-12-29;0;0;0;0;0;0;0.0;0.0;0.0
61;2020-12-30;0;0;0;0;0;0;0.0;0.0;0.0
61;2020-12-31;0;0;0;0;0;0;0.0;0.0;0.0
61;2021-01-01;2;0;0;2;0;0;0.0;0.0;0.0
61;2021-01-02;0;0;0;2;0;0;0.0;0.0;0.0
61;2021-01-03;0;0;0;2;0;0;0.0;0.0;0.0
61;2021-01-04;1;0;0;3;0;0;0.0;0.0;0.0
61;2021-01-05;2;0;0;5;0;0;0.0;0.0;0.0
61;2021-01-06;72;0;0;77;0;0;0.0;0.0;0.0
61;2021-01-07;139;2;0;216;2;0;0.1;0.0;0.0
61;2021-01-08;342;1;0;558;3;0;0.2;0.0;0.0
61;2021-01-09;138;1;0;696;4;0;0.3;0.0;0.0
61;2021-01-10;31;0;0;727;4;0;0.3;0.0;0.0
61;2021-01-11;356;0;0;1083;4;0;0.4;0.0;0.0
61;2021-01-12;537;3;0;1620;7;0;0.7;0.0;0.0
61;2021-01-13;638;1;0;2258;8;0;0.9;0.0;0.0
61;2021-01-14;489;8;0;2747;16;0;1.1;0.0;0.0
61;2021-01-15;498;2;0;3245;18;0;1.3;0.0;0.0
61;2021-01-16;261;1;0;3506;19;0;1.4;0.0;0.0
61;2021-01-17;777;9;0;4283;28;0;1.8;0.0;0.0
61;2021-01-18;1673;3;0;5956;31;0;2.5;0.0;0.0
61;2021-01-19;1106;3;0;7062;34;0;2.9;0.0;0.0
61;2021-01-20;610;0;0;7672;34;0;3.2;0.0;0.0
61;2021-01-21;718;0;0;8390;34;0;3.5;0.0;0.0
61;2021-01-22;647;0;0;9037;34;0;3.7;0.0;0.0
61;2021-01-23;220;1;0;9257;35;0;3.8;0.0;0.0
61;2021-01-24;197;2;0;9454;37;0;3.9;0.0;0.0
61;2021-01-25;468;1;0;9922;38;0;4.1;0.0;0.0
61;2021-01-26;425;4;0;10347;42;0;4.3;0.0;0.0
61;2021-01-27;443;11;0;10790;53;0;4.4;0.0;0.0
61;2021-01-28;429;47;0;11219;100;0;4.6;0.0;0.0
61;2021-01-29;428;173;0;11647;273;0;4.8;0.1;0.0
61;2021-01-30;164;1;0;11811;274;0;4.9;0.1;0.0
61;2021-01-31;93;0;0;11904;274;0;4.9;0.1;0.0
61;2021-02-01;344;162;0;12248;436;0;5.0;0.2;0.0
61;2021-02-02;360;382;0;12608;818;0;5.2;0.3;0.0
61;2021-02-03;354;438;0;12962;1256;0;5.3;0.5;0.0
61;2021-02-04;309;306;0;13271;1562;0;5.5;0.6;0.0
61;2021-02-05;427;338;0;13698;1900;0;5.6;0.8;0.0
61;2021-02-06;153;75;0;13851;1975;0;5.7;0.8;0.0
61;2021-02-07;32;174;0;13883;2149;0;5.7;0.9;0.0
61;2021-02-08;479;1281;0;14362;3430;0;5.9;1.4;0.0
61;2021-02-09;347;702;0;14709;4132;0;6.1;1.7;0.0
61;2021-02-10;234;514;0;14943;4646;0;6.2;1.9;0.0
61;2021-02-11;346;518;0;15289;5164;0;6.3;2.1;0.0
61;2021-02-12;338;664;0;15627;5828;0;6.4;2.4;0.0
61;2021-02-13;130;372;0;15757;6200;0;6.5;2.6;0.0
61;2021-02-14;2;278;0;15759;6478;0;6.5;2.7;0.0
61;2021-02-15;113;672;0;15872;7150;0;6.5;2.9;0.0
61;2021-02-16;166;565;0;16038;7715;0;6.6;3.2;0.0
61;2021-02-17;59;503;0;16097;8218;0;6.6;3.4;0.0
61;2021-02-18;122;459;0;16219;8677;0;6.7;3.6;0.0
61;2021-02-19;100;340;0;16319;9017;0;6.7;3.7;0.0
61;2021-02-20;42;188;0;16361;9205;0;6.7;3.8;0.0
61;2021-02-21;1;139;0;16362;9344;0;6.7;3.8;0.0
61;2021-02-22;72;506;0;16434;9850;0;6.8;4.1;0.0
61;2021-02-23;98;396;0;16532;10246;0;6.8;4.2;0.0
61;2021-02-24;123;432;0;16655;10678;0;6.9;4.4;0.0
61;2021-02-25;286;375;0;16941;11053;0;7.0;4.5;0.0
61;2021-02-26;287;388;0;17228;11441;0;7.1;4.7;0.0
61;2021-02-27;114;171;0;17342;11612;0;7.1;4.8;0.0
61;2021-02-28;4;100;0;17346;11712;0;7.1;4.8;0.0
61;2021-03-01;215;520;0;17561;12232;0;7.2;5.0;0.0
61;2021-03-02;170;593;0;17731;12825;0;7.3;5.3;0.0
61;2021-03-03;167;363;0;17898;13188;0;7.4;5.4;0.0
61;2021-03-04;460;376;0;18358;13564;0;7.6;5.6;0.0
61;2021-03-05;670;288;0;19028;13852;0;7.8;5.7;0.0
61;2021-03-06;437;173;0;19465;14025;0;8.0;5.8;0.0
61;2021-03-07;169;4;0;19634;14029;0;8.1;5.8;0.0
61;2021-03-08;334;276;0;19968;14305;0;8.2;5.9;0.0
61;2021-03-09;606;164;0;20574;14469;0;8.5;6.0;0.0
61;2021-03-10;657;181;0;21231;14650;0;8.7;6.0;0.0
61;2021-03-11;1064;130;0;22295;14780;0;9.2;6.1;0.0
61;2021-03-12;1387;101;0;23682;14881;0;9.7;6.1;0.0
61;2021-03-13;737;47;0;24419;14928;0;10.1;6.1;0.0
61;2021-03-14;177;6;0;24596;14934;0;10.1;6.1;0.0
61;2021-03-15;716;38;0;25312;14972;0;10.4;6.2;0.0
61;2021-03-16;664;27;0;25976;14999;0;10.7;6.2;0.0
61;2021-03-17;678;23;0;26654;15022;0;11.0;6.2;0.0
61;2021-03-18;814;35;0;27468;15057;0;11.3;6.2;0.0
61;2021-03-19;997;67;0;28465;15124;0;11.7;6.2;0.0
61;2021-03-20;487;18;0;28952;15142;0;11.9;6.2;0.0
61;2021-03-21;62;3;0;29014;15145;0;11.9;6.2;0.0
61;2021-03-22;731;99;0;29745;15244;0;12.2;6.3;0.0
61;2021-03-23;844;49;0;30589;15293;0;12.6;6.3;0.0
61;2021-03-24;1306;77;0;31895;15370;0;13.1;6.3;0.0
61;2021-03-25;1799;80;0;33694;15450;0;13.9;6.4;0.0
61;2021-03-26;1686;58;0;35380;15508;0;14.6;6.4;0.0
61;2021-03-27;937;18;0;36317;15526;0;14.9;6.4;0.0
61;2021-03-28;298;9;0;36615;15535;0;15.1;6.4;0.0
61;2021-03-29;1085;196;0;37700;15731;0;15.5;6.5;0.0
61;2021-03-30;1339;125;0;39039;15856;0;16.1;6.5;0.0
61;2021-03-31;1511;71;0;40550;15927;0;16.7;6.6;0.0
61;2021-04-01;1903;236;0;42453;16163;0;17.5;6.7;0.0
61;2021-04-02;1435;408;0;43888;16571;0;18.1;6.8;0.0
61;2021-04-03;568;277;0;44456;16848;0;18.3;6.9;0.0
61;2021-04-04;167;18;0;44623;16866;0;18.4;6.9;0.0
61;2021-04-05;444;12;0;45067;16878;0;18.6;6.9;0.0
61;2021-04-06;1246;544;0;46313;17422;0;19.1;7.2;0.0
61;2021-04-07;1553;596;0;47866;18018;0;19.7;7.4;0.0
61;2021-04-08;2068;713;0;49934;18731;0;20.6;7.7;0.0
61;2021-04-09;2063;760;0;51997;19491;0;21.4;8.0;0.0
61;2021-04-10;1286;429;0;53283;19920;0;21.9;8.2;0.0
61;2021-04-11;209;147;0;53492;20067;0;22.0;8.3;0.0
61;2021-04-12;1154;632;0;54646;20699;0;22.5;8.5;0.0
61;2021-04-13;1591;627;0;56237;21326;0;23.1;8.8;0.0
61;2021-04-14;1626;779;0;57863;22105;0;23.8;9.1;0.0
61;2021-04-15;2073;764;0;59936;22869;0;24.7;9.4;0.0
61;2021-04-16;1984;647;0;61920;23516;0;25.5;9.7;0.0
61;2021-04-17;1210;288;0;63130;23804;0;26.0;9.8;0.0
61;2021-04-18;428;82;0;63558;23886;0;26.2;9.8;0.0
61;2021-04-19;801;695;0;64359;24581;0;26.5;10.1;0.0
61;2021-04-20;1391;712;0;65750;25293;0;27.1;10.4;0.0
61;2021-04-21;1264;978;0;67014;26271;0;27.6;10.8;0.0
61;2021-04-22;1168;1124;0;68182;27395;0;28.1;11.3;0.0
61;2021-04-23;1150;1031;0;69332;28426;0;28.5;11.7;0.0
61;2021-04-24;1155;700;0;70487;29126;0;29.0;12.0;0.0
61;2021-04-25;273;267;0;70760;29393;0;29.1;12.1;0.0
61;2021-04-26;667;948;0;71427;30341;0;29.4;12.5;0.0
61;2021-04-27;1394;1035;0;72821;31376;0;30.0;12.9;0.0
61;2021-04-28;1251;1258;0;74072;32634;0;30.5;13.4;0.0
61;2021-04-29;1217;1658;0;75289;34292;0;31.0;14.1;0.0
61;2021-04-30;1619;1057;0;76908;35349;0;31.7;14.6;0.0
61;2021-05-01;665;298;0;77573;35647;0;31.9;14.7;0.0
61;2021-05-02;336;197;0;77909;35844;0;32.1;14.8;0.0
61;2021-05-03;832;1103;0;78741;36947;0;32.4;15.2;0.0
61;2021-05-04;1268;1599;0;80009;38546;0;32.9;15.9;0.0
61;2021-05-05;998;1868;0;81007;40414;0;33.3;16.6;0.0
61;2021-05-06;1655;1896;0;82662;42310;0;34.0;17.4;0.0
61;2021-05-07;1370;1755;0;84032;44065;0;34.6;18.1;0.0
61;2021-05-08;810;370;0;84842;44435;0;34.9;18.3;0.0
61;2021-05-09;302;234;0;85144;44669;0;35.0;18.4;0.0
61;2021-05-10;1003;1515;0;86147;46184;0;35.5;19.0;0.0
61;2021-05-11;1467;1347;0;87614;47531;0;36.1;19.6;0.0
61;2021-05-12;1605;1426;0;89219;48957;0;36.7;20.2;0.0
61;2021-05-13;874;417;0;90093;49374;0;37.1;20.3;0.0
61;2021-05-14;1612;1041;0;91705;50415;0;37.7;20.8;0.0
61;2021-05-15;1925;925;0;93630;51340;0;38.5;21.1;0.0
61;2021-05-16;843;244;0;94473;51584;0;38.9;21.2;0.0
61;2021-05-17;1298;793;0;95771;52377;0;39.4;21.6;0.0
61;2021-05-18;2319;880;0;98090;53257;0;40.4;21.9;0.0
61;2021-05-19;2148;752;0;100238;54009;0;41.3;22.2;0.0
61;2021-05-20;2059;832;0;102297;54841;0;42.1;22.6;0.0
61;2021-05-21;2187;883;0;104484;55724;0;43.0;22.9;0.0
61;2021-05-22;1367;578;0;105851;56302;0;43.6;23.2;0.0
61;2021-05-23;479;41;0;106330;56343;0;43.8;23.2;0.0
61;2021-05-24;797;138;0;107127;56481;0;44.1;23.2;0.0
61;2021-05-25;1851;864;0;108978;57345;0;44.9;23.6;0.0
61;2021-05-26;1834;892;0;110812;58237;0;45.6;24.0;0.0
61;2021-05-27;2046;1070;0;112858;59307;0;46.5;24.4;0.0
61;2021-05-28;2028;1319;0;114886;60626;0;47.3;25.0;0.0
61;2021-05-29;1263;520;0;116149;61146;0;47.8;25.2;0.0
61;2021-05-30;381;44;0;116530;61190;0;48.0;25.2;0.0
61;2021-05-31;1510;850;0;118040;62040;0;48.6;25.5;0.0
61;2021-06-01;1917;1308;0;119957;63348;0;49.4;26.1;0.0
61;2021-06-02;1638;1049;0;121595;64397;0;50.1;26.5;0.0
61;2021-06-03;2234;1068;0;123829;65465;0;51.0;26.9;0.0
61;2021-06-04;1852;1315;0;125681;66780;0;51.7;27.5;0.0
61;2021-06-05;1395;1105;0;127076;67885;0;52.3;27.9;0.0
61;2021-06-06;296;162;0;127372;68047;0;52.4;28.0;0.0
61;2021-06-07;2051;860;0;129423;68907;0;53.3;28.4;0.0
61;2021-06-08;1795;1537;0;131218;70444;0;54.0;29.0;0.0
61;2021-06-09;1904;1103;0;133122;71547;0;54.8;29.5;0.0
61;2021-06-10;1888;1153;0;135010;72700;0;55.6;29.9;0.0
61;2021-06-11;1735;1521;0;136745;74221;0;56.3;30.6;0.0
61;2021-06-12;1222;876;0;137967;75097;0;56.8;30.9;0.0
61;2021-06-13;289;328;0;138256;75425;0;56.9;31.0;0.0
61;2021-06-14;1063;1176;0;139319;76601;0;57.3;31.5;0.0
61;2021-06-15;1164;1639;0;140483;78240;0;57.8;32.2;0.0
61;2021-06-16;1104;1351;0;141587;79591;0;58.3;32.8;0.0
61;2021-06-17;1085;1713;0;142672;81304;0;58.7;33.5;0.0
61;2021-06-18;1450;1661;0;144122;82965;0;59.3;34.2;0.0
61;2021-06-19;1040;1137;0;145162;84102;0;59.8;34.6;0.0
61;2021-06-20;239;277;0;145401;84379;0;59.9;34.7;0.0
61;2021-06-21;721;1564;0;146122;85943;0;60.1;35.4;0.0
61;2021-06-22;986;1708;0;147108;87651;0;60.6;36.1;0.0
61;2021-06-23;977;2299;0;148085;89950;0;61.0;37.0;0.0
61;2021-06-24;698;1329;0;148783;91279;0;61.2;37.6;0.0
61;2021-06-25;798;1915;0;149581;93194;0;61.6;38.4;0.0
61;2021-06-26;586;1634;0;150167;94828;0;61.8;39.0;0.0
61;2021-06-27;136;671;0;150303;95499;0;61.9;39.3;0.0
61;2021-06-28;452;2098;0;150755;97597;0;62.1;40.2;0.0
61;2021-06-29;723;2767;0;151478;100364;0;62.4;41.3;0.0
61;2021-06-30;799;2345;0;152277;102709;0;62.7;42.3;0.0
61;2021-07-01;690;1707;0;152967;104416;0;63.0;43.0;0.0
61;2021-07-02;879;2557;0;153846;106973;0;63.3;44.0;0.0
61;2021-07-03;392;1525;0;154238;108498;0;63.5;44.7;0.0
61;2021-07-04;74;477;0;154312;108975;0;63.5;44.9;0.0
61;2021-07-05;673;1616;0;154985;110591;0;63.8;45.5;0.0
61;2021-07-06;870;2666;0;155855;113257;0;64.2;46.6;0.0
61;2021-07-07;842;2258;0;156697;115515;0;64.5;47.5;0.0
61;2021-07-08;828;1911;0;157525;117426;0;64.8;48.3;0.0
61;2021-07-09;738;2308;0;158263;119734;0;65.1;49.3;0.0
61;2021-07-10;398;1559;0;158661;121293;0;65.3;49.9;0.0
61;2021-07-11;203;416;0;158864;121709;0;65.4;50.1;0.0
61;2021-07-12;460;2291;0;159324;124000;0;65.6;51.0;0.0
61;2021-07-13;722;2512;0;160046;126512;0;65.9;52.1;0.0
61;2021-07-14;263;426;0;160309;126938;0;66.0;52.3;0.0
61;2021-07-15;835;2734;0;161144;129672;0;66.3;53.4;0.0
61;2021-07-16;1000;2514;0;162144;132186;0;66.7;54.4;0.0
61;2021-07-17;705;1912;0;162849;134098;0;67.0;55.2;0.0
61;2021-07-18;235;304;0;163084;134402;0;67.1;55.3;0.0
61;2021-07-19;962;2357;0;164046;136759;0;67.5;56.3;0.0
61;2021-07-20;1313;2418;0;165359;139177;0;68.1;57.3;0.0
61;2021-07-21;1453;2121;0;166812;141298;0;68.7;58.2;0.0
61;2021-07-22;1793;2117;0;168605;143415;0;69.4;59.0;0.0
61;2021-07-23;1717;2252;0;170322;145667;0;70.1;60.0;0.0
61;2021-07-24;1227;1716;0;171549;147383;0;70.6;60.7;0.0
61;2021-07-25;263;349;0;171812;147732;0;70.7;60.8;0.0
61;2021-07-26;1258;1838;0;173070;149570;0;71.2;61.6;0.0
61;2021-07-27;2323;1449;0;175393;151019;0;72.2;62.2;0.0
61;2021-07-28;2202;1386;1;177595;152405;1;73.1;62.7;0.0
61;2021-07-29;2396;1467;0;179991;153872;1;74.1;63.3;0.0
61;2021-07-30;2296;1328;0;182287;155200;1;75.0;63.9;0.0
61;2021-07-31;1051;1067;0;183338;156267;1;75.5;64.3;0.0
61;2021-08-01;361;217;0;183699;156484;1;75.6;64.4;0.0
61;2021-08-02;1725;1085;0;185424;157569;1;76.3;64.9;0.0
61;2021-08-03;2020;964;0;187444;158533;1;77.2;65.3;0.0
61;2021-08-04;1984;747;0;189428;159280;1;78.0;65.6;0.0
61;2021-08-05;1591;905;0;191019;160185;1;78.6;65.9;0.0
61;2021-08-06;1847;1095;0;192866;161280;1;79.4;66.4;0.0
61;2021-08-07;1112;674;0;193978;161954;1;79.8;66.7;0.0
61;2021-08-08;328;170;0;194306;162124;1;80.0;66.7;0.0
61;2021-08-09;1108;936;0;195414;163060;1;80.4;67.1;0.0
61;2021-08-10;1315;1141;0;196729;164201;1;81.0;67.6;0.0
61;2021-08-11;1031;1086;0;197760;165287;1;81.4;68.0;0.0
61;2021-08-12;1022;1228;0;198782;166515;1;81.8;68.5;0.0
61;2021-08-13;867;1399;0;199649;167914;1;82.2;69.1;0.0
61;2021-08-14;635;739;0;200284;168653;1;82.4;69.4;0.0
61;2021-08-15;90;177;0;200374;168830;1;82.5;69.5;0.0
61;2021-08-16;833;1498;0;201207;170328;1;82.8;70.1;0.0
61;2021-08-17;1005;1636;0;202212;171964;1;83.2;70.8;0.0
61;2021-08-18;821;1426;0;203033;173390;1;83.6;71.4;0.0
61;2021-08-19;709;1480;0;203742;174870;1;83.9;72.0;0.0
61;2021-08-20;759;2004;0;204501;176874;1;84.2;72.8;0.0
61;2021-08-21;433;1100;0;204934;177974;1;84.4;73.3;0.0
61;2021-08-22;104;333;0;205038;178307;1;84.4;73.4;0.0
61;2021-08-23;435;1604;0;205473;179911;1;84.6;74.1;0.0
61;2021-08-24;560;1776;0;206033;181687;1;84.8;74.8;0.0
61;2021-08-25;487;1675;0;206520;183362;1;85.0;75.5;0.0
61;2021-08-26;440;1603;0;206960;184965;1;85.2;76.1;0.0
61;2021-08-27;493;1805;0;207453;186770;1;85.4;76.9;0.0
61;2021-08-28;257;1174;0;207710;187944;1;85.5;77.4;0.0
61;2021-08-29;49;328;0;207759;188272;1;85.5;77.5;0.0
61;2021-08-30;399;1560;10;208158;189832;11;85.7;78.1;0.0
61;2021-08-31;548;1677;44;208706;191509;55;85.9;78.8;0.0
61;2021-09-01;472;1264;181;209178;192773;236;86.1;79.4;0.1
61;2021-09-02;424;1063;247;209602;193836;483;86.3;79.8;0.2
61;2021-09-03;473;1256;272;210075;195092;755;86.5;80.3;0.3
61;2021-09-04;302;1087;77;210377;196179;832;86.6;80.8;0.3
61;2021-09-05;71;156;41;210448;196335;873;86.6;80.8;0.4
61;2021-09-06;266;946;253;210714;197281;1126;86.7;81.2;0.5
61;2021-09-07;315;1250;169;211029;198531;1295;86.9;81.7;0.5
61;2021-09-08;284;1109;217;211313;199640;1512;87.0;82.2;0.6
61;2021-09-09;269;827;365;211582;200467;1877;87.1;82.5;0.8
61;2021-09-10;327;881;270;211909;201348;2147;87.2;82.9;0.9
61;2021-09-11;242;902;78;212151;202250;2225;87.3;83.3;0.9
61;2021-09-12;36;107;20;212187;202357;2245;87.3;83.3;0.9
61;2021-09-13;205;552;457;212392;202909;2702;87.4;83.5;1.1
61;2021-09-14;203;416;435;212595;203325;3137;87.5;83.7;1.3
61;2021-09-15;237;660;465;212832;203985;3602;87.6;84.0;1.5
61;2021-09-16;220;356;192;213052;204341;3794;87.7;84.1;1.6
61;2021-09-17;244;576;249;213296;204917;4043;87.8;84.3;1.7
61;2021-09-18;184;526;129;213480;205443;4172;87.9;84.6;1.7
61;2021-09-19;3;11;1;213483;205454;4173;87.9;84.6;1.7
61;2021-09-20;166;307;248;213649;205761;4421;87.9;84.7;1.8
61;2021-09-21;244;240;226;213893;206001;4647;88.0;84.8;1.9
61;2021-09-22;158;660;361;214051;206661;5008;88.1;85.1;2.1
61;2021-09-23;152;272;226;214203;206933;5234;88.2;85.2;2.2
61;2021-09-24;151;399;371;214354;207332;5605;88.2;85.3;2.3
61;2021-09-25;147;495;168;214501;207827;5773;88.3;85.5;2.4
61;2021-09-26;8;17;4;214509;207844;5777;88.3;85.6;2.4
61;2021-09-27;129;295;403;214638;208139;6180;88.4;85.7;2.5
61;2021-09-28;97;243;161;214735;208382;6341;88.4;85.8;2.6
61;2021-09-29;114;256;228;214849;208638;6569;88.4;85.9;2.7
61;2021-09-30;181;265;210;215030;208903;6779;88.5;86.0;2.8
61;2021-10-01;117;274;237;215147;209177;7016;88.6;86.1;2.9
61;2021-10-02;209;514;261;215356;209691;7277;88.6;86.3;3.0
61;2021-10-03;2;11;2;215358;209702;7279;88.6;86.3;3.0
61;2021-10-04;104;249;443;215462;209951;7722;88.7;86.4;3.2
61;2021-10-05;107;254;402;215569;210205;8124;88.7;86.5;3.3
61;2021-10-06;156;303;384;215725;210508;8508;88.8;86.7;3.5
61;2021-10-07;151;243;517;215876;210751;9025;88.9;86.8;3.7
61;2021-10-08;164;266;441;216040;211017;9466;88.9;86.9;3.9
61;2021-10-09;71;141;105;216111;211158;9571;89.0;86.9;3.9
61;2021-10-10;3;5;3;216114;211163;9574;89.0;86.9;3.9
61;2021-10-11;132;326;585;216246;211489;10159;89.0;87.1;4.2
61;2021-10-12;76;204;229;216322;211693;10388;89.0;87.1;4.3
61;2021-10-13;125;219;430;216447;211912;10818;89.1;87.2;4.5
61;2021-10-14;69;195;341;216516;212107;11159;89.1;87.3;4.6
61;2021-10-15;165;244;441;216681;212351;11600;89.2;87.4;4.8
61;2021-10-16;67;96;142;216748;212447;11742;89.2;87.4;4.8
61;2021-10-17;8;9;13;216756;212456;11755;89.2;87.5;4.8
61;2021-10-18;71;163;306;216827;212619;12061;89.3;87.5;5.0
61;2021-10-19;65;126;258;216892;212745;12319;89.3;87.6;5.1
61;2021-10-20;72;135;348;216964;212880;12667;89.3;87.6;5.2
61;2021-10-21;104;159;449;217068;213039;13116;89.4;87.7;5.4
61;2021-10-22;119;177;497;217187;213216;13613;89.4;87.8;5.6
61;2021-10-23;91;244;310;217278;213460;13923;89.4;87.9;5.7
61;2021-10-24;1;3;0;217279;213463;13923;89.4;87.9;5.7
61;2021-10-25;88;132;435;217367;213595;14358;89.5;87.9;5.9
61;2021-10-26;55;79;235;217422;213674;14593;89.5;88.0;6.0
61;2021-10-27;77;126;631;217499;213800;15224;89.5;88.0;6.3
61;2021-10-28;67;108;461;217566;213908;15685;89.6;88.1;6.5
61;2021-10-29;126;161;677;217692;214069;16362;89.6;88.1;6.7
61;2021-10-30;29;84;207;217721;214153;16569;89.6;88.2;6.8
61;2021-10-31;5;5;1;217726;214158;16570;89.6;88.2;6.8
61;2021-11-01;5;1;4;217731;214159;16574;89.6;88.2;6.8
61;2021-11-02;60;107;502;217791;214266;17076;89.6;88.2;7.0
61;2021-11-03;69;148;621;217860;214414;17697;89.7;88.3;7.3
61;2021-11-04;66;92;631;217926;214506;18328;89.7;88.3;7.5
61;2021-11-05;116;155;873;218042;214661;19201;89.8;88.4;7.9
61;2021-11-06;64;76;348;218106;214737;19549;89.8;88.4;8.0
61;2021-11-07;2;11;24;218108;214748;19573;89.8;88.4;8.1
61;2021-11-08;59;105;849;218167;214853;20422;89.8;88.4;8.4
61;2021-11-09;45;86;608;218212;214939;21030;89.8;88.5;8.7
61;2021-11-10;88;117;979;218300;215056;22009;89.9;88.5;9.1
61;2021-11-11;5;3;33;218305;215059;22042;89.9;88.5;9.1
61;2021-11-12;83;160;1023;218388;215219;23065;89.9;88.6;9.5
61;2021-11-13;51;53;218;218439;215272;23283;89.9;88.6;9.6
61;2021-11-14;0;7;8;218439;215279;23291;89.9;88.6;9.6
61;2021-11-15;56;83;987;218495;215362;24278;89.9;88.6;10.0
61;2021-11-16;79;59;961;218574;215421;25239;90.0;88.7;10.4
61;2021-11-17;90;106;1062;218664;215527;26301;90.0;88.7;10.8
61;2021-11-18;97;113;1277;218761;215640;27578;90.0;88.8;11.4
61;2021-11-19;111;153;1437;218872;215793;29015;90.1;88.8;11.9
61;2021-11-20;75;69;500;218947;215862;29515;90.1;88.9;12.1
61;2021-11-21;4;5;20;218951;215867;29535;90.1;88.9;12.2
61;2021-11-22;69;42;936;219020;215909;30471;90.2;88.9;12.5
61;2021-11-23;127;69;1387;219147;215978;31858;90.2;88.9;13.1
61;2021-11-24;142;103;1343;219289;216081;33201;90.3;88.9;13.7
61;2021-11-25;117;72;1471;219406;216153;34672;90.3;89.0;14.3
61;2021-11-26;88;129;2018;219494;216282;36690;90.3;89.0;15.1
61;2021-11-27;79;59;1107;219573;216341;37797;90.4;89.1;15.6
61;2021-11-28;4;7;42;219577;216348;37839;90.4;89.1;15.6
61;2021-11-29;59;62;1718;219636;216410;39557;90.4;89.1;16.3
61;2021-11-30;124;78;2298;219760;216488;41855;90.5;89.1;17.2
61;2021-12-01;69;93;2358;219829;216581;44213;90.5;89.2;18.2
61;2021-12-02;86;50;2997;219915;216631;47210;90.5;89.2;19.4
61;2021-12-03;95;110;2858;220010;216741;50068;90.6;89.2;20.6
61;2021-12-04;61;64;1390;220071;216805;51458;90.6;89.2;21.2
61;2021-12-05;10;4;359;220081;216809;51817;90.6;89.2;21.3
61;2021-12-06;41;54;2333;220122;216863;54150;90.6;89.3;22.3
61;2021-12-07;76;74;3487;220198;216937;57637;90.6;89.3;23.7
61;2021-12-08;92;95;3189;220290;217032;60826;90.7;89.3;25.0
61;2021-12-09;81;79;3367;220371;217111;64193;90.7;89.4;26.4
61;2021-12-10;66;147;3476;220437;217258;67669;90.7;89.4;27.9
61;2021-12-11;72;70;2134;220509;217328;69803;90.8;89.5;28.7
61;2021-12-12;13;10;428;220522;217338;70231;90.8;89.5;28.9
61;2021-12-13;95;89;3104;220617;217427;73335;90.8;89.5;30.2
61;2021-12-14;88;108;4154;220705;217535;77489;90.8;89.5;31.9
61;2021-12-15;102;126;3507;220807;217661;80996;90.9;89.6;33.3
61;2021-12-16;88;120;4078;220895;217781;85074;90.9;89.6;35.0
61;2021-12-17;115;139;4037;221010;217920;89111;91.0;89.7;36.7
61;2021-12-18;78;67;2103;221088;217987;91214;91.0;89.7;37.5
61;2021-12-19;36;22;567;221124;218009;91781;91.0;89.7;37.8
62;2020-12-27;3;0;0;3;0;0;0.0;0.0;0.0
62;2020-12-28;1;0;0;4;0;0;0.0;0.0;0.0
62;2020-12-29;0;0;0;4;0;0;0.0;0.0;0.0
62;2020-12-30;0;0;0;4;0;0;0.0;0.0;0.0
62;2020-12-31;0;0;0;4;0;0;0.0;0.0;0.0
62;2021-01-01;1;0;0;5;0;0;0.0;0.0;0.0
62;2021-01-02;3;2;0;8;2;0;0.0;0.0;0.0
62;2021-01-03;0;0;0;8;2;0;0.0;0.0;0.0
62;2021-01-04;5;0;0;13;2;0;0.0;0.0;0.0
62;2021-01-05;64;0;0;77;2;0;0.0;0.0;0.0
62;2021-01-06;148;0;0;225;2;0;0.0;0.0;0.0
62;2021-01-07;371;0;0;596;2;0;0.0;0.0;0.0
62;2021-01-08;710;10;0;1306;12;0;0.1;0.0;0.0
62;2021-01-09;199;2;0;1505;14;0;0.1;0.0;0.0
62;2021-01-10;109;0;0;1614;14;0;0.1;0.0;0.0
62;2021-01-11;610;3;0;2224;17;0;0.2;0.0;0.0
62;2021-01-12;1319;5;0;3543;22;0;0.3;0.0;0.0
62;2021-01-13;1146;16;0;4689;38;0;0.4;0.0;0.0
62;2021-01-14;1461;11;0;6150;49;0;0.5;0.0;0.0
62;2021-01-15;1335;14;0;7485;63;0;0.6;0.0;0.0
62;2021-01-16;351;3;0;7836;66;0;0.6;0.0;0.0
62;2021-01-17;143;1;0;7979;67;0;0.6;0.0;0.0
62;2021-01-18;1726;9;0;9705;76;0;0.8;0.0;0.0
62;2021-01-19;2039;5;0;11744;81;0;0.9;0.0;0.0
62;2021-01-20;2002;9;0;13746;90;0;1.1;0.0;0.0
62;2021-01-21;2257;6;0;16003;96;0;1.3;0.0;0.0
62;2021-01-22;1800;8;0;17803;104;0;1.4;0.0;0.0
62;2021-01-23;494;1;0;18297;105;0;1.5;0.0;0.0
62;2021-01-24;9;0;0;18306;105;0;1.5;0.0;0.0
62;2021-01-25;1263;12;0;19569;117;0;1.6;0.0;0.0
62;2021-01-26;1597;32;0;21166;149;0;1.7;0.0;0.0
62;2021-01-27;1346;185;0;22512;334;0;1.8;0.0;0.0
62;2021-01-28;4002;406;0;26514;740;0;2.1;0.1;0.0
62;2021-01-29;1990;347;0;28504;1087;0;2.3;0.1;0.0
62;2021-01-30;166;152;0;28670;1239;0;2.3;0.1;0.0
62;2021-01-31;20;3;0;28690;1242;0;2.3;0.1;0.0
62;2021-02-01;53;366;0;28743;1608;0;2.3;0.1;0.0
62;2021-02-02;74;788;0;28817;2396;0;2.3;0.2;0.0
62;2021-02-03;172;648;0;28989;3044;0;2.3;0.2;0.0
62;2021-02-04;193;823;0;29182;3867;0;2.4;0.3;0.0
62;2021-02-05;105;754;0;29287;4621;0;2.4;0.4;0.0
62;2021-02-06;38;162;0;29325;4783;0;2.4;0.4;0.0
62;2021-02-07;242;33;0;29567;4816;0;2.4;0.4;0.0
62;2021-02-08;166;873;0;29733;5689;0;2.4;0.5;0.0
62;2021-02-09;273;1098;0;30006;6787;0;2.4;0.5;0.0
62;2021-02-10;384;1103;0;30390;7890;0;2.5;0.6;0.0
62;2021-02-11;772;1022;0;31162;8912;0;2.5;0.7;0.0
62;2021-02-12;985;848;0;32147;9760;0;2.6;0.8;0.0
62;2021-02-13;179;302;0;32326;10062;0;2.6;0.8;0.0
62;2021-02-14;3;10;0;32329;10072;0;2.6;0.8;0.0
62;2021-02-15;737;1260;0;33066;11332;0;2.7;0.9;0.0
62;2021-02-16;929;1816;0;33995;13148;0;2.7;1.1;0.0
62;2021-02-17;1092;2065;0;35087;15213;0;2.8;1.2;0.0
62;2021-02-18;2240;3706;0;37327;18919;0;3.0;1.5;0.0
62;2021-02-19;2268;2477;0;39595;21396;0;3.2;1.7;0.0
62;2021-02-20;616;499;0;40211;21895;0;3.2;1.8;0.0
62;2021-02-21;84;63;0;40295;21958;0;3.3;1.8;0.0
62;2021-02-22;855;954;0;41150;22912;0;3.3;1.9;0.0
62;2021-02-23;1431;1217;0;42581;24129;0;3.4;1.9;0.0
62;2021-02-24;1587;762;0;44168;24891;0;3.6;2.0;0.0
62;2021-02-25;3256;557;0;47424;25448;0;3.8;2.1;0.0
62;2021-02-26;2959;453;0;50383;25901;0;4.1;2.1;0.0
62;2021-02-27;1838;117;0;52221;26018;0;4.2;2.1;0.0
62;2021-02-28;59;44;0;52280;26062;0;4.2;2.1;0.0
62;2021-03-01;1389;154;0;53669;26216;0;4.3;2.1;0.0
62;2021-03-02;3121;205;0;56790;26421;0;4.6;2.1;0.0
62;2021-03-03;3304;208;0;60094;26629;0;4.9;2.2;0.0
62;2021-03-04;3876;275;0;63970;26904;0;5.2;2.2;0.0
62;2021-03-05;4703;300;0;68673;27204;0;5.5;2.2;0.0
62;2021-03-06;9722;308;0;78395;27512;0;6.3;2.2;0.0
62;2021-03-07;8117;253;0;86512;27765;0;7.0;2.2;0.0
62;2021-03-08;2317;354;0;88829;28119;0;7.2;2.3;0.0
62;2021-03-09;3935;474;0;92764;28593;0;7.5;2.3;0.0
62;2021-03-10;4349;667;0;97113;29260;0;7.8;2.4;0.0
62;2021-03-11;6177;1532;0;103290;30792;0;8.3;2.5;0.0
62;2021-03-12;6828;1453;0;110118;32245;0;8.9;2.6;0.0
62;2021-03-13;14782;872;0;124900;33117;0;10.1;2.7;0.0
62;2021-03-14;9613;411;0;134513;33528;0;10.9;2.7;0.0
62;2021-03-15;3858;1055;0;138371;34583;0;11.2;2.8;0.0
62;2021-03-16;2810;836;0;141181;35419;0;11.4;2.9;0.0
62;2021-03-17;2851;815;0;144032;36234;0;11.6;2.9;0.0
62;2021-03-18;2800;1058;0;146832;37292;0;11.9;3.0;0.0
62;2021-03-19;4836;935;0;151668;38227;0;12.2;3.1;0.0
62;2021-03-20;11340;638;0;163008;38865;0;13.2;3.1;0.0
62;2021-03-21;9219;388;0;172227;39253;0;13.9;3.2;0.0
62;2021-03-22;3060;1157;0;175287;40410;0;14.2;3.3;0.0
62;2021-03-23;5006;1537;0;180293;41947;0;14.6;3.4;0.0
62;2021-03-24;4656;1403;0;184949;43350;0;14.9;3.5;0.0
62;2021-03-25;6575;1518;0;191524;44868;0;15.5;3.6;0.0
62;2021-03-26;7136;1490;0;198660;46358;0;16.0;3.7;0.0
62;2021-03-27;12462;783;0;211122;47141;0;17.0;3.8;0.0
62;2021-03-28;6811;287;0;217933;47428;0;17.6;3.8;0.0
62;2021-03-29;3489;1302;0;221422;48730;0;17.9;3.9;0.0
62;2021-03-30;4579;2261;0;226001;50991;0;18.2;4.1;0.0
62;2021-03-31;4135;2477;0;230136;53468;0;18.6;4.3;0.0
62;2021-04-01;4945;2795;0;235081;56263;0;19.0;4.5;0.0
62;2021-04-02;5020;3373;0;240101;59636;0;19.4;4.8;0.0
62;2021-04-03;8343;3432;0;248444;63068;0;20.1;5.1;0.0
62;2021-04-04;4494;1940;0;252938;65008;0;20.4;5.2;0.0
62;2021-04-05;1206;514;0;254144;65522;0;20.5;5.3;0.0
62;2021-04-06;4030;3096;0;258174;68618;0;20.8;5.5;0.0
62;2021-04-07;5021;3649;0;263195;72267;0;21.3;5.8;0.0
62;2021-04-08;6517;4006;0;269712;76273;0;21.8;6.2;0.0
62;2021-04-09;7688;3609;0;277400;79882;0;22.4;6.5;0.0
62;2021-04-10;6740;8125;0;284140;88007;0;22.9;7.1;0.0
62;2021-04-11;2797;6843;0;286937;94850;0;23.2;7.7;0.0
62;2021-04-12;3472;2518;0;290409;97368;0;23.5;7.9;0.0
62;2021-04-13;6136;3294;0;296545;100662;0;23.9;8.1;0.0
62;2021-04-14;5396;3129;0;301941;103791;0;24.4;8.4;0.0
62;2021-04-15;5851;3046;0;307792;106837;0;24.9;8.6;0.0
62;2021-04-16;5540;3315;0;313332;110152;0;25.3;8.9;0.0
62;2021-04-17;4418;7629;0;317750;117781;0;25.7;9.5;0.0
62;2021-04-18;1971;6640;0;319721;124421;0;25.8;10.0;0.0
62;2021-04-19;2921;2080;0;322642;126501;0;26.1;10.2;0.0
62;2021-04-20;4108;3856;0;326750;130357;0;26.4;10.5;0.0
62;2021-04-21;3733;3883;0;330483;134240;0;26.7;10.8;0.0
62;2021-04-22;4167;5135;0;334650;139375;0;27.0;11.3;0.0
62;2021-04-23;4167;5273;0;338817;144648;0;27.4;11.7;0.0
62;2021-04-24;4442;6745;0;343259;151393;0;27.7;12.2;0.0
62;2021-04-25;1946;3513;0;345205;154906;0;27.9;12.5;0.0
62;2021-04-26;2441;2555;0;347646;157461;0;28.1;12.7;0.0
62;2021-04-27;4569;3656;0;352215;161117;0;28.4;13.0;0.0
62;2021-04-28;4709;4378;0;356924;165495;0;28.8;13.4;0.0
62;2021-04-29;4978;5760;0;361902;171255;0;29.2;13.8;0.0
62;2021-04-30;5555;5699;0;367457;176954;0;29.7;14.3;0.0
62;2021-05-01;6174;3842;0;373631;180796;0;30.2;14.6;0.0
62;2021-05-02;8050;3320;0;381681;184116;0;30.8;14.9;0.0
62;2021-05-03;5070;2445;0;386751;186561;0;31.2;15.1;0.0
62;2021-05-04;5815;4958;0;392566;191519;0;31.7;15.5;0.0
62;2021-05-05;5195;4765;0;397761;196284;0;32.1;15.8;0.0
62;2021-05-06;5892;4988;0;403653;201272;0;32.6;16.3;0.0
62;2021-05-07;8358;4824;0;412011;206096;0;33.3;16.6;0.0
62;2021-05-08;11291;2514;0;423302;208610;0;34.2;16.8;0.0
62;2021-05-09;8998;1704;0;432300;210314;0;34.9;17.0;0.0
62;2021-05-10;5804;4129;0;438104;214443;0;35.4;17.3;0.0
62;2021-05-11;7108;5033;0;445212;219476;0;36.0;17.7;0.0
62;2021-05-12;9335;4714;0;454547;224190;0;36.7;18.1;0.0
62;2021-05-13;10052;1552;0;464599;225742;0;37.5;18.2;0.0
62;2021-05-14;11599;3495;0;476198;229237;0;38.5;18.5;0.0
62;2021-05-15;19346;3352;0;495544;232589;0;40.0;18.8;0.0
62;2021-05-16;16409;1445;0;511953;234034;0;41.3;18.9;0.0
62;2021-05-17;8428;2760;0;520381;236794;0;42.0;19.1;0.0
62;2021-05-18;9299;3140;0;529680;239934;0;42.8;19.4;0.0
62;2021-05-19;8839;2877;0;538519;242811;0;43.5;19.6;0.0
62;2021-05-20;8590;3911;0;547109;246722;0;44.2;19.9;0.0
62;2021-05-21;9756;4312;0;556865;251034;0;45.0;20.3;0.0
62;2021-05-22;17378;3500;0;574243;254534;0;46.4;20.6;0.0
62;2021-05-23;12429;1142;0;586672;255676;0;47.4;20.6;0.0
62;2021-05-24;5028;730;0;591700;256406;0;47.8;20.7;0.0
62;2021-05-25;7215;4038;0;598915;260444;0;48.4;21.0;0.0
62;2021-05-26;7240;4891;0;606155;265335;0;48.9;21.4;0.0
62;2021-05-27;6518;5722;0;612673;271057;0;49.5;21.9;0.0
62;2021-05-28;6794;6884;0;619467;277941;0;50.0;22.4;0.0
62;2021-05-29;10408;5513;0;629875;283454;0;50.9;22.9;0.0
62;2021-05-30;3936;950;0;633811;284404;0;51.2;23.0;0.0
62;2021-05-31;4915;4150;0;638726;288554;0;51.6;23.3;0.0
62;2021-06-01;6568;6536;0;645294;295090;0;52.1;23.8;0.0
62;2021-06-02;7474;5944;0;652768;301034;0;52.7;24.3;0.0
62;2021-06-03;7850;6106;0;660618;307140;0;53.3;24.8;0.0
62;2021-06-04;7927;6442;0;668545;313582;0;54.0;25.3;0.0
62;2021-06-05;8032;6222;0;676577;319804;0;54.6;25.8;0.0
62;2021-06-06;3111;1360;0;679688;321164;0;54.9;25.9;0.0
62;2021-06-07;4870;4069;0;684558;325233;0;55.3;26.3;0.0
62;2021-06-08;6266;6052;0;690824;331285;0;55.8;26.8;0.0
62;2021-06-09;5524;5062;0;696348;336347;0;56.2;27.2;0.0
62;2021-06-10;5197;6187;0;701545;342534;0;56.6;27.7;0.0
62;2021-06-11;6136;9191;0;707681;351725;0;57.1;28.4;0.0
62;2021-06-12;5842;8888;0;713523;360613;0;57.6;29.1;0.0
62;2021-06-13;3148;3825;0;716671;364438;0;57.9;29.4;0.0
62;2021-06-14;2800;7243;0;719471;371681;0;58.1;30.0;0.0
62;2021-06-15;4711;8778;0;724182;380459;0;58.5;30.7;0.0
62;2021-06-16;5125;7682;0;729307;388141;0;58.9;31.3;0.0
62;2021-06-17;5218;8200;0;734525;396341;0;59.3;32.0;0.0
62;2021-06-18;4845;11210;0;739370;407551;0;59.7;32.9;0.0
62;2021-06-19;5778;13974;0;745148;421525;0;60.2;34.0;0.0
62;2021-06-20;2270;4847;0;747418;426372;0;60.4;34.4;0.0
62;2021-06-21;2975;9578;0;750393;435950;0;60.6;35.2;0.0
62;2021-06-22;3524;10483;0;753917;446433;0;60.9;36.0;0.0
62;2021-06-23;3478;10755;0;757395;457188;0;61.2;36.9;0.0
62;2021-06-24;3432;11992;0;760827;469180;0;61.4;37.9;0.0
62;2021-06-25;3819;15604;0;764646;484784;0;61.7;39.1;0.0
62;2021-06-26;3645;18211;0;768291;502995;0;62.0;40.6;0.0
62;2021-06-27;1364;10154;0;769655;513149;0;62.1;41.4;0.0
62;2021-06-28;2049;9470;0;771704;522619;0;62.3;42.2;0.0
62;2021-06-29;3066;11517;0;774770;534136;0;62.6;43.1;0.0
62;2021-06-30;4072;11061;0;778842;545197;0;62.9;44.0;0.0
62;2021-07-01;4459;10612;0;783301;555809;0;63.3;44.9;0.0
62;2021-07-02;4153;12310;0;787454;568119;0;63.6;45.9;0.0
62;2021-07-03;2965;17981;0;790419;586100;0;63.8;47.3;0.0
62;2021-07-04;1579;9653;0;791998;595753;0;64.0;48.1;0.0
62;2021-07-05;2604;7615;0;794602;603368;0;64.2;48.7;0.0
62;2021-07-06;3861;10125;0;798463;613493;0;64.5;49.5;0.0
62;2021-07-07;4014;8920;0;802477;622413;0;64.8;50.3;0.0
62;2021-07-08;5161;8990;0;807638;631403;0;65.2;51.0;0.0
62;2021-07-09;4550;11085;0;812188;642488;0;65.6;51.9;0.0
62;2021-07-10;5115;11857;0;817303;654345;0;66.0;52.8;0.0
62;2021-07-11;1513;2473;0;818816;656818;0;66.1;53.0;0.0
62;2021-07-12;2502;7598;0;821318;664416;0;66.3;53.7;0.0
62;2021-07-13;5336;12020;0;826654;676436;0;66.8;54.6;0.0
62;2021-07-14;3738;3244;0;830392;679680;0;67.1;54.9;0.0
62;2021-07-15;7645;11512;0;838037;691192;0;67.7;55.8;0.0
62;2021-07-16;7918;11088;0;845955;702280;0;68.3;56.7;0.0
62;2021-07-17;9506;10464;0;855461;712744;0;69.1;57.6;0.0
62;2021-07-18;3182;3774;0;858643;716518;0;69.3;57.9;0.0
62;2021-07-19;6184;7401;0;864827;723919;0;69.8;58.5;0.0
62;2021-07-20;8176;10704;0;873003;734623;0;70.5;59.3;0.0
62;2021-07-21;9725;9449;0;882728;744072;0;71.3;60.1;0.0
62;2021-07-22;9915;8888;0;892643;752960;0;72.1;60.8;0.0
62;2021-07-23;10652;8494;0;903295;761454;0;72.9;61.5;0.0
62;2021-07-24;9919;10241;0;913214;771695;0;73.7;62.3;0.0
62;2021-07-25;5919;2055;0;919133;773750;0;74.2;62.5;0.0
62;2021-07-26;6687;5855;0;925820;779605;0;74.8;63.0;0.0
62;2021-07-27;9965;8098;0;935785;787703;0;75.6;63.6;0.0
62;2021-07-28;10545;7469;0;946330;795172;0;76.4;64.2;0.0
62;2021-07-29;11862;7541;0;958192;802713;0;77.4;64.8;0.0
62;2021-07-30;9257;6509;0;967449;809222;0;78.1;65.3;0.0
62;2021-07-31;6967;4307;0;974416;813529;0;78.7;65.7;0.0
62;2021-08-01;2780;1285;0;977196;814814;0;78.9;65.8;0.0
62;2021-08-02;6914;5053;0;984110;819867;0;79.5;66.2;0.0
62;2021-08-03;8480;7564;0;992590;827431;0;80.2;66.8;0.0
62;2021-08-04;9380;5533;0;1001970;832964;0;80.9;67.3;0.0
62;2021-08-05;8186;5775;0;1010156;838739;0;81.6;67.7;0.0
62;2021-08-06;7400;6045;0;1017556;844784;0;82.2;68.2;0.0
62;2021-08-07;5803;5489;0;1023359;850273;0;82.6;68.7;0.0
62;2021-08-08;2040;1501;0;1025399;851774;0;82.8;68.8;0.0
62;2021-08-09;5317;5393;0;1030716;857167;0;83.2;69.2;0.0
62;2021-08-10;6176;7341;0;1036892;864508;0;83.7;69.8;0.0
62;2021-08-11;5427;7397;0;1042319;871905;0;84.2;70.4;0.0
62;2021-08-12;5796;7141;0;1048115;879046;0;84.6;71.0;0.0
62;2021-08-13;4572;6265;0;1052687;885311;0;85.0;71.5;0.0
62;2021-08-14;3950;7083;0;1056637;892394;0;85.3;72.1;0.0
62;2021-08-15;1210;1357;0;1057847;893751;0;85.4;72.2;0.0
62;2021-08-16;3266;6243;0;1061113;899994;0;85.7;72.7;0.0
62;2021-08-17;4010;7210;0;1065123;907204;0;86.0;73.3;0.0
62;2021-08-18;4371;7231;0;1069494;914435;0;86.4;73.8;0.0
62;2021-08-19;4266;8464;0;1073760;922899;0;86.7;74.5;0.0
62;2021-08-20;3367;8632;0;1077127;931531;0;87.0;75.2;0.0
62;2021-08-21;2456;9708;0;1079583;941239;0;87.2;76.0;0.0
62;2021-08-22;483;3006;0;1080066;944245;0;87.2;76.2;0.0
62;2021-08-23;2724;8036;0;1082790;952281;0;87.4;76.9;0.0
62;2021-08-24;3687;10130;0;1086477;962411;0;87.7;77.7;0.0
62;2021-08-25;3464;9061;0;1089941;971472;0;88.0;78.4;0.0
62;2021-08-26;3075;9392;0;1093016;980864;0;88.3;79.2;0.0
62;2021-08-27;2591;8940;0;1095607;989804;0;88.5;79.9;0.0
62;2021-08-28;2095;8118;0;1097702;997922;0;88.6;80.6;0.0
62;2021-08-29;906;2413;0;1098608;1000335;0;88.7;80.8;0.0
62;2021-08-30;2048;7411;102;1100656;1007746;102;88.9;81.4;0.0
62;2021-08-31;2180;7801;197;1102836;1015547;299;89.1;82.0;0.0
62;2021-09-01;1859;5867;400;1104695;1021414;699;89.2;82.5;0.1
62;2021-09-02;1789;6199;449;1106484;1027613;1148;89.3;83.0;0.1
62;2021-09-03;2087;6934;614;1108571;1034547;1762;89.5;83.5;0.1
62;2021-09-04;2125;6505;405;1110696;1041052;2167;89.7;84.1;0.2
62;2021-09-05;318;1236;67;1111014;1042288;2234;89.7;84.2;0.2
62;2021-09-06;1076;3415;534;1112090;1045703;2768;89.8;84.4;0.2
62;2021-09-07;1204;3811;565;1113294;1049514;3333;89.9;84.7;0.3
62;2021-09-08;1308;4062;444;1114602;1053576;3777;90.0;85.1;0.3
62;2021-09-09;1264;4224;483;1115866;1057800;4260;90.1;85.4;0.3
62;2021-09-10;1617;4450;637;1117483;1062250;4897;90.2;85.8;0.4
62;2021-09-11;1272;3985;364;1118755;1066235;5261;90.3;86.1;0.4
62;2021-09-12;219;564;50;1118974;1066799;5311;90.4;86.1;0.4
62;2021-09-13;826;2293;607;1119800;1069092;5918;90.4;86.3;0.5
62;2021-09-14;1327;3321;1091;1121127;1072413;7009;90.5;86.6;0.6
62;2021-09-15;1345;4091;845;1122472;1076504;7854;90.6;86.9;0.6
62;2021-09-16;1357;2853;1034;1123829;1079357;8888;90.7;87.2;0.7
62;2021-09-17;1367;2483;1050;1125196;1081840;9938;90.9;87.4;0.8
62;2021-09-18;1067;2939;518;1126263;1084779;10456;90.9;87.6;0.8
62;2021-09-19;137;473;52;1126400;1085252;10508;91.0;87.6;0.8
62;2021-09-20;607;1535;855;1127007;1086787;11363;91.0;87.8;0.9
62;2021-09-21;901;2404;858;1127908;1089191;12221;91.1;88.0;1.0
62;2021-09-22;785;2606;896;1128693;1091797;13117;91.1;88.2;1.1
62;2021-09-23;712;1768;1486;1129405;1093565;14603;91.2;88.3;1.2
62;2021-09-24;772;1995;934;1130177;1095560;15537;91.3;88.5;1.3
62;2021-09-25;695;2670;655;1130872;1098230;16192;91.3;88.7;1.3
62;2021-09-26;85;328;58;1130957;1098558;16250;91.3;88.7;1.3
62;2021-09-27;353;1132;635;1131310;1099690;16885;91.4;88.8;1.4
62;2021-09-28;581;1670;985;1131891;1101360;17870;91.4;88.9;1.4
62;2021-09-29;722;1872;991;1132613;1103232;18861;91.5;89.1;1.5
62;2021-09-30;431;994;828;1133044;1104226;19689;91.5;89.2;1.6
62;2021-10-01;785;1681;1055;1133829;1105907;20744;91.6;89.3;1.7
62;2021-10-02;729;1553;817;1134558;1107460;21561;91.6;89.4;1.7
62;2021-10-03;94;250;76;1134652;1107710;21637;91.6;89.4;1.7
62;2021-10-04;446;817;1122;1135098;1108527;22759;91.7;89.5;1.8
62;2021-10-05;650;1439;1716;1135748;1109966;24475;91.7;89.6;2.0
62;2021-10-06;605;1254;1198;1136353;1111220;25673;91.8;89.7;2.1
62;2021-10-07;507;1180;1382;1136860;1112400;27055;91.8;89.8;2.2
62;2021-10-08;758;1569;1721;1137618;1113969;28776;91.9;90.0;2.3
62;2021-10-09;644;1371;1515;1138262;1115340;30291;91.9;90.1;2.4
62;2021-10-10;75;202;193;1138337;1115542;30484;91.9;90.1;2.5
62;2021-10-11;375;705;1273;1138712;1116247;31757;92.0;90.1;2.6
62;2021-10-12;499;1296;2454;1139211;1117543;34211;92.0;90.2;2.8
62;2021-10-13;576;928;1666;1139787;1118471;35877;92.0;90.3;2.9
62;2021-10-14;409;737;1396;1140196;1119208;37273;92.1;90.4;3.0
62;2021-10-15;684;1127;2309;1140880;1120335;39582;92.1;90.5;3.2
62;2021-10-16;536;789;1692;1141416;1121124;41274;92.2;90.5;3.3
62;2021-10-17;57;80;165;1141473;1121204;41439;92.2;90.5;3.3
62;2021-10-18;386;542;1818;1141859;1121746;43257;92.2;90.6;3.5
62;2021-10-19;544;841;2938;1142403;1122587;46195;92.2;90.6;3.7
62;2021-10-20;495;722;2189;1142898;1123309;48384;92.3;90.7;3.9
62;2021-10-21;419;544;2216;1143317;1123853;50600;92.3;90.8;4.1
62;2021-10-22;611;980;2816;1143928;1124833;53416;92.4;90.8;4.3
62;2021-10-23;507;752;2280;1144435;1125585;55696;92.4;90.9;4.5
62;2021-10-24;25;53;152;1144460;1125638;55848;92.4;90.9;4.5
62;2021-10-25;429;484;2146;1144889;1126122;57994;92.5;90.9;4.7
62;2021-10-26;470;663;3068;1145359;1126785;61062;92.5;91.0;4.9
62;2021-10-27;407;597;2290;1145766;1127382;63352;92.5;91.0;5.1
62;2021-10-28;404;469;2244;1146170;1127851;65596;92.6;91.1;5.3
62;2021-10-29;504;740;3037;1146674;1128591;68633;92.6;91.1;5.5
62;2021-10-30;366;647;2568;1147040;1129238;71201;92.6;91.2;5.7
62;2021-10-31;25;33;134;1147065;1129271;71335;92.6;91.2;5.8
62;2021-11-01;29;25;78;1147094;1129296;71413;92.6;91.2;5.8
62;2021-11-02;489;703;3333;1147583;1129999;74746;92.7;91.2;6.0
62;2021-11-03;438;636;2769;1148021;1130635;77515;92.7;91.3;6.3
62;2021-11-04;397;422;2460;1148418;1131057;79975;92.7;91.3;6.5
62;2021-11-05;471;634;3313;1148889;1131691;83288;92.8;91.4;6.7
62;2021-11-06;479;642;3112;1149368;1132333;86400;92.8;91.4;7.0
62;2021-11-07;102;116;468;1149470;1132449;86868;92.8;91.4;7.0
62;2021-11-08;299;421;2722;1149769;1132870;89590;92.8;91.5;7.2
62;2021-11-09;445;550;4678;1150214;1133420;94268;92.9;91.5;7.6
62;2021-11-10;534;724;4294;1150748;1134144;98562;92.9;91.6;8.0
62;2021-11-11;16;27;133;1150764;1134171;98695;92.9;91.6;8.0
62;2021-11-12;531;751;4667;1151295;1134922;103362;93.0;91.6;8.3
62;2021-11-13;390;549;2781;1151685;1135471;106143;93.0;91.7;8.6
62;2021-11-14;35;48;249;1151720;1135519;106392;93.0;91.7;8.6
62;2021-11-15;367;406;3614;1152087;1135925;110006;93.0;91.7;8.9
62;2021-11-16;342;432;4354;1152429;1136357;114360;93.1;91.8;9.2
62;2021-11-17;549;571;4666;1152978;1136928;119026;93.1;91.8;9.6
62;2021-11-18;433;604;5024;1153411;1137532;124050;93.1;91.9;10.0
62;2021-11-19;696;673;5867;1154107;1138205;129917;93.2;91.9;10.5
62;2021-11-20;514;567;3817;1154621;1138772;133734;93.2;92.0;10.8
62;2021-11-21;25;68;425;1154646;1138840;134159;93.2;92.0;10.8
62;2021-11-22;419;257;3753;1155065;1139097;137912;93.3;92.0;11.1
62;2021-11-23;431;388;5009;1155496;1139485;142921;93.3;92.0;11.5
62;2021-11-24;475;458;4039;1155971;1139943;146960;93.3;92.1;11.9
62;2021-11-25;505;427;6410;1156476;1140370;153370;93.4;92.1;12.4
62;2021-11-26;634;605;9785;1157110;1140975;163155;93.4;92.1;13.2
62;2021-11-27;403;504;7097;1157513;1141479;170252;93.5;92.2;13.7
62;2021-11-28;44;64;1428;1157557;1141543;171680;93.5;92.2;13.9
62;2021-11-29;287;331;7993;1157844;1141874;179673;93.5;92.2;14.5
62;2021-11-30;418;457;11787;1158262;1142331;191460;93.5;92.2;15.5
62;2021-12-01;344;481;11939;1158606;1142812;203399;93.6;92.3;16.4
62;2021-12-02;341;270;12887;1158947;1143082;216286;93.6;92.3;17.5
62;2021-12-03;428;653;15688;1159375;1143735;231974;93.6;92.4;18.7
62;2021-12-04;371;511;13182;1159746;1144246;245156;93.6;92.4;19.8
62;2021-12-05;66;61;4862;1159812;1144307;250018;93.7;92.4;20.2
62;2021-12-06;295;381;13440;1160107;1144688;263458;93.7;92.4;21.3
62;2021-12-07;315;404;16515;1160422;1145092;279973;93.7;92.5;22.6
62;2021-12-08;380;579;14370;1160802;1145671;294343;93.7;92.5;23.8
62;2021-12-09;414;463;17451;1161216;1146134;311794;93.8;92.6;25.2
62;2021-12-10;452;652;19520;1161668;1146786;331314;93.8;92.6;26.8
62;2021-12-11;385;559;17435;1162053;1147345;348749;93.8;92.6;28.2
62;2021-12-12;118;100;6376;1162171;1147445;355125;93.8;92.7;28.7
62;2021-12-13;351;432;15917;1162522;1147877;371042;93.9;92.7;30.0
62;2021-12-14;406;462;18780;1162928;1148339;389822;93.9;92.7;31.5
62;2021-12-15;349;538;16794;1163277;1148877;406616;93.9;92.8;32.8
62;2021-12-16;475;520;19376;1163752;1149397;425992;94.0;92.8;34.4
62;2021-12-17;417;662;19839;1164169;1150059;445831;94.0;92.9;36.0
62;2021-12-18;490;488;18221;1164659;1150547;464052;94.0;92.9;37.5
62;2021-12-19;190;136;6563;1164849;1150683;470615;94.1;92.9;38.0
63;2020-12-27;0;0;0;0;0;0;0.0;0.0;0.0
63;2020-12-28;0;0;0;0;0;0;0.0;0.0;0.0
63;2020-12-29;0;0;0;0;0;0;0.0;0.0;0.0
63;2020-12-30;0;0;0;0;0;0;0.0;0.0;0.0
63;2020-12-31;1;1;0;1;1;0;0.0;0.0;0.0
63;2021-01-01;1;0;0;2;1;0;0.0;0.0;0.0
63;2021-01-02;0;0;0;2;1;0;0.0;0.0;0.0
63;2021-01-03;0;0;0;2;1;0;0.0;0.0;0.0
63;2021-01-04;0;0;0;2;1;0;0.0;0.0;0.0
63;2021-01-05;1;0;0;3;1;0;0.0;0.0;0.0
63;2021-01-06;5;1;0;8;2;0;0.0;0.0;0.0
63;2021-01-07;303;1;0;311;3;0;0.1;0.0;0.0
63;2021-01-08;216;5;0;527;8;0;0.1;0.0;0.0
63;2021-01-09;101;0;0;628;8;0;0.1;0.0;0.0
63;2021-01-10;82;0;0;710;8;0;0.1;0.0;0.0
63;2021-01-11;435;4;0;1145;12;0;0.2;0.0;0.0
63;2021-01-12;663;1;0;1808;13;0;0.3;0.0;0.0
63;2021-01-13;785;8;0;2593;21;0;0.4;0.0;0.0
63;2021-01-14;548;8;0;3141;29;0;0.5;0.0;0.0
63;2021-01-15;428;6;0;3569;35;0;0.6;0.0;0.0
63;2021-01-16;168;0;0;3737;35;0;0.6;0.0;0.0
63;2021-01-17;139;0;0;3876;35;0;0.7;0.0;0.0
63;2021-01-18;655;3;0;4531;38;0;0.8;0.0;0.0
63;2021-01-19;873;2;0;5404;40;0;0.9;0.0;0.0
63;2021-01-20;1127;12;0;6531;52;0;1.1;0.0;0.0
63;2021-01-21;1088;5;0;7619;57;0;1.3;0.0;0.0
63;2021-01-22;1040;5;0;8659;62;0;1.5;0.0;0.0
63;2021-01-23;200;0;0;8859;62;0;1.5;0.0;0.0
63;2021-01-24;165;2;0;9024;64;0;1.6;0.0;0.0
63;2021-01-25;893;4;0;9917;68;0;1.7;0.0;0.0
63;2021-01-26;971;3;0;10888;71;0;1.9;0.0;0.0
63;2021-01-27;1058;6;0;11946;77;0;2.1;0.0;0.0
63;2021-01-28;1370;70;0;13316;147;0;2.3;0.0;0.0
63;2021-01-29;1200;73;0;14516;220;0;2.5;0.0;0.0
63;2021-01-30;98;2;0;14614;222;0;2.5;0.0;0.0
63;2021-01-31;9;0;0;14623;222;0;2.5;0.0;0.0
63;2021-02-01;656;188;0;15279;410;0;2.6;0.1;0.0
63;2021-02-02;919;256;0;16198;666;0;2.8;0.1;0.0
63;2021-02-03;1597;317;0;17795;983;0;3.1;0.2;0.0
63;2021-02-04;2111;508;0;19906;1491;0;3.5;0.3;0.0
63;2021-02-05;1240;287;0;21146;1778;0;3.7;0.3;0.0
63;2021-02-06;121;5;0;21267;1783;0;3.7;0.3;0.0
63;2021-02-07;11;3;0;21278;1786;0;3.7;0.3;0.0
63;2021-02-08;549;405;0;21827;2191;0;3.8;0.4;0.0
63;2021-02-09;712;436;0;22539;2627;0;3.9;0.5;0.0
63;2021-02-10;642;587;0;23181;3214;0;4.0;0.6;0.0
63;2021-02-11;843;504;0;24024;3718;0;4.2;0.6;0.0
63;2021-02-12;846;820;0;24870;4538;0;4.3;0.8;0.0
63;2021-02-13;115;2;0;24985;4540;0;4.3;0.8;0.0
63;2021-02-14;2;61;0;24987;4601;0;4.3;0.8;0.0
63;2021-02-15;222;852;0;25209;5453;0;4.4;0.9;0.0
63;2021-02-16;426;1169;0;25635;6622;0;4.4;1.1;0.0
63;2021-02-17;405;920;0;26040;7542;0;4.5;1.3;0.0
63;2021-02-18;641;902;0;26681;8444;0;4.6;1.5;0.0
63;2021-02-19;480;1022;0;27161;9466;0;4.7;1.6;0.0
63;2021-02-20;47;40;0;27208;9506;0;4.7;1.6;0.0
63;2021-02-21;3;19;0;27211;9525;0;4.7;1.7;0.0
63;2021-02-22;276;943;0;27487;10468;0;4.8;1.8;0.0
63;2021-02-23;587;1149;0;28074;11617;0;4.9;2.0;0.0
63;2021-02-24;708;1414;0;28782;13031;0;5.0;2.3;0.0
63;2021-02-25;1598;1694;0;30380;14725;0;5.3;2.6;0.0
63;2021-02-26;1639;1417;0;32019;16142;0;5.6;2.8;0.0
63;2021-02-27;633;82;0;32652;16224;0;5.7;2.8;0.0
63;2021-02-28;6;170;0;32658;16394;0;5.7;2.8;0.0
63;2021-03-01;593;546;0;33251;16940;0;5.8;2.9;0.0
63;2021-03-02;965;825;0;34216;17765;0;5.9;3.1;0.0
63;2021-03-03;1077;740;0;35293;18505;0;6.1;3.2;0.0
63;2021-03-04;1794;531;0;37087;19036;0;6.4;3.3;0.0
63;2021-03-05;2653;728;0;39740;19764;0;6.9;3.4;0.0
63;2021-03-06;1577;56;0;41317;19820;0;7.2;3.4;0.0
63;2021-03-07;506;21;0;41823;19841;0;7.2;3.4;0.0
63;2021-03-08;1004;684;0;42827;20525;0;7.4;3.6;0.0
63;2021-03-09;1607;1061;0;44434;21586;0;7.7;3.7;0.0
63;2021-03-10;1683;664;0;46117;22250;0;8.0;3.9;0.0
63;2021-03-11;3135;942;0;49252;23192;0;8.5;4.0;0.0
63;2021-03-12;3580;431;0;52832;23623;0;9.2;4.1;0.0
63;2021-03-13;2101;92;0;54933;23715;0;9.5;4.1;0.0
63;2021-03-14;73;25;0;55006;23740;0;9.5;4.1;0.0
63;2021-03-15;1735;364;0;56741;24104;0;9.8;4.2;0.0
63;2021-03-16;1747;424;0;58488;24528;0;10.1;4.3;0.0
63;2021-03-17;1685;730;0;60173;25258;0;10.4;4.4;0.0
63;2021-03-18;1978;751;0;62151;26009;0;10.8;4.5;0.0
63;2021-03-19;2820;547;0;64971;26556;0;11.3;4.6;0.0
63;2021-03-20;1131;76;0;66102;26632;0;11.5;4.6;0.0
63;2021-03-21;57;42;0;66159;26674;0;11.5;4.6;0.0
63;2021-03-22;2025;261;0;68184;26935;0;11.8;4.7;0.0
63;2021-03-23;3004;367;0;71188;27302;0;12.3;4.7;0.0
63;2021-03-24;3245;364;0;74433;27666;0;12.9;4.8;0.0
63;2021-03-25;4664;439;0;79097;28105;0;13.7;4.9;0.0
63;2021-03-26;4604;589;0;83701;28694;0;14.5;5.0;0.0
63;2021-03-27;2440;232;0;86141;28926;0;14.9;5.0;0.0
63;2021-03-28;1021;75;0;87162;29001;0;15.1;5.0;0.0
63;2021-03-29;2519;523;0;89681;29524;0;15.5;5.1;0.0
63;2021-03-30;3334;663;0;93015;30187;0;16.1;5.2;0.0
63;2021-03-31;3023;808;0;96038;30995;0;16.6;5.4;0.0
63;2021-04-01;3877;595;0;99915;31590;0;17.3;5.5;0.0
63;2021-04-02;3460;720;0;103375;32310;0;17.9;5.6;0.0
63;2021-04-03;1163;188;0;104538;32498;0;18.1;5.6;0.0
63;2021-04-04;834;31;0;105372;32529;0;18.3;5.6;0.0
63;2021-04-05;773;82;0;106145;32611;0;18.4;5.7;0.0
63;2021-04-06;2472;1006;0;108617;33617;0;18.8;5.8;0.0
63;2021-04-07;3252;899;0;111869;34516;0;19.4;6.0;0.0
63;2021-04-08;4733;1246;0;116602;35762;0;20.2;6.2;0.0
63;2021-04-09;5402;1095;0;122004;36857;0;21.1;6.4;0.0
63;2021-04-10;2307;503;0;124311;37360;0;21.5;6.5;0.0
63;2021-04-11;938;50;0;125249;37410;0;21.7;6.5;0.0
63;2021-04-12;1631;1329;0;126880;38739;0;22.0;6.7;0.0
63;2021-04-13;2052;1995;0;128932;40734;0;22.3;7.1;0.0
63;2021-04-14;2762;1503;0;131694;42237;0;22.8;7.3;0.0
63;2021-04-15;3858;1613;0;135552;43850;0;23.5;7.6;0.0
63;2021-04-16;2979;2161;0;138531;46011;0;24.0;8.0;0.0
63;2021-04-17;1288;698;0;139819;46709;0;24.2;8.1;0.0
63;2021-04-18;772;69;0;140591;46778;0;24.4;8.1;0.0
63;2021-04-19;1728;2110;0;142319;48888;0;24.7;8.5;0.0
63;2021-04-20;1804;2342;0;144123;51230;0;25.0;8.9;0.0
63;2021-04-21;1558;2455;0;145681;53685;0;25.3;9.3;0.0
63;2021-04-22;2044;2362;0;147725;56047;0;25.6;9.7;0.0
63;2021-04-23;2091;3081;0;149816;59128;0;26.0;10.2;0.0
63;2021-04-24;1202;1177;0;151018;60305;0;26.2;10.5;0.0
63;2021-04-25;534;409;0;151552;60714;0;26.3;10.5;0.0
63;2021-04-26;1528;2259;0;153080;62973;0;26.5;10.9;0.0
63;2021-04-27;2406;2611;0;155486;65584;0;27.0;11.4;0.0
63;2021-04-28;2427;3156;0;157913;68740;0;27.4;11.9;0.0
63;2021-04-29;3011;2945;0;160924;71685;0;27.9;12.4;0.0
63;2021-04-30;3061;2782;0;163985;74467;0;28.4;12.9;0.0
63;2021-05-01;1188;1008;0;165173;75475;0;28.6;13.1;0.0
63;2021-05-02;869;626;0;166042;76101;0;28.8;13.2;0.0
63;2021-05-03;2788;2271;0;168830;78372;0;29.3;13.6;0.0
63;2021-05-04;3043;2725;0;171873;81097;0;29.8;14.1;0.0
63;2021-05-05;3048;3144;0;174921;84241;0;30.3;14.6;0.0
63;2021-05-06;3844;3153;0;178765;87394;0;31.0;15.1;0.0
63;2021-05-07;4291;3659;0;183056;91053;0;31.7;15.8;0.0
63;2021-05-08;2152;721;0;185208;91774;0;32.1;15.9;0.0
63;2021-05-09;1780;766;0;186988;92540;0;32.4;16.0;0.0
63;2021-05-10;4341;2792;0;191329;95332;0;33.2;16.5;0.0
63;2021-05-11;5576;2824;0;196905;98156;0;34.1;17.0;0.0
63;2021-05-12;5396;2960;0;202301;101116;0;35.1;17.5;0.0
63;2021-05-13;4443;720;0;206744;101836;0;35.8;17.7;0.0
63;2021-05-14;4958;1620;0;211702;103456;0;36.7;17.9;0.0
63;2021-05-15;3740;1014;0;215442;104470;0;37.3;18.1;0.0
63;2021-05-16;3412;442;0;218854;104912;0;37.9;18.2;0.0
63;2021-05-17;3968;2008;0;222822;106920;0;38.6;18.5;0.0
63;2021-05-18;5227;1684;0;228049;108604;0;39.5;18.8;0.0
63;2021-05-19;5393;1691;0;233442;110295;0;40.5;19.1;0.0
63;2021-05-20;6838;2178;0;240280;112473;0;41.7;19.5;0.0
63;2021-05-21;6437;2318;0;246717;114791;0;42.8;19.9;0.0
63;2021-05-22;3436;848;0;250153;115639;0;43.4;20.0;0.0
63;2021-05-23;2319;233;0;252472;115872;0;43.8;20.1;0.0
63;2021-05-24;2886;602;0;255358;116474;0;44.3;20.2;0.0
63;2021-05-25;4318;2634;0;259676;119108;0;45.0;20.6;0.0
63;2021-05-26;5472;2425;0;265148;121533;0;46.0;21.1;0.0
63;2021-05-27;6462;2793;0;271610;124326;0;47.1;21.6;0.0
63;2021-05-28;5720;3898;0;277330;128224;0;48.1;22.2;0.0
63;2021-05-29;3365;1521;0;280695;129745;0;48.7;22.5;0.0
63;2021-05-30;1498;215;0;282193;129960;0;48.9;22.5;0.0
63;2021-05-31;4008;2311;0;286201;132271;0;49.6;22.9;0.0
63;2021-06-01;3902;3054;0;290103;135325;0;50.3;23.5;0.0
63;2021-06-02;3959;2556;0;294062;137881;0;51.0;23.9;0.0
63;2021-06-03;4904;3311;0;298966;141192;0;51.8;24.5;0.0
63;2021-06-04;5086;3688;0;304052;144880;0;52.7;25.1;0.0
63;2021-06-05;2783;1727;0;306835;146607;0;53.2;25.4;0.0
63;2021-06-06;1241;688;0;308076;147295;0;53.4;25.5;0.0
63;2021-06-07;3178;2601;0;311254;149896;0;54.0;26.0;0.0
63;2021-06-08;2974;2809;0;314228;152705;0;54.5;26.5;0.0
63;2021-06-09;3145;2359;0;317373;155064;0;55.0;26.9;0.0
63;2021-06-10;3287;2800;0;320660;157864;0;55.6;27.4;0.0
63;2021-06-11;3113;4226;0;323773;162090;0;56.1;28.1;0.0
63;2021-06-12;1688;1969;0;325461;164059;0;56.4;28.4;0.0
63;2021-06-13;466;1080;0;325927;165139;0;56.5;28.6;0.0
63;2021-06-14;1813;3548;0;327740;168687;0;56.8;29.2;0.0
63;2021-06-15;2335;3679;0;330075;172366;0;57.2;29.9;0.0
63;2021-06-16;2597;3421;0;332672;175787;0;57.7;30.5;0.0
63;2021-06-17;2477;4482;0;335149;180269;0;58.1;31.2;0.0
63;2021-06-18;2565;5989;0;337714;186258;0;58.5;32.3;0.0
63;2021-06-19;1679;3022;0;339393;189280;0;58.8;32.8;0.0
63;2021-06-20;648;2358;0;340041;191638;0;58.9;33.2;0.0
63;2021-06-21;1284;5540;0;341325;197178;0;59.2;34.2;0.0
63;2021-06-22;1356;5799;0;342681;202977;0;59.4;35.2;0.0
63;2021-06-23;1572;5014;0;344253;207991;0;59.7;36.1;0.0
63;2021-06-24;2008;5514;0;346261;213505;0;60.0;37.0;0.0
63;2021-06-25;1791;6164;0;348052;219669;0;60.3;38.1;0.0
63;2021-06-26;1075;3399;0;349127;223068;0;60.5;38.7;0.0
63;2021-06-27;685;3363;0;349812;226431;0;60.6;39.3;0.0
63;2021-06-28;1162;5648;0;350974;232079;0;60.8;40.2;0.0
63;2021-06-29;1282;5334;0;352256;237413;0;61.1;41.2;0.0
63;2021-06-30;1666;5532;0;353922;242945;0;61.4;42.1;0.0
63;2021-07-01;1969;7982;0;355891;250927;0;61.7;43.5;0.0
63;2021-07-02;2178;6700;0;358069;257627;0;62.1;44.7;0.0
63;2021-07-03;962;3008;0;359031;260635;0;62.2;45.2;0.0
63;2021-07-04;1013;1874;0;360044;262509;0;62.4;45.5;0.0
63;2021-07-05;1560;6340;0;361604;268849;0;62.7;46.6;0.0
63;2021-07-06;1645;4973;0;363249;273822;0;63.0;47.5;0.0
63;2021-07-07;1954;4318;0;365203;278140;0;63.3;48.2;0.0
63;2021-07-08;2243;4758;0;367446;282898;0;63.7;49.0;0.0
63;2021-07-09;1992;5949;0;369438;288847;0;64.0;50.1;0.0
63;2021-07-10;1541;3615;0;370979;292462;0;64.3;50.7;0.0
63;2021-07-11;863;1488;0;371842;293950;0;64.5;51.0;0.0
63;2021-07-12;1594;8295;0;373436;302245;0;64.7;52.4;0.0
63;2021-07-13;3609;6212;0;377045;308457;0;65.4;53.5;0.0
63;2021-07-14;3382;1730;0;380427;310187;0;65.9;53.8;0.0
63;2021-07-15;4309;5147;0;384736;315334;0;66.7;54.7;0.0
63;2021-07-16;4636;5795;0;389372;321129;0;67.5;55.7;0.0
63;2021-07-17;2883;2570;0;392255;323699;0;68.0;56.1;0.0
63;2021-07-18;2632;1090;0;394887;324789;0;68.5;56.3;0.0
63;2021-07-19;3909;4787;0;398796;329576;0;69.1;57.1;0.0
63;2021-07-20;4642;5425;0;403438;335001;0;69.9;58.1;0.0
63;2021-07-21;4659;4071;0;408097;339072;0;70.7;58.8;0.0
63;2021-07-22;5288;4407;0;413385;343479;0;71.7;59.5;0.0
63;2021-07-23;5059;4598;0;418444;348077;0;72.5;60.3;0.0
63;2021-07-24;3393;2010;0;421837;350087;0;73.1;60.7;0.0
63;2021-07-25;2691;1308;0;424528;351395;0;73.6;60.9;0.0
63;2021-07-26;3836;3240;0;428364;354635;0;74.3;61.5;0.0
63;2021-07-27;3894;3214;0;432258;357849;0;74.9;62.0;0.0
63;2021-07-28;3784;2739;0;436042;360588;0;75.6;62.5;0.0
63;2021-07-29;4370;3199;0;440412;363787;0;76.3;63.1;0.0
63;2021-07-30;3821;3600;0;444233;367387;0;77.0;63.7;0.0
63;2021-07-31;2158;1830;0;446391;369217;0;77.4;64.0;0.0
63;2021-08-01;1060;793;0;447451;370010;0;77.6;64.1;0.0
63;2021-08-02;2264;2959;0;449715;372969;0;78.0;64.7;0.0
63;2021-08-03;2755;3334;0;452470;376303;0;78.4;65.2;0.0
63;2021-08-04;2827;3178;1;455297;379481;1;78.9;65.8;0.0
63;2021-08-05;2401;3500;0;457698;382981;1;79.3;66.4;0.0
63;2021-08-06;2312;4022;0;460010;387003;1;79.7;67.1;0.0
63;2021-08-07;1269;2721;0;461279;389724;1;80.0;67.6;0.0
63;2021-08-08;335;1168;0;461614;390892;1;80.0;67.8;0.0
63;2021-08-09;1774;4092;0;463388;394984;1;80.3;68.5;0.0
63;2021-08-10;2217;4007;0;465605;398991;1;80.7;69.2;0.0
63;2021-08-11;2042;3649;0;467647;402640;1;81.1;69.8;0.0
63;2021-08-12;1800;4606;0;469447;407246;1;81.4;70.6;0.0
63;2021-08-13;1669;3906;0;471116;411152;1;81.7;71.3;0.0
63;2021-08-14;838;3017;0;471954;414169;1;81.8;71.8;0.0
63;2021-08-15;181;1346;0;472135;415515;1;81.8;72.0;0.0
63;2021-08-16;1137;4299;0;473272;419814;1;82.0;72.8;0.0
63;2021-08-17;1620;4032;0;474892;423846;1;82.3;73.5;0.0
63;2021-08-18;1398;3311;0;476290;427157;1;82.6;74.0;0.0
63;2021-08-19;1313;3506;0;477603;430663;1;82.8;74.7;0.0
63;2021-08-20;1324;3599;0;478927;434262;1;83.0;75.3;0.0
63;2021-08-21;669;2072;0;479596;436334;1;83.1;75.6;0.0
63;2021-08-22;213;1039;0;479809;437373;1;83.2;75.8;0.0
63;2021-08-23;1008;3502;0;480817;440875;1;83.3;76.4;0.0
63;2021-08-24;1065;3045;0;481882;443920;1;83.5;77.0;0.0
63;2021-08-25;1039;2922;0;482921;446842;1;83.7;77.5;0.0
63;2021-08-26;1102;2688;0;484023;449530;1;83.9;77.9;0.0
63;2021-08-27;1089;3258;0;485112;452788;1;84.1;78.5;0.0
63;2021-08-28;673;1680;0;485785;454468;1;84.2;78.8;0.0
63;2021-08-29;108;580;0;485893;455048;1;84.2;78.9;0.0
63;2021-08-30;762;2396;54;486655;457444;55;84.4;79.3;0.0
63;2021-08-31;971;2499;100;487626;459943;155;84.5;79.7;0.0
63;2021-09-01;949;1817;266;488575;461760;421;84.7;80.0;0.1
63;2021-09-02;823;1808;320;489398;463568;741;84.8;80.4;0.1
63;2021-09-03;908;2261;404;490306;465829;1145;85.0;80.7;0.2
63;2021-09-04;660;1398;130;490966;467227;1275;85.1;81.0;0.2
63;2021-09-05;76;201;14;491042;467428;1289;85.1;81.0;0.2
63;2021-09-06;521;1154;384;491563;468582;1673;85.2;81.2;0.3
63;2021-09-07;640;1398;380;492203;469980;2053;85.3;81.5;0.4
63;2021-09-08;677;1442;285;492880;471422;2338;85.4;81.7;0.4
63;2021-09-09;604;1171;354;493484;472593;2692;85.5;81.9;0.5
63;2021-09-10;749;1606;477;494233;474199;3169;85.7;82.2;0.5
63;2021-09-11;461;1021;128;494694;475220;3297;85.8;82.4;0.6
63;2021-09-12;50;159;13;494744;475379;3310;85.8;82.4;0.6
63;2021-09-13;431;875;500;495175;476254;3810;85.8;82.6;0.7
63;2021-09-14;536;834;630;495711;477088;4440;85.9;82.7;0.8
63;2021-09-15;550;1226;392;496261;478314;4832;86.0;82.9;0.8
63;2021-09-16;458;875;565;496719;479189;5397;86.1;83.1;0.9
63;2021-09-17;451;1185;579;497170;480374;5976;86.2;83.3;1.0
63;2021-09-18;299;951;124;497469;481325;6100;86.2;83.4;1.1
63;2021-09-19;41;109;9;497510;481434;6109;86.2;83.5;1.1
63;2021-09-20;337;666;552;497847;482100;6661;86.3;83.6;1.2
63;2021-09-21;399;685;687;498246;482785;7348;86.4;83.7;1.3
63;2021-09-22;375;1094;383;498621;483879;7731;86.4;83.9;1.3
63;2021-09-23;270;650;561;498891;484529;8292;86.5;84.0;1.4
63;2021-09-24;466;1099;527;499357;485628;8819;86.6;84.2;1.5
63;2021-09-25;231;748;140;499588;486376;8959;86.6;84.3;1.6
63;2021-09-26;26;97;6;499614;486473;8965;86.6;84.3;1.6
63;2021-09-27;298;587;490;499912;487060;9455;86.7;84.4;1.6
63;2021-09-28;274;579;580;500186;487639;10035;86.7;84.5;1.7
63;2021-09-29;311;736;692;500497;488375;10727;86.8;84.7;1.9
63;2021-09-30;270;637;718;500767;489012;11445;86.8;84.8;2.0
63;2021-10-01;474;850;627;501241;489862;12072;86.9;84.9;2.1
63;2021-10-02;254;513;150;501495;490375;12222;86.9;85.0;2.1
63;2021-10-03;33;75;12;501528;490450;12234;86.9;85.0;2.1
63;2021-10-04;200;381;423;501728;490831;12657;87.0;85.1;2.2
63;2021-10-05;281;477;624;502009;491308;13281;87.0;85.2;2.3
63;2021-10-06;340;606;580;502349;491914;13861;87.1;85.3;2.4
63;2021-10-07;239;451;762;502588;492365;14623;87.1;85.3;2.5
63;2021-10-08;368;683;868;502956;493048;15491;87.2;85.5;2.7
63;2021-10-09;217;382;254;503173;493430;15745;87.2;85.5;2.7
63;2021-10-10;25;45;14;503198;493475;15759;87.2;85.5;2.7
63;2021-10-11;195;415;690;503393;493890;16449;87.3;85.6;2.9
63;2021-10-12;207;402;755;503600;494292;17204;87.3;85.7;3.0
63;2021-10-13;288;417;789;503888;494709;17993;87.3;85.8;3.1
63;2021-10-14;242;357;851;504130;495066;18844;87.4;85.8;3.3
63;2021-10-15;370;635;1230;504500;495701;20074;87.5;85.9;3.5
63;2021-10-16;207;305;233;504707;496006;20307;87.5;86.0;3.5
63;2021-10-17;23;41;11;504730;496047;20318;87.5;86.0;3.5
63;2021-10-18;194;380;786;504924;496427;21104;87.5;86.1;3.7
63;2021-10-19;128;245;832;505052;496672;21936;87.5;86.1;3.8
63;2021-10-20;169;346;1057;505221;497018;22993;87.6;86.2;4.0
63;2021-10-21;107;341;997;505328;497359;23990;87.6;86.2;4.2
63;2021-10-22;170;495;1334;505498;497854;25324;87.6;86.3;4.4
63;2021-10-23;80;228;335;505578;498082;25659;87.6;86.3;4.4
63;2021-10-24;15;31;21;505593;498113;25680;87.6;86.3;4.5
63;2021-10-25;122;225;981;505715;498338;26661;87.7;86.4;4.6
63;2021-10-26;110;192;1094;505825;498530;27755;87.7;86.4;4.8
63;2021-10-27;115;285;1200;505940;498815;28955;87.7;86.5;5.0
63;2021-10-28;107;285;1175;506047;499100;30130;87.7;86.5;5.2
63;2021-10-29;130;323;1348;506177;499423;31478;87.7;86.6;5.5
63;2021-10-30;54;157;323;506231;499580;31801;87.8;86.6;5.5
63;2021-10-31;4;13;30;506235;499593;31831;87.8;86.6;5.5
63;2021-11-01;28;33;146;506263;499626;31977;87.8;86.6;5.5
63;2021-11-02;125;243;1489;506388;499869;33466;87.8;86.6;5.8
63;2021-11-03;112;272;1257;506500;500141;34723;87.8;86.7;6.0
63;2021-11-04;125;199;1511;506625;500340;36234;87.8;86.7;6.3
63;2021-11-05;151;344;1950;506776;500684;38184;87.8;86.8;6.6
63;2021-11-06;67;186;646;506843;500870;38830;87.9;86.8;6.7
63;2021-11-07;9;30;33;506852;500900;38863;87.9;86.8;6.7
63;2021-11-08;90;214;1710;506942;501114;40573;87.9;86.9;7.0
63;2021-11-09;93;189;2023;507035;501303;42596;87.9;86.9;7.4
63;2021-11-10;145;236;2009;507180;501539;44605;87.9;86.9;7.7
63;2021-11-11;38;34;396;507218;501573;45001;87.9;86.9;7.8
63;2021-11-12;149;207;2077;507367;501780;47078;87.9;87.0;8.2
63;2021-11-13;79;110;756;507446;501890;47834;88.0;87.0;8.3
63;2021-11-14;6;18;65;507452;501908;47899;88.0;87.0;8.3
63;2021-11-15;88;134;2349;507540;502042;50248;88.0;87.0;8.7
63;2021-11-16;106;135;2603;507646;502177;52851;88.0;87.0;9.2
63;2021-11-17;157;190;2344;507803;502367;55195;88.0;87.1;9.6
63;2021-11-18;105;127;2335;507908;502494;57530;88.0;87.1;10.0
63;2021-11-19;172;191;2917;508080;502685;60447;88.1;87.1;10.5
63;2021-11-20;89;102;1007;508169;502787;61454;88.1;87.2;10.7
63;2021-11-21;10;15;68;508179;502802;61522;88.1;87.2;10.7
63;2021-11-22;94;79;2184;508273;502881;63706;88.1;87.2;11.0
63;2021-11-23;105;109;2575;508378;502990;66281;88.1;87.2;11.5
63;2021-11-24;178;190;2376;508556;503180;68657;88.2;87.2;11.9
63;2021-11-25;113;128;2924;508669;503308;71581;88.2;87.2;12.4
63;2021-11-26;181;177;5151;508850;503485;76732;88.2;87.3;13.3
63;2021-11-27;87;71;2393;508937;503556;79125;88.2;87.3;13.7
63;2021-11-28;26;19;991;508963;503575;80116;88.2;87.3;13.9
63;2021-11-29;104;111;4927;509067;503686;85043;88.2;87.3;14.7
63;2021-11-30;116;115;5793;509183;503801;90836;88.3;87.3;15.7
63;2021-12-01;120;155;5877;509303;503956;96713;88.3;87.4;16.8
63;2021-12-02;118;100;6608;509421;504056;103321;88.3;87.4;17.9
63;2021-12-03;118;171;7269;509539;504227;110590;88.3;87.4;19.2
63;2021-12-04;53;103;3505;509592;504330;114095;88.3;87.4;19.8
63;2021-12-05;12;21;1254;509604;504351;115349;88.3;87.4;20.0
63;2021-12-06;105;96;6658;509709;504447;122007;88.4;87.4;21.1
63;2021-12-07;83;127;7988;509792;504574;129995;88.4;87.5;22.5
63;2021-12-08;128;186;6769;509920;504760;136764;88.4;87.5;23.7
63;2021-12-09;90;127;7434;510010;504887;144198;88.4;87.5;25.0
63;2021-12-10;128;201;9030;510138;505088;153228;88.4;87.6;26.6
63;2021-12-11;84;95;4794;510222;505183;158022;88.4;87.6;27.4
63;2021-12-12;6;9;1221;510228;505192;159243;88.4;87.6;27.6
63;2021-12-13;83;128;7790;510311;505320;167033;88.5;87.6;29.0
63;2021-12-14;127;140;9721;510438;505460;176754;88.5;87.6;30.6
63;2021-12-15;140;193;7960;510578;505653;184714;88.5;87.7;32.0
63;2021-12-16;118;138;9090;510696;505791;193804;88.5;87.7;33.6
63;2021-12-17;162;235;10175;510858;506026;203979;88.6;87.7;35.4
63;2021-12-18;107;104;5825;510965;506130;209804;88.6;87.7;36.4
63;2021-12-19;30;35;1405;510995;506165;211209;88.6;87.7;36.6
64;2020-12-27;1;0;0;1;0;0;0.0;0.0;0.0
64;2020-12-28;2;0;0;3;0;0;0.0;0.0;0.0
64;2020-12-29;0;0;0;3;0;0;0.0;0.0;0.0
64;2020-12-30;0;0;0;3;0;0;0.0;0.0;0.0
64;2020-12-31;0;0;0;3;0;0;0.0;0.0;0.0
64;2021-01-01;1;0;0;4;0;0;0.0;0.0;0.0
64;2021-01-02;0;0;0;4;0;0;0.0;0.0;0.0
64;2021-01-03;0;0;0;4;0;0;0.0;0.0;0.0
64;2021-01-04;28;0;0;32;0;0;0.0;0.0;0.0
64;2021-01-05;24;0;0;56;0;0;0.0;0.0;0.0
64;2021-01-06;186;0;0;242;0;0;0.0;0.0;0.0
64;2021-01-07;808;1;0;1050;1;0;0.2;0.0;0.0
64;2021-01-08;832;2;0;1882;3;0;0.3;0.0;0.0
64;2021-01-09;54;0;0;1936;3;0;0.3;0.0;0.0
64;2021-01-10;2;0;0;1938;3;0;0.3;0.0;0.0
64;2021-01-11;515;0;0;2453;3;0;0.4;0.0;0.0
64;2021-01-12;724;3;0;3177;6;0;0.5;0.0;0.0
64;2021-01-13;841;2;0;4018;8;0;0.7;0.0;0.0
64;2021-01-14;992;5;0;5010;13;0;0.8;0.0;0.0
64;2021-01-15;903;5;0;5913;18;0;1.0;0.0;0.0
64;2021-01-16;76;0;0;5989;18;0;1.0;0.0;0.0
64;2021-01-17;3;1;0;5992;19;0;1.0;0.0;0.0
64;2021-01-18;913;7;0;6905;26;0;1.2;0.0;0.0
64;2021-01-19;1422;4;0;8327;30;0;1.4;0.0;0.0
64;2021-01-20;1553;3;0;9880;33;0;1.6;0.0;0.0
64;2021-01-21;2470;4;0;12350;37;0;2.1;0.0;0.0
64;2021-01-22;1531;3;0;13881;40;0;2.3;0.0;0.0
64;2021-01-23;481;1;0;14362;41;0;2.4;0.0;0.0
64;2021-01-24;59;0;0;14421;41;0;2.4;0.0;0.0
64;2021-01-25;915;7;0;15336;48;0;2.6;0.0;0.0
64;2021-01-26;1284;21;0;16620;69;0;2.8;0.0;0.0
64;2021-01-27;1198;119;0;17818;188;0;3.0;0.0;0.0
64;2021-01-28;1606;604;0;19424;792;0;3.2;0.1;0.0
64;2021-01-29;943;597;0;20367;1389;0;3.4;0.2;0.0
64;2021-01-30;445;58;0;20812;1447;0;3.5;0.2;0.0
64;2021-01-31;76;0;0;20888;1447;0;3.5;0.2;0.0
64;2021-02-01;647;305;0;21535;1752;0;3.6;0.3;0.0
64;2021-02-02;1113;537;0;22648;2289;0;3.8;0.4;0.0
64;2021-02-03;1023;633;0;23671;2922;0;3.9;0.5;0.0
64;2021-02-04;1021;544;0;24692;3466;0;4.1;0.6;0.0
64;2021-02-05;801;458;0;25493;3924;0;4.2;0.7;0.0
64;2021-02-06;488;34;0;25981;3958;0;4.3;0.7;0.0
64;2021-02-07;104;5;0;26085;3963;0;4.3;0.7;0.0
64;2021-02-08;716;308;0;26801;4271;0;4.5;0.7;0.0
64;2021-02-09;886;712;0;27687;4983;0;4.6;0.8;0.0
64;2021-02-10;870;747;0;28557;5730;0;4.8;1.0;0.0
64;2021-02-11;1134;1488;0;29691;7218;0;4.9;1.2;0.0
64;2021-02-12;1018;1001;0;30709;8219;0;5.1;1.4;0.0
64;2021-02-13;239;302;0;30948;8521;0;5.2;1.4;0.0
64;2021-02-14;34;40;0;30982;8561;0;5.2;1.4;0.0
64;2021-02-15;213;1095;0;31195;9656;0;5.2;1.6;0.0
64;2021-02-16;276;1357;0;31471;11013;0;5.2;1.8;0.0
64;2021-02-17;303;1200;0;31774;12213;0;5.3;2.0;0.0
64;2021-02-18;491;1603;0;32265;13816;0;5.4;2.3;0.0
64;2021-02-19;417;1238;0;32682;15054;0;5.4;2.5;0.0
64;2021-02-20;114;406;0;32796;15460;0;5.5;2.6;0.0
64;2021-02-21;17;68;0;32813;15528;0;5.5;2.6;0.0
64;2021-02-22;428;928;0;33241;16456;0;5.5;2.7;0.0
64;2021-02-23;676;1095;0;33917;17551;0;5.6;2.9;0.0
64;2021-02-24;718;984;0;34635;18535;0;5.8;3.1;0.0
64;2021-02-25;1060;921;0;35695;19456;0;5.9;3.2;0.0
64;2021-02-26;1168;880;0;36863;20336;0;6.1;3.4;0.0
64;2021-02-27;833;375;0;37696;20711;0;6.3;3.4;0.0
64;2021-02-28;42;61;0;37738;20772;0;6.3;3.5;0.0
64;2021-03-01;736;780;0;38474;21552;0;6.4;3.6;0.0
64;2021-03-02;1041;892;0;39515;22444;0;6.6;3.7;0.0
64;2021-03-03;1215;938;0;40730;23382;0;6.8;3.9;0.0
64;2021-03-04;1839;1114;0;42569;24496;0;7.1;4.1;0.0
64;2021-03-05;2118;1024;0;44687;25520;0;7.4;4.3;0.0
64;2021-03-06;1484;515;0;46171;26035;0;7.7;4.3;0.0
64;2021-03-07;585;91;0;46756;26126;0;7.8;4.4;0.0
64;2021-03-08;1459;732;0;48215;26858;0;8.0;4.5;0.0
64;2021-03-09;2030;824;0;50245;27682;0;8.4;4.6;0.0
64;2021-03-10;2048;711;0;52293;28393;0;8.7;4.7;0.0
64;2021-03-11;2867;1055;0;55160;29448;0;9.2;4.9;0.0
64;2021-03-12;3314;607;0;58474;30055;0;9.7;5.0;0.0
64;2021-03-13;2100;192;0;60574;30247;0;10.1;5.0;0.0
64;2021-03-14;209;17;0;60783;30264;0;10.1;5.0;0.0
64;2021-03-15;2212;234;0;62995;30498;0;10.5;5.1;0.0
64;2021-03-16;1935;262;0;64930;30760;0;10.8;5.1;0.0
64;2021-03-17;1985;271;0;66915;31031;0;11.1;5.2;0.0
64;2021-03-18;2312;232;0;69227;31263;0;11.5;5.2;0.0
64;2021-03-19;2901;287;0;72128;31550;0;12.0;5.3;0.0
64;2021-03-20;2287;94;0;74415;31644;0;12.4;5.3;0.0
64;2021-03-21;1170;25;0;75585;31669;0;12.6;5.3;0.0
64;2021-03-22;2430;537;0;78015;32206;0;13.0;5.4;0.0
64;2021-03-23;3039;625;0;81054;32831;0;13.5;5.5;0.0
64;2021-03-24;3353;668;0;84407;33499;0;14.1;5.6;0.0
64;2021-03-25;4135;773;0;88542;34272;0;14.7;5.7;0.0
64;2021-03-26;4215;650;0;92757;34922;0;15.5;5.8;0.0
64;2021-03-27;2870;405;0;95627;35327;0;15.9;5.9;0.0
64;2021-03-28;418;67;0;96045;35394;0;16.0;5.9;0.0
64;2021-03-29;2919;859;0;98964;36253;0;16.5;6.0;0.0
64;2021-03-30;3967;862;0;102931;37115;0;17.1;6.2;0.0
64;2021-03-31;3443;761;0;106374;37876;0;17.7;6.3;0.0
64;2021-04-01;4517;906;0;110891;38782;0;18.5;6.5;0.0
64;2021-04-02;4234;708;0;115125;39490;0;19.2;6.6;0.0
64;2021-04-03;1978;547;0;117103;40037;0;19.5;6.7;0.0
64;2021-04-04;258;40;0;117361;40077;0;19.5;6.7;0.0
64;2021-04-05;1500;117;0;118861;40194;0;19.8;6.7;0.0
64;2021-04-06;3512;1343;0;122373;41537;0;20.4;6.9;0.0
64;2021-04-07;3843;1444;0;126216;42981;0;21.0;7.2;0.0
64;2021-04-08;4994;1508;0;131210;44489;0;21.9;7.4;0.0
64;2021-04-09;5652;1607;0;136862;46096;0;22.8;7.7;0.0
64;2021-04-10;3084;982;0;139946;47078;0;23.3;7.8;0.0
64;2021-04-11;389;218;0;140335;47296;0;23.4;7.9;0.0
64;2021-04-12;3874;1778;0;144209;49074;0;24.0;8.2;0.0
64;2021-04-13;4218;2053;0;148427;51127;0;24.7;8.5;0.0
64;2021-04-14;3919;2010;0;152346;53137;0;25.4;8.9;0.0
64;2021-04-15;4147;2147;0;156493;55284;0;26.1;9.2;0.0
64;2021-04-16;4128;2168;0;160621;57452;0;26.8;9.6;0.0
64;2021-04-17;2427;1375;0;163048;58827;0;27.2;9.8;0.0
64;2021-04-18;993;1077;0;164041;59904;0;27.3;10.0;0.0
64;2021-04-19;2567;2318;0;166608;62222;0;27.8;10.4;0.0
64;2021-04-20;3035;2307;0;169643;64529;0;28.3;10.7;0.0
64;2021-04-21;2961;2479;0;172604;67008;0;28.7;11.2;0.0
64;2021-04-22;3236;2619;0;175840;69627;0;29.3;11.6;0.0
64;2021-04-23;3150;2506;0;178990;72133;0;29.8;12.0;0.0
64;2021-04-24;1909;1497;0;180899;73630;0;30.1;12.3;0.0
64;2021-04-25;244;196;0;181143;73826;0;30.2;12.3;0.0
64;2021-04-26;2466;2593;0;183609;76419;0;30.6;12.7;0.0
64;2021-04-27;2809;2995;0;186418;79414;0;31.1;13.2;0.0
64;2021-04-28;3361;2840;0;189779;82254;0;31.6;13.7;0.0
64;2021-04-29;4391;3332;0;194170;85586;0;32.3;14.3;0.0
64;2021-04-30;3848;3458;0;198018;89044;0;33.0;14.8;0.0
64;2021-05-01;1437;970;0;199455;90014;0;33.2;15.0;0.0
64;2021-05-02;428;300;0;199883;90314;0;33.3;15.0;0.0
64;2021-05-03;2742;3348;0;202625;93662;0;33.8;15.6;0.0
64;2021-05-04;3441;3789;0;206066;97451;0;34.3;16.2;0.0
64;2021-05-05;3134;3897;0;209200;101348;0;34.8;16.9;0.0
64;2021-05-06;3844;3837;0;213044;105185;0;35.5;17.5;0.0
64;2021-05-07;3692;4021;0;216736;109206;0;36.1;18.2;0.0
64;2021-05-08;2497;1184;0;219233;110390;0;36.5;18.4;0.0
64;2021-05-09;643;276;0;219876;110666;0;36.6;18.4;0.0
64;2021-05-10;2670;3981;0;222546;114647;0;37.1;19.1;0.0
64;2021-05-11;3860;3874;0;226406;118521;0;37.7;19.7;0.0
64;2021-05-12;4224;3776;0;230630;122297;0;38.4;20.4;0.0
64;2021-05-13;2881;827;0;233511;123124;0;38.9;20.5;0.0
64;2021-05-14;4711;2933;0;238222;126057;0;39.7;21.0;0.0
64;2021-05-15;3287;1717;0;241509;127774;0;40.2;21.3;0.0
64;2021-05-16;590;189;0;242099;127963;0;40.3;21.3;0.0
64;2021-05-17;3918;2262;0;246017;130225;0;41.0;21.7;0.0
64;2021-05-18;4830;2189;0;250847;132414;0;41.8;22.1;0.0
64;2021-05-19;4696;2048;0;255543;134462;0;42.6;22.4;0.0
64;2021-05-20;5224;2023;0;260767;136485;0;43.4;22.7;0.0
64;2021-05-21;5028;2130;0;265795;138615;0;44.3;23.1;0.0
64;2021-05-22;3281;1370;0;269076;139985;0;44.8;23.3;0.0
64;2021-05-23;413;169;0;269489;140154;0;44.9;23.3;0.0
64;2021-05-24;2766;1048;0;272255;141202;0;45.3;23.5;0.0
64;2021-05-25;4033;2646;0;276288;143848;0;46.0;24.0;0.0
64;2021-05-26;4170;2601;0;280458;146449;0;46.7;24.4;0.0
64;2021-05-27;5035;3056;0;285493;149505;0;47.6;24.9;0.0
64;2021-05-28;4312;3218;0;289805;152723;0;48.3;25.4;0.0
64;2021-05-29;2653;2010;0;292458;154733;0;48.7;25.8;0.0
64;2021-05-30;389;186;0;292847;154919;0;48.8;25.8;0.0
64;2021-05-31;3661;3401;0;296508;158320;0;49.4;26.4;0.0
64;2021-06-01;5064;3323;0;301572;161643;0;50.2;26.9;0.0
64;2021-06-02;4706;2990;0;306278;164633;0;51.0;27.4;0.0
64;2021-06-03;5864;3100;0;312142;167733;0;52.0;27.9;0.0
64;2021-06-04;4816;4331;0;316958;172064;0;52.8;28.7;0.0
64;2021-06-05;3096;2380;0;320054;174444;0;53.3;29.1;0.0
64;2021-06-06;1773;285;0;321827;174729;0;53.6;29.1;0.0
64;2021-06-07;3717;4133;0;325544;178862;0;54.2;29.8;0.0
64;2021-06-08;4641;3873;0;330185;182735;0;55.0;30.4;0.0
64;2021-06-09;4719;3325;0;334904;186060;0;55.8;31.0;0.0
64;2021-06-10;5558;3003;0;340462;189063;0;56.7;31.5;0.0
64;2021-06-11;5068;4570;0;345530;193633;0;57.6;32.3;0.0
64;2021-06-12;3499;2134;0;349029;195767;0;58.1;32.6;0.0
64;2021-06-13;1402;331;0;350431;196098;0;58.4;32.7;0.0
64;2021-06-14;3298;4483;0;353729;200581;0;58.9;33.4;0.0
64;2021-06-15;4172;4395;0;357901;204976;0;59.6;34.1;0.0
64;2021-06-16;4125;4414;0;362026;209390;0;60.3;34.9;0.0
64;2021-06-17;3283;3995;0;365309;213385;0;60.8;35.5;0.0
64;2021-06-18;4039;4820;0;369348;218205;0;61.5;36.3;0.0
64;2021-06-19;2660;3053;0;372008;221258;0;62.0;36.9;0.0
64;2021-06-20;762;478;0;372770;221736;0;62.1;36.9;0.0
64;2021-06-21;2040;4722;0;374810;226458;0;62.4;37.7;0.0
64;2021-06-22;2336;5354;0;377146;231812;0;62.8;38.6;0.0
64;2021-06-23;2811;5115;0;379957;236927;0;63.3;39.5;0.0
64;2021-06-24;2485;3568;0;382442;240495;0;63.7;40.1;0.0
64;2021-06-25;2504;6008;0;384946;246503;0;64.1;41.1;0.0
64;2021-06-26;1564;3647;0;386510;250150;0;64.4;41.7;0.0
64;2021-06-27;409;735;0;386919;250885;0;64.4;41.8;0.0
64;2021-06-28;1687;5576;0;388606;256461;0;64.7;42.7;0.0
64;2021-06-29;1746;5856;0;390352;262317;0;65.0;43.7;0.0
64;2021-06-30;2030;5622;0;392382;267939;0;65.4;44.6;0.0
64;2021-07-01;2221;4962;0;394603;272901;0;65.7;45.5;0.0
64;2021-07-02;2147;5913;0;396750;278814;0;66.1;46.4;0.0
64;2021-07-03;1115;3556;0;397865;282370;0;66.3;47.0;0.0
64;2021-07-04;387;754;0;398252;283124;0;66.3;47.2;0.0
64;2021-07-05;1254;5039;0;399506;288163;0;66.5;48.0;0.0
64;2021-07-06;1905;5916;1;401411;294079;1;66.9;49.0;0.0
64;2021-07-07;1935;5422;0;403346;299501;1;67.2;49.9;0.0
64;2021-07-08;1658;4044;0;405004;303545;1;67.5;50.6;0.0
64;2021-07-09;1768;6038;0;406772;309583;1;67.8;51.6;0.0
64;2021-07-10;1140;3574;0;407912;313157;1;67.9;52.2;0.0
64;2021-07-11;238;741;0;408150;313898;1;68.0;52.3;0.0
64;2021-07-12;1392;5690;0;409542;319588;1;68.2;53.2;0.0
64;2021-07-13;2280;6714;0;411822;326302;1;68.6;54.4;0.0
64;2021-07-14;2170;2924;0;413992;329226;1;69.0;54.8;0.0
64;2021-07-15;2157;4960;0;416149;334186;1;69.3;55.7;0.0
64;2021-07-16;2790;6200;0;418939;340386;1;69.8;56.7;0.0
64;2021-07-17;2242;4039;0;421181;344425;1;70.2;57.4;0.0
64;2021-07-18;650;1790;0;421831;346215;1;70.3;57.7;0.0
64;2021-07-19;2392;5543;0;424223;351758;1;70.7;58.6;0.0
64;2021-07-20;3208;6032;0;427431;357790;1;71.2;59.6;0.0
64;2021-07-21;3457;5440;0;430888;363230;1;71.8;60.5;0.0
64;2021-07-22;3962;5154;0;434850;368384;1;72.4;61.4;0.0
64;2021-07-23;3752;5082;0;438602;373466;1;73.1;62.2;0.0
64;2021-07-24;2607;3964;0;441209;377430;1;73.5;62.9;0.0
64;2021-07-25;730;841;0;441939;378271;1;73.6;63.0;0.0
64;2021-07-26;2930;4498;0;444869;382769;1;74.1;63.8;0.0
64;2021-07-27;4101;4667;0;448970;387436;1;74.8;64.5;0.0
64;2021-07-28;4103;4065;0;453073;391501;1;75.5;65.2;0.0
64;2021-07-29;5211;3336;0;458284;394837;1;76.3;65.8;0.0
64;2021-07-30;4743;3761;0;463027;398598;1;77.1;66.4;0.0
64;2021-07-31;3088;2970;0;466115;401568;1;77.6;66.9;0.0
64;2021-08-01;886;398;0;467001;401966;1;77.8;67.0;0.0
64;2021-08-02;3837;2238;0;470838;404204;1;78.4;67.3;0.0
64;2021-08-03;4037;2740;0;474875;406944;1;79.1;67.8;0.0
64;2021-08-04;3758;2591;0;478633;409535;1;79.7;68.2;0.0
64;2021-08-05;3673;2266;0;482306;411801;1;80.3;68.6;0.0
64;2021-08-06;3436;2816;0;485742;414617;1;80.9;69.1;0.0
64;2021-08-07;2171;2310;0;487913;416927;1;81.3;69.4;0.0
64;2021-08-08;378;464;0;488291;417391;1;81.3;69.5;0.0
64;2021-08-09;2393;2736;0;490684;420127;1;81.7;70.0;0.0
64;2021-08-10;2954;3082;0;493638;423209;1;82.2;70.5;0.0
64;2021-08-11;2750;2893;0;496388;426102;1;82.7;71.0;0.0
64;2021-08-12;2800;2972;0;499188;429074;1;83.1;71.5;0.0
64;2021-08-13;2297;3360;0;501485;432434;1;83.5;72.0;0.0
64;2021-08-14;1482;2457;0;502967;434891;1;83.8;72.4;0.0
64;2021-08-15;173;552;0;503140;435443;1;83.8;72.5;0.0
64;2021-08-16;1898;3010;0;505038;438453;1;84.1;73.0;0.0
64;2021-08-17;2056;3562;0;507094;442015;1;84.5;73.6;0.0
64;2021-08-18;1801;3264;0;508895;445279;1;84.8;74.2;0.0
64;2021-08-19;1738;3300;0;510633;448579;1;85.1;74.7;0.0
64;2021-08-20;1423;3750;0;512056;452329;1;85.3;75.3;0.0
64;2021-08-21;881;2666;0;512937;454995;1;85.4;75.8;0.0
64;2021-08-22;135;777;0;513072;455772;1;85.5;75.9;0.0
64;2021-08-23;1118;3007;0;514190;458779;1;85.6;76.4;0.0
64;2021-08-24;1274;4302;0;515464;463081;1;85.9;77.1;0.0
64;2021-08-25;1173;3572;0;516637;466653;1;86.1;77.7;0.0
64;2021-08-26;988;3455;0;517625;470108;1;86.2;78.3;0.0
64;2021-08-27;1077;3985;1;518702;474093;2;86.4;79.0;0.0
64;2021-08-28;676;2333;0;519378;476426;2;86.5;79.4;0.0
64;2021-08-29;90;477;0;519468;476903;2;86.5;79.4;0.0
64;2021-08-30;857;3300;84;520325;480203;86;86.7;80.0;0.0
64;2021-08-31;914;3528;181;521239;483731;267;86.8;80.6;0.0
64;2021-09-01;917;2840;275;522156;486571;542;87.0;81.0;0.1
64;2021-09-02;854;2681;413;523010;489252;955;87.1;81.5;0.2
64;2021-09-03;838;2577;436;523848;491829;1391;87.3;81.9;0.2
64;2021-09-04;653;1999;166;524501;493828;1557;87.4;82.3;0.3
64;2021-09-05;68;198;51;524569;494026;1608;87.4;82.3;0.3
64;2021-09-06;509;1994;422;525078;496020;2030;87.5;82.6;0.3
64;2021-09-07;630;1814;456;525708;497834;2486;87.6;82.9;0.4
64;2021-09-08;716;2375;280;526424;500209;2766;87.7;83.3;0.5
64;2021-09-09;462;1565;423;526886;501774;3189;87.8;83.6;0.5
64;2021-09-10;688;1923;398;527574;503697;3587;87.9;83.9;0.6
64;2021-09-11;546;1899;152;528120;505596;3739;88.0;84.2;0.6
64;2021-09-12;60;158;37;528180;505754;3776;88.0;84.2;0.6
64;2021-09-13;444;1257;494;528624;507011;4270;88.0;84.5;0.7
64;2021-09-14;434;1016;915;529058;508027;5185;88.1;84.6;0.9
64;2021-09-15;648;1609;647;529706;509636;5832;88.2;84.9;1.0
64;2021-09-16;462;790;936;530168;510426;6768;88.3;85.0;1.1
64;2021-09-17;521;1218;943;530689;511644;7711;88.4;85.2;1.3
64;2021-09-18;305;1160;212;530994;512804;7923;88.4;85.4;1.3
64;2021-09-19;18;45;13;531012;512849;7936;88.4;85.4;1.3
64;2021-09-20;224;445;567;531236;513294;8503;88.5;85.5;1.4
64;2021-09-21;384;882;954;531620;514176;9457;88.5;85.6;1.6
64;2021-09-22;354;1357;726;531974;515533;10183;88.6;85.9;1.7
64;2021-09-23;241;684;752;532215;516217;10935;88.6;86.0;1.8
64;2021-09-24;379;956;694;532594;517173;11629;88.7;86.1;1.9
64;2021-09-25;281;953;185;532875;518126;11814;88.8;86.3;2.0
64;2021-09-26;6;18;9;532881;518144;11823;88.8;86.3;2.0
64;2021-09-27;213;523;494;533094;518667;12317;88.8;86.4;2.1
64;2021-09-28;253;625;732;533347;519292;13049;88.8;86.5;2.2
64;2021-09-29;327;936;765;533674;520228;13814;88.9;86.7;2.3
64;2021-09-30;219;396;666;533893;520624;14480;88.9;86.7;2.4
64;2021-10-01;345;685;736;534238;521309;15216;89.0;86.8;2.5
64;2021-10-02;228;514;173;534466;521823;15389;89.0;86.9;2.6
64;2021-10-03;7;19;3;534473;521842;15392;89.0;86.9;2.6
64;2021-10-04;293;403;670;534766;522245;16062;89.1;87.0;2.7
64;2021-10-05;248;543;779;535014;522788;16841;89.1;87.1;2.8
64;2021-10-06;407;882;757;535421;523670;17598;89.2;87.2;2.9
64;2021-10-07;204;479;855;535625;524149;18453;89.2;87.3;3.1
64;2021-10-08;336;674;944;535961;524823;19397;89.3;87.4;3.2
64;2021-10-09;217;376;222;536178;525199;19619;89.3;87.5;3.3
64;2021-10-10;3;2;6;536181;525201;19625;89.3;87.5;3.3
64;2021-10-11;144;230;528;536325;525431;20153;89.3;87.5;3.4
64;2021-10-12;216;521;1100;536541;525952;21253;89.4;87.6;3.5
64;2021-10-13;321;543;987;536862;526495;22240;89.4;87.7;3.7
64;2021-10-14;189;265;765;537051;526760;23005;89.5;87.7;3.8
64;2021-10-15;302;506;1126;537353;527266;24131;89.5;87.8;4.0
64;2021-10-16;177;267;282;537530;527533;24413;89.5;87.9;4.1
64;2021-10-17;15;10;9;537545;527543;24422;89.5;87.9;4.1
64;2021-10-18;120;259;603;537665;527802;25025;89.6;87.9;4.2
64;2021-10-19;194;321;1109;537859;528123;26134;89.6;88.0;4.4
64;2021-10-20;323;410;1376;538182;528533;27510;89.6;88.0;4.6
64;2021-10-21;184;268;1347;538366;528801;28857;89.7;88.1;4.8
64;2021-10-22;237;389;1296;538603;529190;30153;89.7;88.1;5.0
64;2021-10-23;174;238;442;538777;529428;30595;89.7;88.2;5.1
64;2021-10-24;3;18;5;538780;529446;30600;89.7;88.2;5.1
64;2021-10-25;129;170;847;538909;529616;31447;89.8;88.2;5.2
64;2021-10-26;223;309;1395;539132;529925;32842;89.8;88.3;5.5
64;2021-10-27;251;385;1552;539383;530310;34394;89.8;88.3;5.7
64;2021-10-28;143;175;1323;539526;530485;35717;89.9;88.4;5.9
64;2021-10-29;233;324;1605;539759;530809;37322;89.9;88.4;6.2
64;2021-10-30;143;210;515;539902;531019;37837;89.9;88.4;6.3
64;2021-10-31;1;7;33;539903;531026;37870;89.9;88.5;6.3
64;2021-11-01;48;37;71;539951;531063;37941;89.9;88.5;6.3
64;2021-11-02;180;286;1480;540131;531349;39421;90.0;88.5;6.6
64;2021-11-03;234;356;1760;540365;531705;41181;90.0;88.6;6.9
64;2021-11-04;156;214;1436;540521;531919;42617;90.0;88.6;7.1
64;2021-11-05;221;324;1920;540742;532243;44537;90.1;88.7;7.4
64;2021-11-06;147;198;664;540889;532441;45201;90.1;88.7;7.5
64;2021-11-07;3;18;12;540892;532459;45213;90.1;88.7;7.5
64;2021-11-08;113;161;1411;541005;532620;46624;90.1;88.7;7.8
64;2021-11-09;183;269;2627;541188;532889;49251;90.1;88.8;8.2
64;2021-11-10;251;331;2365;541439;533220;51616;90.2;88.8;8.6
64;2021-11-11;27;31;144;541466;533251;51760;90.2;88.8;8.6
64;2021-11-12;240;290;2535;541706;533541;54295;90.2;88.9;9.0
64;2021-11-13;138;208;927;541844;533749;55222;90.3;88.9;9.2
64;2021-11-14;3;8;21;541847;533757;55243;90.3;88.9;9.2
64;2021-11-15;116;127;1674;541963;533884;56917;90.3;88.9;9.5
64;2021-11-16;217;258;3066;542180;534142;59983;90.3;89.0;10.0
64;2021-11-17;247;291;2625;542427;534433;62608;90.3;89.0;10.4
64;2021-11-18;186;215;2692;542613;534648;65300;90.4;89.1;10.9
64;2021-11-19;229;285;3028;542842;534933;68328;90.4;89.1;11.4
64;2021-11-20;228;199;951;543070;535132;69279;90.5;89.1;11.5
64;2021-11-21;1;10;19;543071;535142;69298;90.5;89.1;11.5
64;2021-11-22;146;123;2336;543217;535265;71634;90.5;89.2;11.9
64;2021-11-23;255;236;3452;543472;535501;75086;90.5;89.2;12.5
64;2021-11-24;226;254;2936;543698;535755;78022;90.6;89.2;13.0
64;2021-11-25;284;210;4400;543982;535965;82422;90.6;89.3;13.7
64;2021-11-26;234;288;4231;544216;536253;86653;90.6;89.3;14.4
64;2021-11-27;175;210;1953;544391;536463;88606;90.7;89.4;14.8
64;2021-11-28;14;12;466;544405;536475;89072;90.7;89.4;14.8
64;2021-11-29;152;163;4101;544557;536638;93173;90.7;89.4;15.5
64;2021-11-30;221;228;6035;544778;536866;99208;90.7;89.4;16.5
64;2021-12-01;183;264;5302;544961;537130;104510;90.8;89.5;17.4
64;2021-12-02;173;170;6575;545134;537300;111085;90.8;89.5;18.5
64;2021-12-03;197;257;6884;545331;537557;117969;90.8;89.5;19.6
64;2021-12-04;155;189;3511;545486;537746;121480;90.9;89.6;20.2
64;2021-12-05;25;25;1196;545511;537771;122676;90.9;89.6;20.4
64;2021-12-06;152;168;5651;545663;537939;128327;90.9;89.6;21.4
64;2021-12-07;167;232;7711;545830;538171;136038;90.9;89.6;22.7
64;2021-12-08;193;290;7044;546023;538461;143082;90.9;89.7;23.8
64;2021-12-09;217;200;8259;546240;538661;151341;91.0;89.7;25.2
64;2021-12-10;243;277;9269;546483;538938;160610;91.0;89.8;26.8
64;2021-12-11;152;242;4669;546635;539180;165279;91.0;89.8;27.5
64;2021-12-12;26;28;2273;546661;539208;167552;91.1;89.8;27.9
64;2021-12-13;140;195;7142;546801;539403;174694;91.1;89.8;29.1
64;2021-12-14;234;309;10115;547035;539712;184809;91.1;89.9;30.8
64;2021-12-15;240;279;8867;547275;539991;193676;91.2;89.9;32.3
64;2021-12-16;228;297;10573;547503;540288;204249;91.2;90.0;34.0
64;2021-12-17;268;336;10599;547771;540624;214848;91.2;90.0;35.8
64;2021-12-18;159;223;5366;547930;540847;220214;91.3;90.1;36.7
64;2021-12-19;33;50;2258;547963;540897;222472;91.3;90.1;37.1
65;2020-12-27;0;0;0;0;0;0;0.0;0.0;0.0
65;2020-12-28;1;0;0;1;0;0;0.0;0.0;0.0
65;2020-12-29;0;0;0;1;0;0;0.0;0.0;0.0
65;2020-12-30;0;0;0;1;0;0;0.0;0.0;0.0
65;2020-12-31;0;0;0;1;0;0;0.0;0.0;0.0
65;2021-01-01;0;0;0;1;0;0;0.0;0.0;0.0
65;2021-01-02;0;0;0;1;0;0;0.0;0.0;0.0
65;2021-01-03;0;0;0;1;0;0;0.0;0.0;0.0
65;2021-01-04;0;0;0;1;0;0;0.0;0.0;0.0
65;2021-01-05;0;0;0;1;0;0;0.0;0.0;0.0
65;2021-01-06;8;0;0;9;0;0;0.0;0.0;0.0
65;2021-01-07;124;0;0;133;0;0;0.1;0.0;0.0
65;2021-01-08;183;1;0;316;1;0;0.2;0.0;0.0
65;2021-01-09;175;2;0;491;3;0;0.2;0.0;0.0
65;2021-01-10;1;0;0;492;3;0;0.2;0.0;0.0
65;2021-01-11;250;3;0;742;6;0;0.4;0.0;0.0
65;2021-01-12;260;2;0;1002;8;0;0.5;0.0;0.0
65;2021-01-13;563;1;0;1565;9;0;0.8;0.0;0.0
65;2021-01-14;556;9;0;2121;18;0;1.0;0.0;0.0
65;2021-01-15;490;2;0;2611;20;0;1.3;0.0;0.0
65;2021-01-16;206;3;0;2817;23;0;1.4;0.0;0.0
65;2021-01-17;0;0;0;2817;23;0;1.4;0.0;0.0
65;2021-01-18;541;5;0;3358;28;0;1.7;0.0;0.0
65;2021-01-19;543;2;0;3901;30;0;1.9;0.0;0.0
65;2021-01-20;572;5;0;4473;35;0;2.2;0.0;0.0
65;2021-01-21;548;1;0;5021;36;0;2.5;0.0;0.0
65;2021-01-22;573;2;0;5594;38;0;2.8;0.0;0.0
65;2021-01-23;176;1;0;5770;39;0;2.9;0.0;0.0
65;2021-01-24;3;1;0;5773;40;0;2.9;0.0;0.0
65;2021-01-25;537;5;0;6310;45;0;3.1;0.0;0.0
65;2021-01-26;808;2;0;7118;47;0;3.5;0.0;0.0
65;2021-01-27;564;8;0;7682;55;0;3.8;0.0;0.0
65;2021-01-28;479;35;0;8161;90;0;4.0;0.0;0.0
65;2021-01-29;404;67;0;8565;157;0;4.2;0.1;0.0
65;2021-01-30;175;67;0;8740;224;0;4.3;0.1;0.0
65;2021-01-31;16;0;0;8756;224;0;4.3;0.1;0.0
65;2021-02-01;316;98;0;9072;322;0;4.5;0.2;0.0
65;2021-02-02;347;182;0;9419;504;0;4.7;0.2;0.0
65;2021-02-03;438;240;0;9857;744;0;4.9;0.4;0.0
65;2021-02-04;287;297;0;10144;1041;0;5.0;0.5;0.0
65;2021-02-05;254;341;0;10398;1382;0;5.1;0.7;0.0
65;2021-02-06;93;97;0;10491;1479;0;5.2;0.7;0.0
65;2021-02-07;11;0;0;10502;1479;0;5.2;0.7;0.0
65;2021-02-08;373;207;0;10875;1686;0;5.4;0.8;0.0
65;2021-02-09;262;359;0;11137;2045;0;5.5;1.0;0.0
65;2021-02-10;284;273;0;11421;2318;0;5.7;1.1;0.0
65;2021-02-11;304;261;0;11725;2579;0;5.8;1.3;0.0
65;2021-02-12;261;214;0;11986;2793;0;5.9;1.4;0.0
65;2021-02-13;118;93;0;12104;2886;0;6.0;1.4;0.0
65;2021-02-14;2;17;0;12106;2903;0;6.0;1.4;0.0
65;2021-02-15;190;389;0;12296;3292;0;6.1;1.6;0.0
65;2021-02-16;440;553;0;12736;3845;0;6.3;1.9;0.0
65;2021-02-17;211;496;0;12947;4341;0;6.4;2.1;0.0
65;2021-02-18;268;563;0;13215;4904;0;6.5;2.4;0.0
65;2021-02-19;142;453;0;13357;5357;0;6.6;2.7;0.0
65;2021-02-20;54;153;0;13411;5510;0;6.6;2.7;0.0
65;2021-02-21;2;45;0;13413;5555;0;6.6;2.7;0.0
65;2021-02-22;162;519;0;13575;6074;0;6.7;3.0;0.0
65;2021-02-23;213;513;0;13788;6587;0;6.8;3.3;0.0
65;2021-02-24;209;601;0;13997;7188;0;6.9;3.6;0.0
65;2021-02-25;232;195;0;14229;7383;0;7.0;3.7;0.0
65;2021-02-26;323;725;0;14552;8108;0;7.2;4.0;0.0
65;2021-02-27;104;199;0;14656;8307;0;7.3;4.1;0.0
65;2021-02-28;1;0;0;14657;8307;0;7.3;4.1;0.0
65;2021-03-01;367;352;0;15024;8659;0;7.4;4.3;0.0
65;2021-03-02;407;339;0;15431;8998;0;7.6;4.5;0.0
65;2021-03-03;371;382;0;15802;9380;0;7.8;4.6;0.0
65;2021-03-04;638;311;0;16440;9691;0;8.1;4.8;0.0
65;2021-03-05;672;275;0;17112;9966;0;8.5;4.9;0.0
65;2021-03-06;1140;87;0;18252;10053;0;9.0;5.0;0.0
65;2021-03-07;240;12;0;18492;10065;0;9.1;5.0;0.0
65;2021-03-08;385;330;0;18877;10395;0;9.3;5.1;0.0
65;2021-03-09;599;295;0;19476;10690;0;9.6;5.3;0.0
65;2021-03-10;583;353;0;20059;11043;0;9.9;5.5;0.0
65;2021-03-11;747;337;0;20806;11380;0;10.3;5.6;0.0
65;2021-03-12;1016;192;0;21822;11572;0;10.8;5.7;0.0
65;2021-03-13;347;86;0;22169;11658;0;11.0;5.8;0.0
65;2021-03-14;5;31;0;22174;11689;0;11.0;5.8;0.0
65;2021-03-15;766;174;0;22940;11863;0;11.3;5.9;0.0
65;2021-03-16;677;216;0;23617;12079;0;11.7;6.0;0.0
65;2021-03-17;663;183;0;24280;12262;0;12.0;6.1;0.0
65;2021-03-18;504;227;0;24784;12489;0;12.3;6.2;0.0
65;2021-03-19;814;148;0;25598;12637;0;12.7;6.3;0.0
65;2021-03-20;248;47;0;25846;12684;0;12.8;6.3;0.0
65;2021-03-21;11;1;0;25857;12685;0;12.8;6.3;0.0
65;2021-03-22;684;149;0;26541;12834;0;13.1;6.3;0.0
65;2021-03-23;820;345;0;27361;13179;0;13.5;6.5;0.0
65;2021-03-24;824;244;0;28185;13423;0;13.9;6.6;0.0
65;2021-03-25;1196;178;0;29381;13601;0;14.5;6.7;0.0
65;2021-03-26;1211;134;0;30592;13735;0;15.1;6.8;0.0
65;2021-03-27;1231;89;0;31823;13824;0;15.7;6.8;0.0
65;2021-03-28;5;2;0;31828;13826;0;15.7;6.8;0.0
65;2021-03-29;1390;328;0;33218;14154;0;16.4;7.0;0.0
65;2021-03-30;1261;350;0;34479;14504;0;17.1;7.2;0.0
65;2021-03-31;1081;349;0;35560;14853;0;17.6;7.3;0.0
65;2021-04-01;1362;371;0;36922;15224;0;18.3;7.5;0.0
65;2021-04-02;1503;277;0;38425;15501;0;19.0;7.7;0.0
65;2021-04-03;228;47;0;38653;15548;0;19.1;7.7;0.0
65;2021-04-04;7;2;0;38660;15550;0;19.1;7.7;0.0
65;2021-04-05;155;46;0;38815;15596;0;19.2;7.7;0.0
65;2021-04-06;1130;455;0;39945;16051;0;19.8;7.9;0.0
65;2021-04-07;1538;412;0;41483;16463;0;20.5;8.1;0.0
65;2021-04-08;1466;382;0;42949;16845;0;21.2;8.3;0.0
65;2021-04-09;1471;440;0;44420;17285;0;22.0;8.6;0.0
65;2021-04-10;1412;146;0;45832;17431;0;22.7;8.6;0.0
65;2021-04-11;8;5;0;45840;17436;0;22.7;8.6;0.0
65;2021-04-12;1214;689;0;47054;18125;0;23.3;9.0;0.0
65;2021-04-13;1418;570;0;48472;18695;0;24.0;9.2;0.0
65;2021-04-14;1731;696;0;50203;19391;0;24.8;9.6;0.0
65;2021-04-15;1539;665;0;51742;20056;0;25.6;9.9;0.0
65;2021-04-16;1618;493;0;53360;20549;0;26.4;10.2;0.0
65;2021-04-17;1833;130;0;55193;20679;0;27.3;10.2;0.0
65;2021-04-18;11;32;0;55204;20711;0;27.3;10.2;0.0
65;2021-04-19;1205;711;0;56409;21422;0;27.9;10.6;0.0
65;2021-04-20;1397;677;0;57806;22099;0;28.6;10.9;0.0
65;2021-04-21;982;960;0;58788;23059;0;29.1;11.4;0.0
65;2021-04-22;1479;706;0;60267;23765;0;29.8;11.8;0.0
65;2021-04-23;1056;1019;0;61323;24784;0;30.3;12.3;0.0
65;2021-04-24;1151;551;0;62474;25335;0;30.9;12.5;0.0
65;2021-04-25;37;17;0;62511;25352;0;30.9;12.5;0.0
65;2021-04-26;1451;1151;0;63962;26503;0;31.6;13.1;0.0
65;2021-04-27;1325;1181;0;65287;27684;0;32.3;13.7;0.0
65;2021-04-28;1630;898;0;66917;28582;0;33.1;14.1;0.0
65;2021-04-29;1747;966;0;68664;29548;0;34.0;14.6;0.0
65;2021-04-30;1569;856;0;70233;30404;0;34.7;15.0;0.0
65;2021-05-01;1437;227;0;71670;30631;0;35.5;15.2;0.0
65;2021-05-02;608;24;0;72278;30655;0;35.8;15.2;0.0
65;2021-05-03;1160;1293;0;73438;31948;0;36.3;15.8;0.0
65;2021-05-04;1383;1102;0;74821;33050;0;37.0;16.4;0.0
65;2021-05-05;1187;1495;0;76008;34545;0;37.6;17.1;0.0
65;2021-05-06;1310;1096;0;77318;35641;0;38.3;17.6;0.0
65;2021-05-07;1103;1411;0;78421;37052;0;38.8;18.3;0.0
65;2021-05-08;1480;404;0;79901;37456;0;39.5;18.5;0.0
65;2021-05-09;11;92;0;79912;37548;0;39.5;18.6;0.0
65;2021-05-10;855;1661;0;80767;39209;0;40.0;19.4;0.0
65;2021-05-11;911;1648;0;81678;40857;0;40.4;20.2;0.0
65;2021-05-12;1043;1473;0;82721;42330;0;40.9;20.9;0.0
65;2021-05-13;1025;141;0;83746;42471;0;41.4;21.0;0.0
65;2021-05-14;1293;945;0;85039;43416;0;42.1;21.5;0.0
65;2021-05-15;1100;427;0;86139;43843;0;42.6;21.7;0.0
65;2021-05-16;1156;62;0;87295;43905;0;43.2;21.7;0.0
65;2021-05-17;954;1387;0;88249;45292;0;43.7;22.4;0.0
65;2021-05-18;1388;1054;0;89637;46346;0;44.3;22.9;0.0
65;2021-05-19;1429;912;0;91066;47258;0;45.1;23.4;0.0
65;2021-05-20;1582;909;0;92648;48167;0;45.8;23.8;0.0
65;2021-05-21;1456;950;0;94104;49117;0;46.6;24.3;0.0
65;2021-05-22;1099;620;0;95203;49737;0;47.1;24.6;0.0
65;2021-05-23;342;13;0;95545;49750;0;47.3;24.6;0.0
65;2021-05-24;531;71;0;96076;49821;0;47.5;24.6;0.0
65;2021-05-25;1209;1350;0;97285;51171;0;48.1;25.3;0.0
65;2021-05-26;1235;1240;0;98520;52411;0;48.7;25.9;0.0
65;2021-05-27;1227;1342;0;99747;53753;0;49.3;26.6;0.0
65;2021-05-28;1208;1544;0;100955;55297;0;49.9;27.4;0.0
65;2021-05-29;821;1346;0;101776;56643;0;50.4;28.0;0.0
65;2021-05-30;20;10;0;101796;56653;0;50.4;28.0;0.0
65;2021-05-31;1065;1205;0;102861;57858;0;50.9;28.6;0.0
65;2021-06-01;1420;925;0;104281;58783;0;51.6;29.1;0.0
65;2021-06-02;1241;986;0;105522;59769;0;52.2;29.6;0.0
65;2021-06-03;1116;1055;0;106638;60824;0;52.8;30.1;0.0
65;2021-06-04;1331;1439;0;107969;62263;0;53.4;30.8;0.0
65;2021-06-05;361;1134;0;108330;63397;0;53.6;31.4;0.0
65;2021-06-06;47;21;0;108377;63418;0;53.6;31.4;0.0
65;2021-06-07;621;1810;0;108998;65228;0;53.9;32.3;0.0
65;2021-06-08;843;1417;0;109841;66645;0;54.3;33.0;0.0
65;2021-06-09;780;1494;0;110621;68139;0;54.7;33.7;0.0
65;2021-06-10;764;1080;0;111385;69219;0;55.1;34.2;0.0
65;2021-06-11;834;1628;0;112219;70847;0;55.5;35.1;0.0
65;2021-06-12;187;603;0;112406;71450;0;55.6;35.3;0.0
65;2021-06-13;42;6;0;112448;71456;0;55.6;35.4;0.0
65;2021-06-14;503;2092;0;112951;73548;0;55.9;36.4;0.0
65;2021-06-15;901;1650;0;113852;75198;0;56.3;37.2;0.0
65;2021-06-16;1025;1253;0;114877;76451;0;56.8;37.8;0.0
65;2021-06-17;743;937;0;115620;77388;0;57.2;38.3;0.0
65;2021-06-18;954;1478;0;116574;78866;0;57.7;39.0;0.0
65;2021-06-19;629;1543;0;117203;80409;0;58.0;39.8;0.0
65;2021-06-20;14;9;0;117217;80418;0;58.0;39.8;0.0
65;2021-06-21;680;1684;0;117897;82102;0;58.3;40.6;0.0
65;2021-06-22;959;1316;0;118856;83418;0;58.8;41.3;0.0
65;2021-06-23;947;1098;0;119803;84516;0;59.3;41.8;0.0
65;2021-06-24;903;906;0;120706;85422;0;59.7;42.3;0.0
65;2021-06-25;805;1632;0;121511;87054;0;60.1;43.1;0.0
65;2021-06-26;174;1308;0;121685;88362;0;60.2;43.7;0.0
65;2021-06-27;24;903;0;121709;89265;0;60.2;44.2;0.0
65;2021-06-28;408;1906;0;122117;91171;0;60.4;45.1;0.0
65;2021-06-29;625;1694;0;122742;92865;0;60.7;45.9;0.0
65;2021-06-30;827;1478;0;123569;94343;0;61.1;46.7;0.0
65;2021-07-01;564;741;0;124133;95084;0;61.4;47.0;0.0
65;2021-07-02;1023;1500;0;125156;96584;0;61.9;47.8;0.0
65;2021-07-03;198;1468;0;125354;98052;0;62.0;48.5;0.0
65;2021-07-04;341;161;0;125695;98213;0;62.2;48.6;0.0
65;2021-07-05;516;1746;0;126211;99959;0;62.4;49.5;0.0
65;2021-07-06;722;1737;0;126933;101696;0;62.8;50.3;0.0
65;2021-07-07;802;1335;0;127735;103031;0;63.2;51.0;0.0
65;2021-07-08;368;648;0;128103;103679;0;63.4;51.3;0.0
65;2021-07-09;518;1388;0;128621;105067;0;63.6;52.0;0.0
65;2021-07-10;276;745;0;128897;105812;0;63.8;52.3;0.0
65;2021-07-11;14;15;0;128911;105827;0;63.8;52.4;0.0
65;2021-07-12;434;1794;0;129345;107621;0;64.0;53.2;0.0
65;2021-07-13;692;1766;0;130037;109387;0;64.3;54.1;0.0
65;2021-07-14;168;90;0;130205;109477;0;64.4;54.2;0.0
65;2021-07-15;1040;1462;0;131245;110939;0;64.9;54.9;0.0
65;2021-07-16;1126;1651;0;132371;112590;0;65.5;55.7;0.0
65;2021-07-17;417;452;0;132788;113042;0;65.7;55.9;0.0
65;2021-07-18;49;60;0;132837;113102;0;65.7;56.0;0.0
65;2021-07-19;731;1372;0;133568;114474;0;66.1;56.6;0.0
65;2021-07-20;1305;1548;0;134873;116022;0;66.7;57.4;0.0
65;2021-07-21;1298;1518;0;136171;117540;0;67.4;58.2;0.0
65;2021-07-22;1860;1151;0;138031;118691;0;68.3;58.7;0.0
65;2021-07-23;1525;1654;0;139556;120345;0;69.0;59.5;0.0
65;2021-07-24;1011;629;0;140567;120974;0;69.5;59.9;0.0
65;2021-07-25;86;60;0;140653;121034;0;69.6;59.9;0.0
65;2021-07-26;1103;1091;0;141756;122125;0;70.1;60.4;0.0
65;2021-07-27;1672;1698;0;143428;123823;0;71.0;61.3;0.0
65;2021-07-28;1477;1191;0;144905;125014;0;71.7;61.8;0.0
65;2021-07-29;2548;1062;0;147453;126076;0;73.0;62.4;0.0
65;2021-07-30;2176;1277;0;149629;127353;0;74.0;63.0;0.0
65;2021-07-31;1882;336;0;151511;127689;0;75.0;63.2;0.0
65;2021-08-01;52;29;0;151563;127718;0;75.0;63.2;0.0
65;2021-08-02;951;738;0;152514;128456;0;75.5;63.6;0.0
65;2021-08-03;1758;902;0;154272;129358;0;76.3;64.0;0.0
65;2021-08-04;1532;560;0;155804;129918;0;77.1;64.3;0.0
65;2021-08-05;1589;720;0;157393;130638;0;77.9;64.6;0.0
65;2021-08-06;1466;839;0;158859;131477;0;78.6;65.0;0.0
65;2021-08-07;645;464;0;159504;131941;0;78.9;65.3;0.0
65;2021-08-08;28;27;0;159532;131968;0;78.9;65.3;0.0
65;2021-08-09;647;948;0;160179;132916;0;79.2;65.8;0.0
65;2021-08-10;1038;1349;0;161217;134265;0;79.8;66.4;0.0
65;2021-08-11;670;1107;0;161887;135372;0;80.1;67.0;0.0
65;2021-08-12;718;1013;0;162605;136385;0;80.4;67.5;0.0
65;2021-08-13;423;882;0;163028;137267;0;80.7;67.9;0.0
65;2021-08-14;519;534;0;163547;137801;0;80.9;68.2;0.0
65;2021-08-15;15;42;0;163562;137843;0;80.9;68.2;0.0
65;2021-08-16;349;1413;0;163911;139256;0;81.1;68.9;0.0
65;2021-08-17;669;1968;0;164580;141224;0;81.4;69.9;0.0
65;2021-08-18;588;1441;0;165168;142665;0;81.7;70.6;0.0
65;2021-08-19;625;1165;0;165793;143830;0;82.0;71.2;0.0
65;2021-08-20;377;1201;0;166170;145031;0;82.2;71.8;0.0
65;2021-08-21;83;210;0;166253;145241;0;82.3;71.9;0.0
65;2021-08-22;13;41;0;166266;145282;0;82.3;71.9;0.0
65;2021-08-23;272;1556;0;166538;146838;0;82.4;72.6;0.0
65;2021-08-24;532;2190;0;167070;149028;0;82.7;73.7;0.0
65;2021-08-25;398;1754;0;167468;150782;0;82.9;74.6;0.0
65;2021-08-26;417;2027;0;167885;152809;0;83.1;75.6;0.0
65;2021-08-27;412;1765;0;168297;154574;0;83.3;76.5;0.0
65;2021-08-28;147;253;0;168444;154827;0;83.3;76.6;0.0
65;2021-08-29;9;26;0;168453;154853;0;83.3;76.6;0.0
65;2021-08-30;252;945;26;168705;155798;26;83.5;77.1;0.0
65;2021-08-31;406;1374;86;169111;157172;112;83.7;77.8;0.1
65;2021-09-01;446;1019;83;169557;158191;195;83.9;78.3;0.1
65;2021-09-02;347;802;126;169904;158993;321;84.1;78.7;0.2
65;2021-09-03;424;952;132;170328;159945;453;84.3;79.1;0.2
65;2021-09-04;172;756;63;170500;160701;516;84.4;79.5;0.3
65;2021-09-05;22;22;23;170522;160723;539;84.4;79.5;0.3
65;2021-09-06;261;498;286;170783;161221;825;84.5;79.8;0.4
65;2021-09-07;291;729;369;171074;161950;1194;84.6;80.1;0.6
65;2021-09-08;326;659;236;171400;162609;1430;84.8;80.4;0.7
65;2021-09-09;227;555;191;171627;163164;1621;84.9;80.7;0.8
65;2021-09-10;351;694;192;171978;163858;1813;85.1;81.1;0.9
65;2021-09-11;67;165;26;172045;164023;1839;85.1;81.1;0.9
65;2021-09-12;8;12;0;172053;164035;1839;85.1;81.2;0.9
65;2021-09-13;192;311;193;172245;164346;2032;85.2;81.3;1.0
65;2021-09-14;172;321;261;172417;164667;2293;85.3;81.5;1.1
65;2021-09-15;235;582;331;172652;165249;2624;85.4;81.8;1.3
65;2021-09-16;147;222;224;172799;165471;2848;85.5;81.9;1.4
65;2021-09-17;253;496;370;173052;165967;3218;85.6;82.1;1.6
65;2021-09-18;91;253;83;173143;166220;3301;85.7;82.2;1.6
65;2021-09-19;3;15;4;173146;166235;3305;85.7;82.2;1.6
65;2021-09-20;102;223;241;173248;166458;3546;85.7;82.4;1.8
65;2021-09-21;110;250;246;173358;166708;3792;85.8;82.5;1.9
65;2021-09-22;143;598;334;173501;167306;4126;85.8;82.8;2.0
65;2021-09-23;60;169;245;173561;167475;4371;85.9;82.9;2.2
65;2021-09-24;158;506;284;173719;167981;4655;85.9;83.1;2.3
65;2021-09-25;78;213;40;173797;168194;4695;86.0;83.2;2.3
65;2021-09-26;2;4;9;173799;168198;4704;86.0;83.2;2.3
65;2021-09-27;55;236;179;173854;168434;4883;86.0;83.3;2.4
65;2021-09-28;85;268;340;173939;168702;5223;86.1;83.5;2.6
65;2021-09-29;139;384;282;174078;169086;5505;86.1;83.7;2.7
65;2021-09-30;47;134;158;174125;169220;5663;86.1;83.7;2.8
65;2021-10-01;179;353;324;174304;169573;5987;86.2;83.9;3.0
65;2021-10-02;26;71;10;174330;169644;5997;86.2;83.9;3.0
65;2021-10-03;0;9;0;174330;169653;5997;86.2;83.9;3.0
65;2021-10-04;123;236;270;174453;169889;6267;86.3;84.1;3.1
65;2021-10-05;67;170;237;174520;170059;6504;86.3;84.1;3.2
65;2021-10-06;149;317;334;174669;170376;6838;86.4;84.3;3.4
65;2021-10-07;69;148;191;174738;170524;7029;86.4;84.4;3.5
65;2021-10-08;181;371;361;174919;170895;7390;86.5;84.5;3.7
65;2021-10-09;31;42;36;174950;170937;7426;86.6;84.6;3.7
65;2021-10-10;4;4;1;174954;170941;7427;86.6;84.6;3.7
65;2021-10-11;93;182;344;175047;171123;7771;86.6;84.7;3.8
65;2021-10-12;48;111;313;175095;171234;8084;86.6;84.7;4.0
65;2021-10-13;123;214;337;175218;171448;8421;86.7;84.8;4.2
65;2021-10-14;45;100;120;175263;171548;8541;86.7;84.9;4.2
65;2021-10-15;172;220;577;175435;171768;9118;86.8;85.0;4.5
65;2021-10-16;32;22;12;175467;171790;9130;86.8;85.0;4.5
65;2021-10-17;1;2;2;175468;171792;9132;86.8;85.0;4.5
65;2021-10-18;91;113;319;175559;171905;9451;86.9;85.0;4.7
65;2021-10-19;53;62;243;175612;171967;9694;86.9;85.1;4.8
65;2021-10-20;107;152;504;175719;172119;10198;86.9;85.2;5.0
65;2021-10-21;40;54;110;175759;172173;10308;87.0;85.2;5.1
65;2021-10-22;121;196;600;175880;172369;10908;87.0;85.3;5.4
65;2021-10-23;12;29;34;175892;172398;10942;87.0;85.3;5.4
65;2021-10-24;1;7;6;175893;172405;10948;87.0;85.3;5.4
65;2021-10-25;95;134;496;175988;172539;11444;87.1;85.4;5.7
65;2021-10-26;32;45;261;176020;172584;11705;87.1;85.4;5.8
65;2021-10-27;96;142;526;176116;172726;12231;87.1;85.5;6.1
65;2021-10-28;25;34;173;176141;172760;12404;87.1;85.5;6.1
65;2021-10-29;98;217;592;176239;172977;12996;87.2;85.6;6.4
65;2021-10-30;20;33;19;176259;173010;13015;87.2;85.6;6.4
65;2021-10-31;0;1;0;176259;173011;13015;87.2;85.6;6.4
65;2021-11-01;9;12;1;176268;173023;13016;87.2;85.6;6.4
65;2021-11-02;35;63;298;176303;173086;13314;87.2;85.6;6.6
65;2021-11-03;114;168;744;176417;173254;14058;87.3;85.7;7.0
65;2021-11-04;37;41;343;176454;173295;14401;87.3;85.7;7.1
65;2021-11-05;103;162;759;176557;173457;15160;87.3;85.8;7.5
65;2021-11-06;23;36;101;176580;173493;15261;87.4;85.8;7.6
65;2021-11-07;1;5;1;176581;173498;15262;87.4;85.8;7.6
65;2021-11-08;53;97;707;176634;173595;15969;87.4;85.9;7.9
65;2021-11-09;37;57;509;176671;173652;16478;87.4;85.9;8.2
65;2021-11-10;95;117;964;176766;173769;17442;87.5;86.0;8.6
65;2021-11-11;0;4;22;176766;173773;17464;87.5;86.0;8.6
65;2021-11-12;94;146;1269;176860;173919;18733;87.5;86.0;9.3
65;2021-11-13;8;13;66;176868;173932;18799;87.5;86.1;9.3
65;2021-11-14;0;5;4;176868;173937;18803;87.5;86.1;9.3
65;2021-11-15;50;99;814;176918;174036;19617;87.5;86.1;9.7
65;2021-11-16;59;58;837;176977;174094;20454;87.6;86.1;10.1
65;2021-11-17;81;131;1096;177058;174225;21550;87.6;86.2;10.7
65;2021-11-18;57;47;631;177115;174272;22181;87.6;86.2;11.0
65;2021-11-19;98;127;1357;177213;174399;23538;87.7;86.3;11.6
65;2021-11-20;20;20;159;177233;174419;23697;87.7;86.3;11.7
65;2021-11-21;2;3;7;177235;174422;23704;87.7;86.3;11.7
65;2021-11-22;52;51;971;177287;174473;24675;87.7;86.3;12.2
65;2021-11-23;69;51;1250;177356;174524;25925;87.7;86.3;12.8
65;2021-11-24;97;105;1284;177453;174629;27209;87.8;86.4;13.5
65;2021-11-25;73;40;1051;177526;174669;28260;87.8;86.4;14.0
65;2021-11-26;120;127;2195;177646;174796;30455;87.9;86.5;15.1
65;2021-11-27;42;25;1115;177688;174821;31570;87.9;86.5;15.6
65;2021-11-28;24;15;562;177712;174836;32132;87.9;86.5;15.9
65;2021-11-29;52;73;1561;177764;174909;33693;87.9;86.5;16.7
65;2021-11-30;113;67;2426;177877;174976;36119;88.0;86.6;17.9
65;2021-12-01;89;125;2404;177966;175101;38523;88.0;86.6;19.1
65;2021-12-02;93;67;2523;178059;175168;41046;88.1;86.7;20.3
65;2021-12-03;91;109;2782;178150;175277;43828;88.1;86.7;21.7
65;2021-12-04;40;35;1155;178190;175312;44983;88.2;86.7;22.3
65;2021-12-05;2;10;685;178192;175322;45668;88.2;86.7;22.6
65;2021-12-06;57;61;1976;178249;175383;47644;88.2;86.8;23.6
65;2021-12-07;74;63;2737;178323;175446;50381;88.2;86.8;24.9
65;2021-12-08;85;116;2566;178408;175562;52947;88.3;86.9;26.2
65;2021-12-09;63;59;2870;178471;175621;55817;88.3;86.9;27.6
65;2021-12-10;84;102;3045;178555;175723;58862;88.3;86.9;29.1
65;2021-12-11;57;33;1408;178612;175756;60270;88.4;87.0;29.8
65;2021-12-12;6;8;819;178618;175764;61089;88.4;87.0;30.2
65;2021-12-13;62;55;2187;178680;175819;63276;88.4;87.0;31.3
65;2021-12-14;88;105;2936;178768;175924;66212;88.4;87.0;32.8
65;2021-12-15;88;104;3157;178856;176028;69369;88.5;87.1;34.3
65;2021-12-16;88;70;3280;178944;176098;72649;88.5;87.1;35.9
65;2021-12-17;112;146;3661;179056;176244;76310;88.6;87.2;37.8
65;2021-12-18;60;42;1357;179116;176286;77667;88.6;87.2;38.4
65;2021-12-19;39;16;907;179155;176302;78574;88.6;87.2;38.9
66;2020-12-27;0;0;0;0;0;0;0.0;0.0;0.0
66;2020-12-28;3;0;0;3;0;0;0.0;0.0;0.0
66;2020-12-29;1;0;0;4;0;0;0.0;0.0;0.0
66;2020-12-30;0;0;0;4;0;0;0.0;0.0;0.0
66;2020-12-31;2;0;0;6;0;0;0.0;0.0;0.0
66;2021-01-01;1;0;0;7;0;0;0.0;0.0;0.0
66;2021-01-02;0;0;0;7;0;0;0.0;0.0;0.0
66;2021-01-03;0;0;0;7;0;0;0.0;0.0;0.0
66;2021-01-04;31;0;0;38;0;0;0.0;0.0;0.0
66;2021-01-05;134;0;0;172;0;0;0.0;0.0;0.0
66;2021-01-06;184;0;0;356;0;0;0.1;0.0;0.0
66;2021-01-07;169;0;0;525;0;0;0.1;0.0;0.0
66;2021-01-08;212;0;0;737;0;0;0.2;0.0;0.0
66;2021-01-09;227;0;0;964;0;0;0.2;0.0;0.0
66;2021-01-10;9;0;0;973;0;0;0.2;0.0;0.0
66;2021-01-11;387;2;0;1360;2;0;0.3;0.0;0.0
66;2021-01-12;547;2;0;1907;4;0;0.5;0.0;0.0
66;2021-01-13;850;9;0;2757;13;0;0.7;0.0;0.0
66;2021-01-14;855;12;0;3612;25;0;0.9;0.0;0.0
66;2021-01-15;582;1;0;4194;26;0;1.0;0.0;0.0
66;2021-01-16;114;3;0;4308;29;0;1.0;0.0;0.0
66;2021-01-17;46;1;0;4354;30;0;1.0;0.0;0.0
66;2021-01-18;616;3;0;4970;33;0;1.2;0.0;0.0
66;2021-01-19;706;4;0;5676;37;0;1.4;0.0;0.0
66;2021-01-20;1129;6;0;6805;43;0;1.6;0.0;0.0
66;2021-01-21;2300;7;0;9105;50;0;2.2;0.0;0.0
66;2021-01-22;1365;9;0;10470;59;0;2.5;0.0;0.0
66;2021-01-23;388;4;0;10858;63;0;2.6;0.0;0.0
66;2021-01-24;216;9;0;11074;72;0;2.6;0.0;0.0
66;2021-01-25;691;44;0;11765;116;0;2.8;0.0;0.0
66;2021-01-26;786;63;0;12551;179;0;3.0;0.0;0.0
66;2021-01-27;834;95;0;13385;274;0;3.2;0.1;0.0
66;2021-01-28;836;120;0;14221;394;0;3.4;0.1;0.0
66;2021-01-29;786;125;0;15007;519;0;3.6;0.1;0.0
66;2021-01-30;455;85;0;15462;604;0;3.7;0.1;0.0
66;2021-01-31;197;25;0;15659;629;0;3.7;0.2;0.0
66;2021-02-01;545;185;0;16204;814;0;3.9;0.2;0.0
66;2021-02-02;619;276;0;16823;1090;0;4.0;0.3;0.0
66;2021-02-03;713;578;0;17536;1668;0;4.2;0.4;0.0
66;2021-02-04;687;601;0;18223;2269;0;4.3;0.5;0.0
66;2021-02-05;758;411;0;18981;2680;0;4.5;0.6;0.0
66;2021-02-06;400;143;0;19381;2823;0;4.6;0.7;0.0
66;2021-02-07;165;138;0;19546;2961;0;4.7;0.7;0.0
66;2021-02-08;486;366;0;20032;3327;0;4.8;0.8;0.0
66;2021-02-09;512;392;0;20544;3719;0;4.9;0.9;0.0
66;2021-02-10;595;757;0;21139;4476;0;5.0;1.1;0.0
66;2021-02-11;1072;1518;0;22211;5994;0;5.3;1.4;0.0
66;2021-02-12;1078;1131;0;23289;7125;0;5.6;1.7;0.0
66;2021-02-13;345;299;0;23634;7424;0;5.6;1.8;0.0
66;2021-02-14;106;191;0;23740;7615;0;5.7;1.8;0.0
66;2021-02-15;421;680;0;24161;8295;0;5.8;2.0;0.0
66;2021-02-16;311;778;0;24472;9073;0;5.8;2.2;0.0
66;2021-02-17;360;669;0;24832;9742;0;5.9;2.3;0.0
66;2021-02-18;371;748;0;25203;10490;0;6.0;2.5;0.0
66;2021-02-19;386;681;0;25589;11171;0;6.1;2.7;0.0
66;2021-02-20;172;388;0;25761;11559;0;6.1;2.8;0.0
66;2021-02-21;34;162;0;25795;11721;0;6.2;2.8;0.0
66;2021-02-22;405;598;0;26200;12319;0;6.2;2.9;0.0
66;2021-02-23;504;651;0;26704;12970;0;6.4;3.1;0.0
66;2021-02-24;355;732;0;27059;13702;0;6.5;3.3;0.0
66;2021-02-25;706;687;0;27765;14389;0;6.6;3.4;0.0
66;2021-02-26;934;740;0;28699;15129;0;6.8;3.6;0.0
66;2021-02-27;359;407;0;29058;15536;0;6.9;3.7;0.0
66;2021-02-28;59;167;0;29117;15703;0;6.9;3.7;0.0
66;2021-03-01;346;613;0;29463;16316;0;7.0;3.9;0.0
66;2021-03-02;329;651;0;29792;16967;0;7.1;4.0;0.0
66;2021-03-03;524;613;0;30316;17580;0;7.2;4.2;0.0
66;2021-03-04;989;1042;0;31305;18622;0;7.5;4.4;0.0
66;2021-03-05;1506;782;0;32811;19404;0;7.8;4.6;0.0
66;2021-03-06;1126;331;0;33937;19735;0;8.1;4.7;0.0
66;2021-03-07;1028;96;0;34965;19831;0;8.3;4.7;0.0
66;2021-03-08;663;525;0;35628;20356;0;8.5;4.9;0.0
66;2021-03-09;1189;582;0;36817;20938;0;8.8;5.0;0.0
66;2021-03-10;1270;503;0;38087;21441;0;9.1;5.1;0.0
66;2021-03-11;1463;572;0;39550;22013;0;9.4;5.3;0.0
66;2021-03-12;2339;561;0;41889;22574;0;10.0;5.4;0.0
66;2021-03-13;1072;297;0;42961;22871;0;10.2;5.5;0.0
66;2021-03-14;194;83;0;43155;22954;0;10.3;5.5;0.0
66;2021-03-15;1049;394;0;44204;23348;0;10.5;5.6;0.0
66;2021-03-16;928;266;0;45132;23614;0;10.8;5.6;0.0
66;2021-03-17;855;381;0;45987;23995;0;11.0;5.7;0.0
66;2021-03-18;946;328;0;46933;24323;0;11.2;5.8;0.0
66;2021-03-19;1244;318;0;48177;24641;0;11.5;5.9;0.0
66;2021-03-20;812;118;0;48989;24759;0;11.7;5.9;0.0
66;2021-03-21;186;40;0;49175;24799;0;11.7;5.9;0.0
66;2021-03-22;1088;388;0;50263;25187;0;12.0;6.0;0.0
66;2021-03-23;1717;386;0;51980;25573;0;12.4;6.1;0.0
66;2021-03-24;1772;507;0;53752;26080;0;12.8;6.2;0.0
66;2021-03-25;2509;464;0;56261;26544;0;13.4;6.3;0.0
66;2021-03-26;2480;372;0;58741;26916;0;14.0;6.4;0.0
66;2021-03-27;1171;287;0;59912;27203;0;14.3;6.5;0.0
66;2021-03-28;323;3;0;60235;27206;0;14.4;6.5;0.0
66;2021-03-29;1734;244;0;61969;27450;0;14.8;6.5;0.0
66;2021-03-30;2167;175;0;64136;27625;0;15.3;6.6;0.0
66;2021-03-31;1930;245;0;66066;27870;0;15.8;6.6;0.0
66;2021-04-01;2573;310;0;68639;28180;0;16.4;6.7;0.0
66;2021-04-02;2328;266;0;70967;28446;0;16.9;6.8;0.0
66;2021-04-03;1104;318;0;72071;28764;0;17.2;6.9;0.0
66;2021-04-04;104;116;0;72175;28880;0;17.2;6.9;0.0
66;2021-04-05;200;135;0;72375;29015;0;17.3;6.9;0.0
66;2021-04-06;1244;629;0;73619;29644;0;17.6;7.1;0.0
66;2021-04-07;1378;572;0;74997;30216;0;17.9;7.2;0.0
66;2021-04-08;1945;551;0;76942;30767;0;18.4;7.3;0.0
66;2021-04-09;3382;677;0;80324;31444;0;19.2;7.5;0.0
66;2021-04-10;2189;510;0;82513;31954;0;19.7;7.6;0.0
66;2021-04-11;1137;163;0;83650;32117;0;20.0;7.7;0.0
66;2021-04-12;2543;988;0;86193;33105;0;20.6;7.9;0.0
66;2021-04-13;3433;1048;0;89626;34153;0;21.4;8.1;0.0
66;2021-04-14;3130;905;0;92756;35058;0;22.1;8.4;0.0
66;2021-04-15;3368;1001;0;96124;36059;0;22.9;8.6;0.0
66;2021-04-16;3383;1015;0;99507;37074;0;23.7;8.8;0.0
66;2021-04-17;2124;577;0;101631;37651;0;24.2;9.0;0.0
66;2021-04-18;1344;138;0;102975;37789;0;24.6;9.0;0.0
66;2021-04-19;2106;1087;0;105081;38876;0;25.1;9.3;0.0
66;2021-04-20;2212;1059;0;107293;39935;0;25.6;9.5;0.0
66;2021-04-21;2633;1151;0;109926;41086;0;26.2;9.8;0.0
66;2021-04-22;2516;1204;0;112442;42290;0;26.8;10.1;0.0
66;2021-04-23;2228;1185;0;114670;43475;0;27.4;10.4;0.0
66;2021-04-24;2534;846;0;117204;44321;0;28.0;10.6;0.0
66;2021-04-25;1126;271;0;118330;44592;0;28.2;10.6;0.0
66;2021-04-26;1849;1176;0;120179;45768;0;28.7;10.9;0.0
66;2021-04-27;2570;1263;0;122749;47031;0;29.3;11.2;0.0
66;2021-04-28;2296;1609;0;125045;48640;0;29.8;11.6;0.0
66;2021-04-29;2509;2029;0;127554;50669;0;30.4;12.1;0.0
66;2021-04-30;2845;1473;0;130399;52142;0;31.1;12.4;0.0
66;2021-05-01;1868;470;0;132267;52612;0;31.6;12.6;0.0
66;2021-05-02;1420;259;0;133687;52871;0;31.9;12.6;0.0
66;2021-05-03;2777;1055;0;136464;53926;0;32.6;12.9;0.0
66;2021-05-04;2938;1271;0;139402;55197;0;33.3;13.2;0.0
66;2021-05-05;2880;1513;0;142282;56710;0;33.9;13.5;0.0
66;2021-05-06;3529;2000;0;145811;58710;0;34.8;14.0;0.0
66;2021-05-07;2824;2960;0;148635;61670;0;35.5;14.7;0.0
66;2021-05-08;1598;1113;0;150233;62783;0;35.8;15.0;0.0
66;2021-05-09;836;1307;0;151069;64090;0;36.0;15.3;0.0
66;2021-05-10;1671;2770;0;152740;66860;0;36.4;15.9;0.0
66;2021-05-11;2579;2974;0;155319;69834;0;37.1;16.7;0.0
66;2021-05-12;2210;2422;0;157529;72256;0;37.6;17.2;0.0
66;2021-05-13;1971;1283;0;159500;73539;0;38.0;17.5;0.0
66;2021-05-14;2487;1994;0;161987;75533;0;38.6;18.0;0.0
66;2021-05-15;2048;1467;0;164035;77000;0;39.1;18.4;0.0
66;2021-05-16;1983;1139;0;166018;78139;0;39.6;18.6;0.0
66;2021-05-17;1884;1733;0;167902;79872;0;40.1;19.1;0.0
66;2021-05-18;2913;1669;0;170815;81541;0;40.7;19.5;0.0
66;2021-05-19;2618;1277;0;173433;82818;0;41.4;19.8;0.0
66;2021-05-20;3967;1363;0;177400;84181;0;42.3;20.1;0.0
66;2021-05-21;2971;1368;0;180371;85549;0;43.0;20.4;0.0
66;2021-05-22;2729;739;0;183100;86288;0;43.7;20.6;0.0
66;2021-05-23;1358;211;0;184458;86499;0;44.0;20.6;0.0
66;2021-05-24;1819;400;0;186277;86899;0;44.4;20.7;0.0
66;2021-05-25;2601;1578;0;188878;88477;0;45.1;21.1;0.0
66;2021-05-26;2590;1394;0;191468;89871;0;45.7;21.4;0.0
66;2021-05-27;3123;2106;0;194591;91977;0;46.4;21.9;0.0
66;2021-05-28;2488;2904;0;197079;94881;0;47.0;22.6;0.0
66;2021-05-29;1909;1396;0;198988;96277;0;47.5;23.0;0.0
66;2021-05-30;719;903;0;199707;97180;0;47.6;23.2;0.0
66;2021-05-31;1933;1638;0;201640;98818;0;48.1;23.6;0.0
66;2021-06-01;2450;1907;0;204090;100725;0;48.7;24.0;0.0
66;2021-06-02;2599;2211;0;206689;102936;0;49.3;24.6;0.0
66;2021-06-03;2341;2777;0;209030;105713;0;49.9;25.2;0.0
66;2021-06-04;1750;3170;0;210780;108883;0;50.3;26.0;0.0
66;2021-06-05;1278;2446;0;212058;111329;0;50.6;26.6;0.0
66;2021-06-06;314;1142;0;212372;112471;0;50.7;26.8;0.0
66;2021-06-07;1265;2721;0;213637;115192;0;51.0;27.5;0.0
66;2021-06-08;1670;2848;0;215307;118040;0;51.4;28.2;0.0
66;2021-06-09;1912;2593;0;217219;120633;0;51.8;28.8;0.0
66;2021-06-10;1969;2748;0;219188;123381;0;52.3;29.4;0.0
66;2021-06-11;1937;3595;0;221125;126976;0;52.7;30.3;0.0
66;2021-06-12;817;2247;0;221942;129223;0;52.9;30.8;0.0
66;2021-06-13;468;1268;0;222410;130491;0;53.1;31.1;0.0
66;2021-06-14;1296;3245;0;223706;133736;0;53.4;31.9;0.0
66;2021-06-15;1993;3328;0;225699;137064;0;53.8;32.7;0.0
66;2021-06-16;1723;3313;0;227422;140377;0;54.3;33.5;0.0
66;2021-06-17;2241;3363;0;229663;143740;0;54.8;34.3;0.0
66;2021-06-18;2050;3550;0;231713;147290;0;55.3;35.1;0.0
66;2021-06-19;1378;2098;0;233091;149388;0;55.6;35.6;0.0
66;2021-06-20;873;1116;0;233964;150504;0;55.8;35.9;0.0
66;2021-06-21;1040;2661;0;235004;153165;0;56.1;36.5;0.0
66;2021-06-22;1379;3440;0;236383;156605;0;56.4;37.4;0.0
66;2021-06-23;1216;2753;0;237599;159358;0;56.7;38.0;0.0
66;2021-06-24;1357;2950;0;238956;162308;0;57.0;38.7;0.0
66;2021-06-25;1309;3228;0;240265;165536;0;57.3;39.5;0.0
66;2021-06-26;861;2396;0;241126;167932;0;57.5;40.1;0.0
66;2021-06-27;594;1383;0;241720;169315;0;57.7;40.4;0.0
66;2021-06-28;902;2773;0;242622;172088;0;57.9;41.1;0.0
66;2021-06-29;1071;3469;0;243693;175557;0;58.1;41.9;0.0
66;2021-06-30;1176;3028;0;244869;178585;0;58.4;42.6;0.0
66;2021-07-01;1340;3792;0;246209;182377;0;58.7;43.5;0.0
66;2021-07-02;1228;3270;0;247437;185647;0;59.0;44.3;0.0
66;2021-07-03;1025;3592;0;248462;189239;0;59.3;45.1;0.0
66;2021-07-04;632;1625;0;249094;190864;0;59.4;45.5;0.0
66;2021-07-05;977;2725;0;250071;193589;0;59.7;46.2;0.0
66;2021-07-06;1220;3456;0;251291;197045;0;59.9;47.0;0.0
66;2021-07-07;1242;2978;0;252533;200023;0;60.2;47.7;0.0
66;2021-07-08;1157;3116;0;253690;203139;0;60.5;48.5;0.0
66;2021-07-09;1279;3122;0;254969;206261;0;60.8;49.2;0.0
66;2021-07-10;884;2119;0;255853;208380;0;61.0;49.7;0.0
66;2021-07-11;475;1378;0;256328;209758;0;61.1;50.0;0.0
66;2021-07-12;858;3250;0;257186;213008;0;61.4;50.8;0.0
66;2021-07-13;1884;3911;0;259070;216919;0;61.8;51.7;0.0
66;2021-07-14;1682;1106;0;260752;218025;0;62.2;52.0;0.0
66;2021-07-15;2437;2715;0;263189;220740;0;62.8;52.7;0.0
66;2021-07-16;2853;2842;0;266042;223582;0;63.5;53.3;0.0
66;2021-07-17;1884;1817;0;267926;225399;0;63.9;53.8;0.0
66;2021-07-18;1027;967;0;268953;226366;0;64.2;54.0;0.0
66;2021-07-19;2295;2597;0;271248;228963;0;64.7;54.6;0.0
66;2021-07-20;2940;2555;0;274188;231518;0;65.4;55.2;0.0
66;2021-07-21;3267;2539;0;277455;234057;0;66.2;55.8;0.0
66;2021-07-22;3441;2464;0;280896;236521;0;67.0;56.4;0.0
66;2021-07-23;3436;2561;0;284332;239082;0;67.8;57.0;0.0
66;2021-07-24;2433;1708;0;286765;240790;0;68.4;57.4;0.0
66;2021-07-25;1853;1068;0;288618;241858;0;68.8;57.7;0.0
66;2021-07-26;2327;2175;0;290945;244033;0;69.4;58.2;0.0
66;2021-07-27;2743;2408;0;293688;246441;0;70.1;58.8;0.0
66;2021-07-28;2912;2222;0;296600;248663;0;70.8;59.3;0.0
66;2021-07-29;3376;2146;0;299976;250809;0;71.6;59.8;0.0
66;2021-07-30;3633;2102;0;303609;252911;0;72.4;60.3;0.0
66;2021-07-31;1978;1494;0;305587;254405;0;72.9;60.7;0.0
66;2021-08-01;1505;713;0;307092;255118;0;73.3;60.9;0.0
66;2021-08-02;1973;1480;0;309065;256598;0;73.7;61.2;0.0
66;2021-08-03;2237;1533;0;311302;258131;0;74.3;61.6;0.0
66;2021-08-04;2135;1550;0;313437;259681;0;74.8;61.9;0.0
66;2021-08-05;2042;1895;0;315479;261576;0;75.3;62.4;0.0
66;2021-08-06;1975;2061;0;317454;263637;0;75.7;62.9;0.0
66;2021-08-07;1347;1701;0;318801;265338;0;76.0;63.3;0.0
66;2021-08-08;490;1110;0;319291;266448;0;76.2;63.6;0.0
66;2021-08-09;1169;2089;0;320460;268537;0;76.4;64.1;0.0
66;2021-08-10;1433;2383;0;321893;270920;0;76.8;64.6;0.0
66;2021-08-11;1384;2374;0;323277;273294;0;77.1;65.2;0.0
66;2021-08-12;1460;2446;0;324737;275740;0;77.5;65.8;0.0
66;2021-08-13;1285;2427;0;326022;278167;0;77.8;66.4;0.0
66;2021-08-14;572;2158;0;326594;280325;0;77.9;66.9;0.0
66;2021-08-15;133;1351;0;326727;281676;0;77.9;67.2;0.0
66;2021-08-16;1175;2167;0;327902;283843;0;78.2;67.7;0.0
66;2021-08-17;1309;2473;0;329211;286316;0;78.5;68.3;0.0
66;2021-08-18;1169;2595;0;330380;288911;0;78.8;68.9;0.0
66;2021-08-19;1004;2504;0;331384;291415;0;79.0;69.5;0.0
66;2021-08-20;890;2870;0;332274;294285;0;79.3;70.2;0.0
66;2021-08-21;526;1789;0;332800;296074;0;79.4;70.6;0.0
66;2021-08-22;200;1185;0;333000;297259;0;79.4;70.9;0.0
66;2021-08-23;1045;2416;0;334045;299675;0;79.7;71.5;0.0
66;2021-08-24;905;2488;0;334950;302163;0;79.9;72.1;0.0
66;2021-08-25;853;1970;0;335803;304133;0;80.1;72.5;0.0
66;2021-08-26;859;1991;0;336662;306124;0;80.3;73.0;0.0
66;2021-08-27;805;2137;0;337467;308261;0;80.5;73.5;0.0
66;2021-08-28;469;1064;0;337936;309325;0;80.6;73.8;0.0
66;2021-08-29;217;325;0;338153;309650;0;80.7;73.9;0.0
66;2021-08-30;800;2259;50;338953;311909;50;80.9;74.4;0.0
66;2021-08-31;766;2265;79;339719;314174;129;81.0;74.9;0.0
66;2021-09-01;764;1658;204;340483;315832;333;81.2;75.3;0.1
66;2021-09-02;624;1430;235;341107;317262;568;81.4;75.7;0.1
66;2021-09-03;651;1699;276;341758;318961;844;81.5;76.1;0.2
66;2021-09-04;649;1476;133;342407;320437;977;81.7;76.4;0.2
66;2021-09-05;193;268;44;342600;320705;1021;81.7;76.5;0.2
66;2021-09-06;437;1262;516;343037;321967;1537;81.8;76.8;0.4
66;2021-09-07;371;1077;421;343408;323044;1958;81.9;77.1;0.5
66;2021-09-08;558;1177;422;343966;324221;2380;82.1;77.3;0.6
66;2021-09-09;451;1046;447;344417;325267;2827;82.2;77.6;0.7
66;2021-09-10;476;1063;409;344893;326330;3236;82.3;77.8;0.8
66;2021-09-11;481;1084;135;345374;327414;3371;82.4;78.1;0.8
66;2021-09-12;94;134;41;345468;327548;3412;82.4;78.1;0.8
66;2021-09-13;358;999;623;345826;328547;4035;82.5;78.4;1.0
66;2021-09-14;382;780;580;346208;329327;4615;82.6;78.6;1.1
66;2021-09-15;480;930;625;346688;330257;5240;82.7;78.8;1.2
66;2021-09-16;369;676;535;347057;330933;5775;82.8;78.9;1.4
66;2021-09-17;351;718;660;347408;331651;6435;82.9;79.1;1.5
66;2021-09-18;340;1023;160;347748;332674;6595;83.0;79.4;1.6
66;2021-09-19;76;219;38;347824;332893;6633;83.0;79.4;1.6
66;2021-09-20;277;622;400;348101;333515;7033;83.0;79.6;1.7
66;2021-09-21;288;556;566;348389;334071;7599;83.1;79.7;1.8
66;2021-09-22;304;739;553;348693;334810;8152;83.2;79.9;1.9
66;2021-09-23;235;479;409;348928;335289;8561;83.2;80.0;2.0
66;2021-09-24;331;718;397;349259;336007;8958;83.3;80.2;2.1
66;2021-09-25;215;834;125;349474;336841;9083;83.4;80.4;2.2
66;2021-09-26;63;204;11;349537;337045;9094;83.4;80.4;2.2
66;2021-09-27;178;476;444;349715;337521;9538;83.4;80.5;2.3
66;2021-09-28;251;492;327;349966;338013;9865;83.5;80.6;2.4
66;2021-09-29;236;546;314;350202;338559;10179;83.5;80.8;2.4
66;2021-09-30;320;448;480;350522;339007;10659;83.6;80.9;2.5
66;2021-10-01;399;520;409;350921;339527;11068;83.7;81.0;2.6
66;2021-10-02;277;582;102;351198;340109;11170;83.8;81.1;2.7
66;2021-10-03;75;113;40;351273;340222;11210;83.8;81.2;2.7
66;2021-10-04;251;378;524;351524;340600;11734;83.9;81.2;2.8
66;2021-10-05;242;382;596;351766;340982;12330;83.9;81.3;2.9
66;2021-10-06;210;370;459;351976;341352;12789;84.0;81.4;3.1
66;2021-10-07;233;422;472;352209;341774;13261;84.0;81.5;3.2
66;2021-10-08;285;496;646;352494;342270;13907;84.1;81.6;3.3
66;2021-10-09;293;482;261;352787;342752;14168;84.2;81.8;3.4
66;2021-10-10;6;19;5;352793;342771;14173;84.2;81.8;3.4
66;2021-10-11;214;374;389;353007;343145;14562;84.2;81.9;3.5
66;2021-10-12;227;317;575;353234;343462;15137;84.3;81.9;3.6
66;2021-10-13;219;395;606;353453;343857;15743;84.3;82.0;3.8
66;2021-10-14;210;286;626;353663;344143;16369;84.4;82.1;3.9
66;2021-10-15;329;386;714;353992;344529;17083;84.4;82.2;4.1
66;2021-10-16;232;296;194;354224;344825;17277;84.5;82.3;4.1
66;2021-10-17;7;17;0;354231;344842;17277;84.5;82.3;4.1
66;2021-10-18;193;227;500;354424;345069;17777;84.5;82.3;4.2
66;2021-10-19;207;272;699;354631;345341;18476;84.6;82.4;4.4
66;2021-10-20;192;261;688;354823;345602;19164;84.6;82.4;4.6
66;2021-10-21;209;341;880;355032;345943;20044;84.7;82.5;4.8
66;2021-10-22;207;323;744;355239;346266;20788;84.7;82.6;5.0
66;2021-10-23;221;289;331;355460;346555;21119;84.8;82.7;5.0
66;2021-10-24;4;11;14;355464;346566;21133;84.8;82.7;5.0
66;2021-10-25;172;305;681;355636;346871;21814;84.8;82.7;5.2
66;2021-10-26;149;220;697;355785;347091;22511;84.9;82.8;5.4
66;2021-10-27;135;209;791;355920;347300;23302;84.9;82.8;5.6
66;2021-10-28;171;229;809;356091;347529;24111;84.9;82.9;5.8
66;2021-10-29;183;267;765;356274;347796;24876;85.0;83.0;5.9
66;2021-10-30;120;223;313;356394;348019;25189;85.0;83.0;6.0
66;2021-10-31;6;3;5;356400;348022;25194;85.0;83.0;6.0
66;2021-11-01;37;32;11;356437;348054;25205;85.0;83.0;6.0
66;2021-11-02;195;281;900;356632;348335;26105;85.1;83.1;6.2
66;2021-11-03;214;271;1019;356846;348606;27124;85.1;83.2;6.5
66;2021-11-04;216;206;1085;357062;348812;28209;85.2;83.2;6.7
66;2021-11-05;200;291;1171;357262;349103;29380;85.2;83.3;7.0
66;2021-11-06;147;261;453;357409;349364;29833;85.3;83.3;7.1
66;2021-11-07;10;20;13;357419;349384;29846;85.3;83.3;7.1
66;2021-11-08;107;248;1015;357526;349632;30861;85.3;83.4;7.4
66;2021-11-09;140;207;1497;357666;349839;32358;85.3;83.5;7.7
66;2021-11-10;204;250;1403;357870;350089;33761;85.4;83.5;8.1
66;2021-11-11;14;32;43;357884;350121;33804;85.4;83.5;8.1
66;2021-11-12;162;275;1606;358046;350396;35410;85.4;83.6;8.4
66;2021-11-13;96;197;462;358142;350593;35872;85.4;83.6;8.6
66;2021-11-14;15;11;29;358157;350604;35901;85.4;83.6;8.6
66;2021-11-15;118;168;1588;358275;350772;37489;85.5;83.7;8.9
66;2021-11-16;161;200;2114;358436;350972;39603;85.5;83.7;9.4
66;2021-11-17;178;217;1797;358614;351189;41400;85.5;83.8;9.9
66;2021-11-18;188;224;2311;358802;351413;43711;85.6;83.8;10.4
66;2021-11-19;202;232;2417;359004;351645;46128;85.6;83.9;11.0
66;2021-11-20;210;181;829;359214;351826;46957;85.7;83.9;11.2
66;2021-11-21;17;31;24;359231;351857;46981;85.7;83.9;11.2
66;2021-11-22;217;133;1717;359448;351990;48698;85.7;84.0;11.6
66;2021-11-23;193;209;2552;359641;352199;51250;85.8;84.0;12.2
66;2021-11-24;194;250;1925;359835;352449;53175;85.8;84.1;12.7
66;2021-11-25;194;194;2536;360029;352643;55711;85.9;84.1;13.3
66;2021-11-26;225;245;3597;360254;352888;59308;85.9;84.2;14.1
66;2021-11-27;183;214;1458;360437;353102;60766;86.0;84.2;14.5
66;2021-11-28;50;49;1861;360487;353151;62627;86.0;84.2;14.9
66;2021-11-29;155;189;3581;360642;353340;66208;86.0;84.3;15.8
66;2021-11-30;241;264;4766;360883;353604;70974;86.1;84.4;16.9
66;2021-12-01;186;275;4519;361069;353879;75493;86.1;84.4;18.0
66;2021-12-02;163;171;5694;361232;354050;81187;86.2;84.5;19.4
66;2021-12-03;205;227;5733;361437;354277;86920;86.2;84.5;20.7
66;2021-12-04;127;148;2165;361564;354425;89085;86.2;84.5;21.3
66;2021-12-05;17;23;250;361581;354448;89335;86.3;84.6;21.3
66;2021-12-06;189;193;4726;361770;354641;94061;86.3;84.6;22.4
66;2021-12-07;191;217;5783;361961;354858;99844;86.3;84.6;23.8
66;2021-12-08;211;223;5375;362172;355081;105219;86.4;84.7;25.1
66;2021-12-09;188;243;6252;362360;355324;111471;86.4;84.8;26.6
66;2021-12-10;311;287;6644;362671;355611;118115;86.5;84.8;28.2
66;2021-12-11;159;269;2991;362830;355880;121106;86.6;84.9;28.9
66;2021-12-12;18;41;631;362848;355921;121737;86.6;84.9;29.0
66;2021-12-13;158;238;5089;363006;356159;126826;86.6;85.0;30.3
66;2021-12-14;222;251;7016;363228;356410;133842;86.6;85.0;31.9
66;2021-12-15;220;254;6169;363448;356664;140011;86.7;85.1;33.4
66;2021-12-16;240;242;5731;363688;356906;145742;86.8;85.1;34.8
66;2021-12-17;261;321;6334;363949;357227;152076;86.8;85.2;36.3
66;2021-12-18;196;203;3560;364145;357430;155636;86.9;85.3;37.1
66;2021-12-19;31;28;525;364176;357458;156161;86.9;85.3;37.3
67;2020-12-27;0;0;0;0;0;0;0.0;0.0;0.0
67;2020-12-28;3;0;0;3;0;0;0.0;0.0;0.0
67;2020-12-29;2;0;0;5;0;0;0.0;0.0;0.0
67;2020-12-30;1;0;0;6;0;0;0.0;0.0;0.0
67;2020-12-31;1;0;0;7;0;0;0.0;0.0;0.0
67;2021-01-01;5;0;0;12;0;0;0.0;0.0;0.0
67;2021-01-02;1;0;0;13;0;0;0.0;0.0;0.0
67;2021-01-03;1;0;0;14;0;0;0.0;0.0;0.0
67;2021-01-04;43;0;0;57;0;0;0.0;0.0;0.0
67;2021-01-05;169;7;0;226;7;0;0.0;0.0;0.0
67;2021-01-06;125;0;0;351;7;0;0.0;0.0;0.0
67;2021-01-07;240;1;0;591;8;0;0.1;0.0;0.0
67;2021-01-08;235;2;0;826;10;0;0.1;0.0;0.0
67;2021-01-09;111;1;0;937;11;0;0.1;0.0;0.0
67;2021-01-10;67;0;0;1004;11;0;0.1;0.0;0.0
67;2021-01-11;189;1;0;1193;12;0;0.1;0.0;0.0
67;2021-01-12;521;3;0;1714;15;0;0.2;0.0;0.0
67;2021-01-13;669;4;0;2383;19;0;0.2;0.0;0.0
67;2021-01-14;1093;8;0;3476;27;0;0.4;0.0;0.0
67;2021-01-15;928;7;0;4404;34;0;0.4;0.0;0.0
67;2021-01-16;199;4;0;4603;38;0;0.5;0.0;0.0
67;2021-01-17;100;0;0;4703;38;0;0.5;0.0;0.0
67;2021-01-18;909;6;0;5612;44;0;0.6;0.0;0.0
67;2021-01-19;1396;5;0;7008;49;0;0.7;0.0;0.0
67;2021-01-20;1835;14;0;8843;63;0;0.9;0.0;0.0
67;2021-01-21;2190;11;0;11033;74;0;1.1;0.0;0.0
67;2021-01-22;1978;11;0;13011;85;0;1.3;0.0;0.0
67;2021-01-23;728;5;0;13739;90;0;1.4;0.0;0.0
67;2021-01-24;397;1;0;14136;91;0;1.4;0.0;0.0
67;2021-01-25;568;30;0;14704;121;0;1.5;0.0;0.0
67;2021-01-26;237;107;0;14941;228;0;1.5;0.0;0.0
67;2021-01-27;1432;137;0;16373;365;0;1.7;0.0;0.0
67;2021-01-28;3003;232;0;19376;597;0;2.0;0.1;0.0
67;2021-01-29;1985;169;0;21361;766;0;2.2;0.1;0.0
67;2021-01-30;1061;78;0;22422;844;0;2.3;0.1;0.0
67;2021-01-31;1127;31;0;23549;875;0;2.4;0.1;0.0
67;2021-02-01;3237;250;0;26786;1125;0;2.7;0.1;0.0
67;2021-02-02;2592;427;0;29378;1552;0;3.0;0.2;0.0
67;2021-02-03;1531;412;0;30909;1964;0;3.1;0.2;0.0
67;2021-02-04;1130;769;0;32039;2733;0;3.3;0.3;0.0
67;2021-02-05;1147;628;0;33186;3361;0;3.4;0.3;0.0
67;2021-02-06;761;142;0;33947;3503;0;3.5;0.4;0.0
67;2021-02-07;291;46;0;34238;3549;0;3.5;0.4;0.0
67;2021-02-08;846;460;0;35084;4009;0;3.6;0.4;0.0
67;2021-02-09;1022;737;0;36106;4746;0;3.7;0.5;0.0
67;2021-02-10;982;807;0;37088;5553;0;3.8;0.6;0.0
67;2021-02-11;1180;1151;0;38268;6704;0;3.9;0.7;0.0
67;2021-02-12;1244;807;0;39512;7511;0;4.0;0.8;0.0
67;2021-02-13;775;270;0;40287;7781;0;4.1;0.8;0.0
67;2021-02-14;251;97;0;40538;7878;0;4.1;0.8;0.0
67;2021-02-15;808;891;0;41346;8769;0;4.2;0.9;0.0
67;2021-02-16;935;1166;0;42281;9935;0;4.3;1.0;0.0
67;2021-02-17;830;1210;0;43111;11145;0;4.4;1.1;0.0
67;2021-02-18;1428;2520;0;44539;13665;0;4.5;1.4;0.0
67;2021-02-19;1306;2099;0;45845;15764;0;4.7;1.6;0.0
67;2021-02-20;608;826;0;46453;16590;0;4.7;1.7;0.0
67;2021-02-21;199;1166;0;46652;17756;0;4.7;1.8;0.0
67;2021-02-22;1370;2085;0;48022;19841;0;4.9;2.0;0.0
67;2021-02-23;1462;1577;0;49484;21418;0;5.0;2.2;0.0
67;2021-02-24;1428;1073;0;50912;22491;0;5.2;2.3;0.0
67;2021-02-25;1630;1476;0;52542;23967;0;5.3;2.4;0.0
67;2021-02-26;2262;1403;0;54804;25370;0;5.6;2.6;0.0
67;2021-02-27;1254;771;0;56058;26141;0;5.7;2.7;0.0
67;2021-02-28;150;364;0;56208;26505;0;5.7;2.7;0.0
67;2021-03-01;674;990;0;56882;27495;0;5.8;2.8;0.0
67;2021-03-02;955;1184;0;57837;28679;0;5.9;2.9;0.0
67;2021-03-03;1476;1241;0;59313;29920;0;6.0;3.0;0.0
67;2021-03-04;2024;1065;0;61337;30985;0;6.2;3.2;0.0
67;2021-03-05;3284;1122;0;64621;32107;0;6.6;3.3;0.0
67;2021-03-06;2392;755;0;67013;32862;0;6.8;3.3;0.0
67;2021-03-07;527;290;0;67540;33152;0;6.9;3.4;0.0
67;2021-03-08;1229;817;0;68769;33969;0;7.0;3.5;0.0
67;2021-03-09;2242;970;0;71011;34939;0;7.2;3.6;0.0
67;2021-03-10;2477;1235;0;73488;36174;0;7.5;3.7;0.0
67;2021-03-11;3219;1408;0;76707;37582;0;7.8;3.8;0.0
67;2021-03-12;5201;1419;0;81908;39001;0;8.3;4.0;0.0
67;2021-03-13;4034;883;0;85942;39884;0;8.7;4.1;0.0
67;2021-03-14;588;381;0;86530;40265;0;8.8;4.1;0.0
67;2021-03-15;2284;1148;0;88814;41413;0;9.0;4.2;0.0
67;2021-03-16;1672;1234;0;90486;42647;0;9.2;4.3;0.0
67;2021-03-17;2175;951;0;92661;43598;0;9.4;4.4;0.0
67;2021-03-18;2460;783;0;95121;44381;0;9.7;4.5;0.0
67;2021-03-19;3765;773;0;98886;45154;0;10.1;4.6;0.0
67;2021-03-20;3054;516;0;101940;45670;0;10.4;4.6;0.0
67;2021-03-21;345;26;0;102285;45696;0;10.4;4.6;0.0
67;2021-03-22;2401;801;0;104686;46497;0;10.6;4.7;0.0
67;2021-03-23;3449;839;0;108135;47336;0;11.0;4.8;0.0
67;2021-03-24;3923;885;0;112058;48221;0;11.4;4.9;0.0
67;2021-03-25;5336;596;0;117394;48817;0;11.9;5.0;0.0
67;2021-03-26;6798;542;0;124192;49359;0;12.6;5.0;0.0
67;2021-03-27;3806;349;0;127998;49708;0;13.0;5.1;0.0
67;2021-03-28;579;108;0;128577;49816;0;13.1;5.1;0.0
67;2021-03-29;3772;494;0;132349;50310;0;13.5;5.1;0.0
67;2021-03-30;4782;780;0;137131;51090;0;13.9;5.2;0.0
67;2021-03-31;4721;819;0;141852;51909;0;14.4;5.3;0.0
67;2021-04-01;5018;1045;0;146870;52954;0;14.9;5.4;0.0
67;2021-04-02;1053;204;0;147923;53158;0;15.0;5.4;0.0
67;2021-04-03;1607;302;0;149530;53460;0;15.2;5.4;0.0
67;2021-04-04;350;28;0;149880;53488;0;15.2;5.4;0.0
67;2021-04-05;388;12;0;150268;53500;0;15.3;5.4;0.0
67;2021-04-06;3432;1287;0;153700;54787;0;15.6;5.6;0.0
67;2021-04-07;4473;1364;0;158173;56151;0;16.1;5.7;0.0
67;2021-04-08;5498;1453;0;163671;57604;0;16.6;5.9;0.0
67;2021-04-09;6981;1386;0;170652;58990;0;17.4;6.0;0.0
67;2021-04-10;4150;958;0;174802;59948;0;17.8;6.1;0.0
67;2021-04-11;850;514;0;175652;60462;0;17.9;6.1;0.0
67;2021-04-12;3839;1524;0;179491;61986;0;18.3;6.3;0.0
67;2021-04-13;4794;1717;0;184285;63703;0;18.7;6.5;0.0
67;2021-04-14;5167;1996;0;189452;65699;0;19.3;6.7;0.0
67;2021-04-15;5946;2215;0;195398;67914;0;19.9;6.9;0.0
67;2021-04-16;7614;2510;0;203012;70424;0;20.6;7.2;0.0
67;2021-04-17;3836;1562;0;206848;71986;0;21.0;7.3;0.0
67;2021-04-18;1064;644;0;207912;72630;0;21.1;7.4;0.0
67;2021-04-19;3506;2196;0;211418;74826;0;21.5;7.6;0.0
67;2021-04-20;4110;1992;0;215528;76818;0;21.9;7.8;0.0
67;2021-04-21;3975;2553;0;219503;79371;0;22.3;8.1;0.0
67;2021-04-22;4421;2911;0;223924;82282;0;22.8;8.4;0.0
67;2021-04-23;5148;2995;0;229072;85277;0;23.3;8.7;0.0
67;2021-04-24;3014;1963;0;232086;87240;0;23.6;8.9;0.0
67;2021-04-25;990;444;0;233076;87684;0;23.7;8.9;0.0
67;2021-04-26;3142;2569;0;236218;90253;0;24.0;9.2;0.0
67;2021-04-27;3963;2890;0;240181;93143;0;24.4;9.5;0.0
67;2021-04-28;4197;3331;0;244378;96474;0;24.8;9.8;0.0
67;2021-04-29;5138;3476;0;249516;99950;0;25.4;10.2;0.0
67;2021-04-30;7122;2439;0;256638;102389;0;26.1;10.4;0.0
67;2021-05-01;2636;768;0;259274;103157;0;26.4;10.5;0.0
67;2021-05-02;2144;669;0;261418;103826;0;26.6;10.6;0.0
67;2021-05-03;5438;2599;0;266856;106425;0;27.1;10.8;0.0
67;2021-05-04;5705;3539;0;272561;109964;0;27.7;11.2;0.0
67;2021-05-05;5131;4111;0;277692;114075;0;28.2;11.6;0.0
67;2021-05-06;6664;4724;0;284356;118799;0;28.9;12.1;0.0
67;2021-05-07;6440;6751;0;290796;125550;0;29.6;12.8;0.0
67;2021-05-08;3504;1007;0;294300;126557;0;29.9;12.9;0.0
67;2021-05-09;3177;606;0;297477;127163;0;30.2;12.9;0.0
67;2021-05-10;4770;4477;0;302247;131640;0;30.7;13.4;0.0
67;2021-05-11;5769;4862;0;308016;136502;0;31.3;13.9;0.0
67;2021-05-12;6687;4718;0;314703;141220;0;32.0;14.4;0.0
67;2021-05-13;7364;1592;0;322067;142812;0;32.7;14.5;0.0
67;2021-05-14;8900;5154;0;330967;147966;0;33.7;15.0;0.0
67;2021-05-15;8022;3448;0;338989;151414;0;34.5;15.4;0.0
67;2021-05-16;5733;914;0;344722;152328;0;35.1;15.5;0.0
67;2021-05-17;5784;3741;0;350506;156069;0;35.6;15.9;0.0
67;2021-05-18;6984;3860;0;357490;159929;0;36.4;16.3;0.0
67;2021-05-19;7558;4049;0;365048;163978;0;37.1;16.7;0.0
67;2021-05-20;8905;4097;0;373953;168075;0;38.0;17.1;0.0
67;2021-05-21;8387;5683;0;382340;173758;0;38.9;17.7;0.0
67;2021-05-22;5902;3306;0;388242;177064;0;39.5;18.0;0.0
67;2021-05-23;2545;586;0;390787;177650;0;39.7;18.1;0.0
67;2021-05-24;4629;868;0;395416;178518;0;40.2;18.2;0.0
67;2021-05-25;5674;4724;0;401090;183242;0;40.8;18.6;0.0
67;2021-05-26;6395;4820;0;407485;188062;0;41.4;19.1;0.0
67;2021-05-27;7605;4877;0;415090;192939;0;42.2;19.6;0.0
67;2021-05-28;8307;6379;0;423397;199318;0;43.1;20.3;0.0
67;2021-05-29;6552;3799;0;429949;203117;0;43.7;20.7;0.0
67;2021-05-30;1147;782;0;431096;203899;0;43.8;20.7;0.0
67;2021-05-31;6674;4036;0;437770;207935;0;44.5;21.1;0.0
67;2021-06-01;7536;4389;0;445306;212324;0;45.3;21.6;0.0
67;2021-06-02;8209;4137;0;453515;216461;0;46.1;22.0;0.0
67;2021-06-03;8964;4862;0;462479;221323;0;47.0;22.5;0.0
67;2021-06-04;8592;6074;0;471071;227397;0;47.9;23.1;0.0
67;2021-06-05;6361;3890;0;477432;231287;0;48.5;23.5;0.0
67;2021-06-06;3165;827;0;480597;232114;0;48.9;23.6;0.0
67;2021-06-07;7412;4222;0;488009;236336;0;49.6;24.0;0.0
67;2021-06-08;8536;4918;0;496545;241254;0;50.5;24.5;0.0
67;2021-06-09;9056;4803;0;505601;246057;0;51.4;25.0;0.0
67;2021-06-10;9521;4967;0;515122;251024;0;52.4;25.5;0.0
67;2021-06-11;7947;8227;0;523069;259251;0;53.2;26.4;0.0
67;2021-06-12;6675;5055;0;529744;264306;0;53.9;26.9;0.0
67;2021-06-13;2793;1018;0;532537;265324;0;54.1;27.0;0.0
67;2021-06-14;5425;6350;0;537962;271674;0;54.7;27.6;0.0
67;2021-06-15;6504;6622;0;544466;278296;0;55.4;28.3;0.0
67;2021-06-16;6733;6568;0;551199;284864;0;56.0;29.0;0.0
67;2021-06-17;6983;8865;0;558182;293729;0;56.8;29.9;0.0
67;2021-06-18;7275;8392;0;565457;302121;0;57.5;30.7;0.0
67;2021-06-19;6023;5704;0;571480;307825;0;58.1;31.3;0.0
67;2021-06-20;1302;1326;0;572782;309151;0;58.2;31.4;0.0
67;2021-06-21;4124;6792;0;576906;315943;0;58.7;32.1;0.0
67;2021-06-22;4123;8898;0;581029;324841;0;59.1;33.0;0.0
67;2021-06-23;5092;8152;0;586121;332993;0;59.6;33.9;0.0
67;2021-06-24;4495;8813;0;590616;341806;0;60.1;34.8;0.0
67;2021-06-25;5172;9946;0;595788;351752;0;60.6;35.8;0.0
67;2021-06-26;3301;8917;0;599089;360669;0;60.9;36.7;0.0
67;2021-06-27;955;3416;0;600044;364085;0;61.0;37.0;0.0
67;2021-06-28;2774;8673;0;602818;372758;0;61.3;37.9;0.0
67;2021-06-29;2852;8659;0;605670;381417;0;61.6;38.8;0.0
67;2021-06-30;3275;8759;6;608945;390176;6;61.9;39.7;0.0
67;2021-07-01;3624;8400;0;612569;398576;6;62.3;40.5;0.0
67;2021-07-02;3751;10908;0;616320;409484;6;62.7;41.6;0.0
67;2021-07-03;2844;7603;0;619164;417087;6;63.0;42.4;0.0
67;2021-07-04;704;1794;0;619868;418881;6;63.0;42.6;0.0
67;2021-07-05;2693;8360;0;622561;427241;6;63.3;43.4;0.0
67;2021-07-06;2996;8571;0;625557;435812;6;63.6;44.3;0.0
67;2021-07-07;3878;8649;0;629435;444461;6;64.0;45.2;0.0
67;2021-07-08;4114;7792;0;633549;452253;6;64.4;46.0;0.0
67;2021-07-09;3706;11341;0;637255;463594;6;64.8;47.1;0.0
67;2021-07-10;2710;7990;0;639965;471584;6;65.1;48.0;0.0
67;2021-07-11;870;1893;0;640835;473477;6;65.2;48.1;0.0
67;2021-07-12;2468;9825;0;643303;483302;6;65.4;49.1;0.0
67;2021-07-13;4109;9957;0;647412;493259;6;65.8;50.2;0.0
67;2021-07-14;3429;4324;0;650841;497583;6;66.2;50.6;0.0
67;2021-07-15;5143;12092;0;655984;509675;6;66.7;51.8;0.0
67;2021-07-16;4920;12217;0;660904;521892;6;67.2;53.1;0.0
67;2021-07-17;3635;8602;0;664539;530494;6;67.6;53.9;0.0
67;2021-07-18;1373;2396;0;665912;532890;6;67.7;54.2;0.0
67;2021-07-19;4485;9680;0;670397;542570;6;68.2;55.2;0.0
67;2021-07-20;5706;9702;0;676103;552272;6;68.7;56.2;0.0
67;2021-07-21;5842;10315;0;681945;562587;6;69.3;57.2;0.0
67;2021-07-22;6366;9820;0;688311;572407;6;70.0;58.2;0.0
67;2021-07-23;7266;10986;0;695577;583393;6;70.7;59.3;0.0
67;2021-07-24;5201;7327;0;700778;590720;6;71.3;60.1;0.0
67;2021-07-25;2091;1868;0;702869;592588;6;71.5;60.3;0.0
67;2021-07-26;4974;7239;0;707843;599827;6;72.0;61.0;0.0
67;2021-07-27;6476;7147;0;714319;606974;6;72.6;61.7;0.0
67;2021-07-28;7397;7112;0;721716;614086;6;73.4;62.4;0.0
67;2021-07-29;8050;6312;0;729766;620398;6;74.2;63.1;0.0
67;2021-07-30;8336;7184;1;738102;627582;7;75.1;63.8;0.0
67;2021-07-31;4988;4739;0;743090;632321;7;75.6;64.3;0.0
67;2021-08-01;2238;1344;0;745328;633665;7;75.8;64.4;0.0
67;2021-08-02;6237;5054;0;751565;638719;7;76.4;64.9;0.0
67;2021-08-03;7044;4672;0;758609;643391;7;77.1;65.4;0.0
67;2021-08-04;6631;4574;0;765240;647965;7;77.8;65.9;0.0
67;2021-08-05;5503;4244;0;770743;652209;7;78.4;66.3;0.0
67;2021-08-06;6059;5366;0;776802;657575;7;79.0;66.9;0.0
67;2021-08-07;4327;4103;1;781129;661678;8;79.4;67.3;0.0
67;2021-08-08;1175;1332;0;782304;663010;8;79.5;67.4;0.0
67;2021-08-09;3089;4509;0;785393;667519;8;79.9;67.9;0.0
67;2021-08-10;3140;4773;0;788533;672292;8;80.2;68.4;0.0
67;2021-08-11;3232;4619;1;791765;676911;9;80.5;68.8;0.0
67;2021-08-12;2933;4734;0;794698;681645;9;80.8;69.3;0.0
67;2021-08-13;3135;5371;0;797833;687016;9;81.1;69.9;0.0
67;2021-08-14;2033;4835;0;799866;691851;9;81.3;70.3;0.0
67;2021-08-15;628;1416;0;800494;693267;9;81.4;70.5;0.0
67;2021-08-16;2015;5257;0;802509;698524;9;81.6;71.0;0.0
67;2021-08-17;2055;5294;0;804564;703818;9;81.8;71.6;0.0
67;2021-08-18;2221;6148;1;806785;709966;10;82.0;72.2;0.0
67;2021-08-19;1812;5891;0;808597;715857;10;82.2;72.8;0.0
67;2021-08-20;2221;7205;0;810818;723062;10;82.4;73.5;0.0
67;2021-08-21;1412;5287;0;812230;728349;10;82.6;74.1;0.0
67;2021-08-22;360;1878;0;812590;730227;10;82.6;74.3;0.0
67;2021-08-23;1777;6629;0;814367;736856;10;82.8;74.9;0.0
67;2021-08-24;1859;6445;0;816226;743301;10;83.0;75.6;0.0
67;2021-08-25;1968;6907;0;818194;750208;10;83.2;76.3;0.0
67;2021-08-26;1751;5329;0;819945;755537;10;83.4;76.8;0.0
67;2021-08-27;2052;6792;0;821997;762329;10;83.6;77.5;0.0
67;2021-08-28;1524;5681;0;823521;768010;10;83.7;78.1;0.0
67;2021-08-29;381;1449;0;823902;769459;10;83.8;78.2;0.0
67;2021-08-30;1344;4272;156;825246;773731;166;83.9;78.7;0.0
67;2021-08-31;1315;3784;239;826561;777515;405;84.0;79.1;0.0
67;2021-09-01;1829;3803;485;828390;781318;890;84.2;79.4;0.1
67;2021-09-02;1026;2496;416;829416;783814;1306;84.3;79.7;0.1
67;2021-09-03;1492;3671;518;830908;787485;1824;84.5;80.1;0.2
67;2021-09-04;1380;3541;339;832288;791026;2163;84.6;80.4;0.2
67;2021-09-05;266;764;92;832554;791790;2255;84.7;80.5;0.2
67;2021-09-06;917;1880;419;833471;793670;2674;84.7;80.7;0.3
67;2021-09-07;782;1734;393;834253;795404;3067;84.8;80.9;0.3
67;2021-09-08;1133;2300;521;835386;797704;3588;84.9;81.1;0.4
67;2021-09-09;1059;1712;514;836445;799416;4102;85.1;81.3;0.4
67;2021-09-10;1335;2282;544;837780;801698;4646;85.2;81.5;0.5
67;2021-09-11;998;2514;364;838778;804212;5010;85.3;81.8;0.5
67;2021-09-12;226;464;95;839004;804676;5105;85.3;81.8;0.5
67;2021-09-13;685;1363;696;839689;806039;5801;85.4;82.0;0.6
67;2021-09-14;926;1355;1008;840615;807394;6809;85.5;82.1;0.7
67;2021-09-15;973;2010;953;841588;809404;7762;85.6;82.3;0.8
67;2021-09-16;722;1233;1022;842310;810637;8784;85.6;82.4;0.9
67;2021-09-17;962;2112;1044;843272;812749;9828;85.7;82.6;1.0
67;2021-09-18;789;2249;399;844061;814998;10227;85.8;82.9;1.0
67;2021-09-19;98;369;98;844159;815367;10325;85.8;82.9;1.0
67;2021-09-20;566;1049;936;844725;816416;11261;85.9;83.0;1.1
67;2021-09-21;458;908;733;845183;817324;11994;85.9;83.1;1.2
67;2021-09-22;599;1799;1105;845782;819123;13099;86.0;83.3;1.3
67;2021-09-23;528;854;848;846310;819977;13947;86.1;83.4;1.4
67;2021-09-24;627;1566;974;846937;821543;14921;86.1;83.5;1.5
67;2021-09-25;590;1724;388;847527;823267;15309;86.2;83.7;1.6
67;2021-09-26;80;283;81;847607;823550;15390;86.2;83.7;1.6
67;2021-09-27;398;811;595;848005;824361;15985;86.2;83.8;1.6
67;2021-09-28;403;762;629;848408;825123;16614;86.3;83.9;1.7
67;2021-09-29;611;1252;1039;849019;826375;17653;86.3;84.0;1.8
67;2021-09-30;395;831;1120;849414;827206;18773;86.4;84.1;1.9
67;2021-10-01;864;1353;1036;850278;828559;19809;86.5;84.3;2.0
67;2021-10-02;595;1217;380;850873;829776;20189;86.5;84.4;2.1
67;2021-10-03;100;202;79;850973;829978;20268;86.5;84.4;2.1
67;2021-10-04;371;583;533;851344;830561;20801;86.6;84.5;2.1
67;2021-10-05;361;669;646;851705;831230;21447;86.6;84.5;2.2
67;2021-10-06;601;1032;999;852306;832262;22446;86.7;84.6;2.3
67;2021-10-07;449;736;913;852755;832998;23359;86.7;84.7;2.4
67;2021-10-08;712;1176;994;853467;834174;24353;86.8;84.8;2.5
67;2021-10-09;499;973;577;853966;835147;24930;86.8;84.9;2.5
67;2021-10-10;70;102;48;854036;835249;24978;86.8;84.9;2.5
67;2021-10-11;401;598;703;854437;835847;25681;86.9;85.0;2.6
67;2021-10-12;372;552;704;854809;836399;26385;86.9;85.0;2.7
67;2021-10-13;536;911;1076;855345;837310;27461;87.0;85.1;2.8
67;2021-10-14;379;622;815;855724;837932;28276;87.0;85.2;2.9
67;2021-10-15;683;965;1441;856407;838897;29717;87.1;85.3;3.0
67;2021-10-16;533;892;742;856940;839789;30459;87.1;85.4;3.1
67;2021-10-17;110;105;63;857050;839894;30522;87.1;85.4;3.1
67;2021-10-18;405;481;859;857455;840375;31381;87.2;85.5;3.2
67;2021-10-19;312;490;802;857767;840865;32183;87.2;85.5;3.3
67;2021-10-20;454;656;1263;858221;841521;33446;87.3;85.6;3.4
67;2021-10-21;316;483;929;858537;842004;34375;87.3;85.6;3.5
67;2021-10-22;568;692;1414;859105;842696;35789;87.4;85.7;3.6
67;2021-10-23;502;709;1114;859607;843405;36903;87.4;85.8;3.8
67;2021-10-24;56;116;99;859663;843521;37002;87.4;85.8;3.8
67;2021-10-25;324;410;929;859987;843931;37931;87.4;85.8;3.9
67;2021-10-26;259;331;971;860246;844262;38902;87.5;85.8;4.0
67;2021-10-27;391;542;1502;860637;844804;40404;87.5;85.9;4.1
67;2021-10-28;325;408;1102;860962;845212;41506;87.5;85.9;4.2
67;2021-10-29;485;573;1854;861447;845785;43360;87.6;86.0;4.4
67;2021-10-30;364;492;1243;861811;846277;44603;87.6;86.1;4.5
67;2021-10-31;66;89;100;861877;846366;44703;87.6;86.1;4.5
67;2021-11-01;89;56;82;861966;846422;44785;87.6;86.1;4.6
67;2021-11-02;257;345;1058;862223;846767;45843;87.7;86.1;4.7
67;2021-11-03;393;626;1765;862616;847393;47608;87.7;86.2;4.8
67;2021-11-04;301;408;1378;862917;847801;48986;87.7;86.2;5.0
67;2021-11-05;572;686;2635;863489;848487;51621;87.8;86.3;5.2
67;2021-11-06;364;593;1647;863853;849080;53268;87.8;86.3;5.4
67;2021-11-07;40;117;142;863893;849197;53410;87.8;86.3;5.4
67;2021-11-08;246;477;1967;864139;849674;55377;87.9;86.4;5.6
67;2021-11-09;249;366;1994;864388;850040;57371;87.9;86.4;5.8
67;2021-11-10;395;547;2790;864783;850587;60161;87.9;86.5;6.1
67;2021-11-11;46;71;298;864829;850658;60459;87.9;86.5;6.1
67;2021-11-12;427;596;3391;865256;851254;63850;88.0;86.6;6.5
67;2021-11-13;389;551;2179;865645;851805;66029;88.0;86.6;6.7
67;2021-11-14;44;57;205;865689;851862;66234;88.0;86.6;6.7
67;2021-11-15;276;370;2756;865965;852232;68990;88.1;86.7;7.0
67;2021-11-16;340;349;2756;866305;852581;71746;88.1;86.7;7.3
67;2021-11-17;409;480;3593;866714;853061;75339;88.1;86.7;7.7
67;2021-11-18;384;413;3523;867098;853474;78862;88.2;86.8;8.0
67;2021-11-19;559;695;4871;867657;854169;83733;88.2;86.9;8.5
67;2021-11-20;354;531;2780;868011;854700;86513;88.3;86.9;8.8
67;2021-11-21;33;82;232;868044;854782;86745;88.3;86.9;8.8
67;2021-11-22;391;310;3364;868435;855092;90109;88.3;86.9;9.2
67;2021-11-23;399;336;3702;868834;855428;93811;88.3;87.0;9.5
67;2021-11-24;533;517;4150;869367;855945;97961;88.4;87.0;10.0
67;2021-11-25;406;379;4382;869773;856324;102343;88.4;87.1;10.4
67;2021-11-26;602;596;7395;870375;856920;109738;88.5;87.1;11.2
67;2021-11-27;379;459;4803;870754;857379;114541;88.5;87.2;11.6
67;2021-11-28;48;75;944;870802;857454;115485;88.5;87.2;11.7
67;2021-11-29;329;309;5636;871131;857763;121121;88.6;87.2;12.3
67;2021-11-30;389;372;6782;871520;858135;127903;88.6;87.3;13.0
67;2021-12-01;344;427;7284;871864;858562;135187;88.7;87.3;13.7
67;2021-12-02;242;274;8071;872106;858836;143258;88.7;87.3;14.6
67;2021-12-03;327;511;10610;872433;859347;153868;88.7;87.4;15.6
67;2021-12-04;308;408;8005;872741;859755;161873;88.7;87.4;16.5
67;2021-12-05;49;111;1571;872790;859866;163444;88.7;87.4;16.6
67;2021-12-06;240;306;9098;873030;860172;172542;88.8;87.5;17.5
67;2021-12-07;333;394;11724;873363;860566;184266;88.8;87.5;18.7
67;2021-12-08;348;478;10960;873711;861044;195226;88.8;87.6;19.9
67;2021-12-09;311;379;11514;874022;861423;206740;88.9;87.6;21.0
67;2021-12-10;461;580;14510;874483;862003;221250;88.9;87.7;22.5
67;2021-12-11;415;481;10845;874898;862484;232095;89.0;87.7;23.6
67;2021-12-12;96;90;2685;874994;862574;234780;89.0;87.7;23.9
67;2021-12-13;228;419;11735;875222;862993;246515;89.0;87.8;25.1
67;2021-12-14;391;479;14319;875613;863472;260834;89.0;87.8;26.5
67;2021-12-15;379;598;14015;875992;864070;274849;89.1;87.9;27.9
67;2021-12-16;307;515;13764;876299;864585;288613;89.1;87.9;29.3
67;2021-12-17;446;668;16498;876745;865253;305111;89.1;88.0;31.0
67;2021-12-18;371;471;11106;877116;865724;316217;89.2;88.0;32.2
67;2021-12-19;97;121;2547;877213;865845;318764;89.2;88.0;32.4
68;2020-12-27;0;0;0;0;0;0;0.0;0.0;0.0
68;2020-12-28;1;0;0;1;0;0;0.0;0.0;0.0
68;2020-12-29;0;0;0;1;0;0;0.0;0.0;0.0
68;2020-12-30;2;0;0;3;0;0;0.0;0.0;0.0
68;2020-12-31;0;0;0;3;0;0;0.0;0.0;0.0
68;2021-01-01;0;0;0;3;0;0;0.0;0.0;0.0
68;2021-01-02;0;0;0;3;0;0;0.0;0.0;0.0
68;2021-01-03;0;0;0;3;0;0;0.0;0.0;0.0
68;2021-01-04;1;0;0;4;0;0;0.0;0.0;0.0
68;2021-01-05;11;0;0;15;0;0;0.0;0.0;0.0
68;2021-01-06;223;1;0;238;1;0;0.0;0.0;0.0
68;2021-01-07;84;1;0;322;2;0;0.0;0.0;0.0
68;2021-01-08;137;1;0;459;3;0;0.1;0.0;0.0
68;2021-01-09;25;1;0;484;4;0;0.1;0.0;0.0
68;2021-01-10;0;0;0;484;4;0;0.1;0.0;0.0
68;2021-01-11;94;0;0;578;4;0;0.1;0.0;0.0
68;2021-01-12;378;1;0;956;5;0;0.1;0.0;0.0
68;2021-01-13;702;3;0;1658;8;0;0.3;0.0;0.0
68;2021-01-14;383;2;0;2041;10;0;0.3;0.0;0.0
68;2021-01-15;225;1;0;2266;11;0;0.3;0.0;0.0
68;2021-01-16;4;0;0;2270;11;0;0.3;0.0;0.0
68;2021-01-17;1;0;0;2271;11;0;0.3;0.0;0.0
68;2021-01-18;387;4;0;2658;15;0;0.4;0.0;0.0
68;2021-01-19;600;5;0;3258;20;0;0.5;0.0;0.0
68;2021-01-20;748;10;0;4006;30;0;0.6;0.0;0.0
68;2021-01-21;1400;13;0;5406;43;0;0.8;0.0;0.0
68;2021-01-22;1481;14;0;6887;57;0;1.0;0.0;0.0
68;2021-01-23;255;3;0;7142;60;0;1.1;0.0;0.0
68;2021-01-24;671;2;0;7813;62;0;1.2;0.0;0.0
68;2021-01-25;1342;44;0;9155;106;0;1.4;0.0;0.0
68;2021-01-26;1492;76;0;10647;182;0;1.6;0.0;0.0
68;2021-01-27;2680;148;0;13327;330;0;2.0;0.1;0.0
68;2021-01-28;2315;59;0;15642;389;0;2.4;0.1;0.0
68;2021-01-29;1509;136;0;17151;525;0;2.6;0.1;0.0
68;2021-01-30;177;6;0;17328;531;0;2.6;0.1;0.0
68;2021-01-31;7;0;0;17335;531;0;2.6;0.1;0.0
68;2021-02-01;759;122;0;18094;653;0;2.7;0.1;0.0
68;2021-02-02;889;299;0;18983;952;0;2.9;0.1;0.0
68;2021-02-03;992;613;0;19975;1565;0;3.0;0.2;0.0
68;2021-02-04;1010;325;0;20985;1890;0;3.2;0.3;0.0
68;2021-02-05;961;235;0;21946;2125;0;3.3;0.3;0.0
68;2021-02-06;150;7;0;22096;2132;0;3.4;0.3;0.0
68;2021-02-07;3;17;0;22099;2149;0;3.4;0.3;0.0
68;2021-02-08;868;42;0;22967;2191;0;3.5;0.3;0.0
68;2021-02-09;1278;67;0;24245;2258;0;3.7;0.3;0.0
68;2021-02-10;1389;76;0;25634;2334;0;3.9;0.4;0.0
68;2021-02-11;1459;457;0;27093;2791;0;4.1;0.4;0.0
68;2021-02-12;1510;444;0;28603;3235;0;4.3;0.5;0.0
68;2021-02-13;141;6;0;28744;3241;0;4.4;0.5;0.0
68;2021-02-14;61;229;0;28805;3470;0;4.4;0.5;0.0
68;2021-02-15;619;1054;0;29424;4524;0;4.5;0.7;0.0
68;2021-02-16;830;1340;0;30254;5864;0;4.6;0.9;0.0
68;2021-02-17;1210;2063;0;31464;7927;0;4.8;1.2;0.0
68;2021-02-18;1606;2025;0;33070;9952;0;5.0;1.5;0.0
68;2021-02-19;970;1358;0;34040;11310;0;5.2;1.7;0.0
68;2021-02-20;108;165;0;34148;11475;0;5.2;1.7;0.0
68;2021-02-21;1;48;0;34149;11523;0;5.2;1.7;0.0
68;2021-02-22;445;799;0;34594;12322;0;5.3;1.9;0.0
68;2021-02-23;614;1035;0;35208;13357;0;5.3;2.0;0.0
68;2021-02-24;801;1151;0;36009;14508;0;5.5;2.2;0.0
68;2021-02-25;1177;1250;0;37186;15758;0;5.6;2.4;0.0
68;2021-02-26;1150;1002;0;38336;16760;0;5.8;2.5;0.0
68;2021-02-27;547;188;0;38883;16948;0;5.9;2.6;0.0
68;2021-02-28;12;1;0;38895;16949;0;5.9;2.6;0.0
68;2021-03-01;920;775;0;39815;17724;0;6.0;2.7;0.0
68;2021-03-02;1161;925;0;40976;18649;0;6.2;2.8;0.0
68;2021-03-03;1490;986;0;42466;19635;0;6.4;3.0;0.0
68;2021-03-04;1892;1038;0;44358;20673;0;6.7;3.1;0.0
68;2021-03-05;2264;1029;0;46622;21702;0;7.1;3.3;0.0
68;2021-03-06;2199;267;0;48821;21969;0;7.4;3.3;0.0
68;2021-03-07;817;103;0;49638;22072;0;7.5;3.4;0.0
68;2021-03-08;1384;943;0;51022;23015;0;7.7;3.5;0.0
68;2021-03-09;1649;1265;0;52671;24280;0;8.0;3.7;0.0
68;2021-03-10;1884;1746;0;54555;26026;0;8.3;4.0;0.0
68;2021-03-11;2548;1871;0;57103;27897;0;8.7;4.2;0.0
68;2021-03-12;2566;1373;0;59669;29270;0;9.1;4.4;0.0
68;2021-03-13;3274;276;0;62943;29546;0;9.6;4.5;0.0
68;2021-03-14;1405;63;0;64348;29609;0;9.8;4.5;0.0
68;2021-03-15;1630;603;0;65978;30212;0;10.0;4.6;0.0
68;2021-03-16;1862;574;0;67840;30786;0;10.3;4.7;0.0
68;2021-03-17;1803;695;0;69643;31481;0;10.6;4.8;0.0
68;2021-03-18;2043;905;0;71686;32386;0;10.9;4.9;0.0
68;2021-03-19;2900;713;0;74586;33099;0;11.3;5.0;0.0
68;2021-03-20;974;132;0;75560;33231;0;11.5;5.0;0.0
68;2021-03-21;75;2;0;75635;33233;0;11.5;5.0;0.0
68;2021-03-22;1874;568;0;77509;33801;0;11.8;5.1;0.0
68;2021-03-23;2751;583;0;80260;34384;0;12.2;5.2;0.0
68;2021-03-24;3116;756;0;83376;35140;0;12.7;5.3;0.0
68;2021-03-25;3392;765;0;86768;35905;0;13.2;5.5;0.0
68;2021-03-26;3920;710;0;90688;36615;0;13.8;5.6;0.0
68;2021-03-27;1183;175;0;91871;36790;0;13.9;5.6;0.0
68;2021-03-28;60;5;0;91931;36795;0;14.0;5.6;0.0
68;2021-03-29;2240;1292;0;94171;38087;0;14.3;5.8;0.0
68;2021-03-30;2930;1204;0;97101;39291;0;14.7;6.0;0.0
68;2021-03-31;2682;1254;0;99783;40545;0;15.2;6.2;0.0
68;2021-04-01;2778;1447;0;102561;41992;0;15.6;6.4;0.0
68;2021-04-02;321;101;0;102882;42093;0;15.6;6.4;0.0
68;2021-04-03;304;128;0;103186;42221;0;15.7;6.4;0.0
68;2021-04-04;22;2;0;103208;42223;0;15.7;6.4;0.0
68;2021-04-05;66;5;0;103274;42228;0;15.7;6.4;0.0
68;2021-04-06;1767;1228;0;105041;43456;0;15.9;6.6;0.0
68;2021-04-07;2585;1420;0;107626;44876;0;16.3;6.8;0.0
68;2021-04-08;3264;1431;0;110890;46307;0;16.8;7.0;0.0
68;2021-04-09;4177;1473;0;115067;47780;0;17.5;7.3;0.0
68;2021-04-10;1300;1869;0;116367;49649;0;17.7;7.5;0.0
68;2021-04-11;127;1181;0;116494;50830;0;17.7;7.7;0.0
68;2021-04-12;2657;1521;0;119151;52351;0;18.1;7.9;0.0
68;2021-04-13;2740;1966;0;121891;54317;0;18.5;8.2;0.0
68;2021-04-14;3522;2138;0;125413;56455;0;19.0;8.6;0.0
68;2021-04-15;4012;1999;0;129425;58454;0;19.7;8.9;0.0
68;2021-04-16;3890;1958;0;133315;60412;0;20.2;9.2;0.0
68;2021-04-17;1176;451;0;134491;60863;0;20.4;9.2;0.0
68;2021-04-18;115;17;0;134606;60880;0;20.4;9.2;0.0
68;2021-04-19;2308;1760;0;136914;62640;0;20.8;9.5;0.0
68;2021-04-20;2368;2225;0;139282;64865;0;21.1;9.8;0.0
68;2021-04-21;2768;2403;0;142050;67268;0;21.6;10.2;0.0
68;2021-04-22;3181;1946;0;145231;69214;0;22.1;10.5;0.0
68;2021-04-23;3290;2044;0;148521;71258;0;22.6;10.8;0.0
68;2021-04-24;859;542;0;149380;71800;0;22.7;10.9;0.0
68;2021-04-25;214;22;0;149594;71822;0;22.7;10.9;0.0
68;2021-04-26;2258;2100;0;151852;73922;0;23.1;11.2;0.0
68;2021-04-27;2533;2199;0;154385;76121;0;23.4;11.6;0.0
68;2021-04-28;3421;1817;0;157806;77938;0;24.0;11.8;0.0
68;2021-04-29;4007;1753;0;161813;79691;0;24.6;12.1;0.0
68;2021-04-30;4639;1405;0;166452;81096;0;25.3;12.3;0.0
68;2021-05-01;983;131;0;167435;81227;0;25.4;12.3;0.0
68;2021-05-02;732;77;0;168167;81304;0;25.5;12.3;0.0
68;2021-05-03;3507;1753;0;171674;83057;0;26.1;12.6;0.0
68;2021-05-04;3803;2314;0;175477;85371;0;26.6;13.0;0.0
68;2021-05-05;3570;3188;0;179047;88559;0;27.2;13.4;0.0
68;2021-05-06;4666;2883;0;183713;91442;0;27.9;13.9;0.0
68;2021-05-07;4357;2949;0;188070;94391;0;28.6;14.3;0.0
68;2021-05-08;1666;252;0;189736;94643;0;28.8;14.4;0.0
68;2021-05-09;1067;114;0;190803;94757;0;29.0;14.4;0.0
68;2021-05-10;2964;3674;0;193767;98431;0;29.4;14.9;0.0
68;2021-05-11;4531;3569;0;198298;102000;0;30.1;15.5;0.0
68;2021-05-12;5573;3251;0;203871;105251;0;31.0;16.0;0.0
68;2021-05-13;4551;883;0;208422;106134;0;31.6;16.1;0.0
68;2021-05-14;5617;2172;0;214039;108306;0;32.5;16.4;0.0
68;2021-05-15;3508;979;0;217547;109285;0;33.0;16.6;0.0
68;2021-05-16;774;148;0;218321;109433;0;33.2;16.6;0.0
68;2021-05-17;4296;2427;0;222617;111860;0;33.8;17.0;0.0
68;2021-05-18;6019;2306;0;228636;114166;0;34.7;17.3;0.0
68;2021-05-19;5713;2793;0;234349;116959;0;35.6;17.8;0.0
68;2021-05-20;5903;2416;0;240252;119375;0;36.5;18.1;0.0
68;2021-05-21;5707;2872;0;245959;122247;0;37.3;18.6;0.0
68;2021-05-22;2673;967;0;248632;123214;0;37.8;18.7;0.0
68;2021-05-23;140;25;0;248772;123239;0;37.8;18.7;0.0
68;2021-05-24;2208;942;0;250980;124181;0;38.1;18.9;0.0
68;2021-05-25;4187;3307;0;255167;127488;0;38.7;19.4;0.0
68;2021-05-26;4789;3288;0;259956;130776;0;39.5;19.9;0.0
68;2021-05-27;5327;3331;0;265283;134107;0;40.3;20.4;0.0
68;2021-05-28;5408;3720;0;270691;137827;0;41.1;20.9;0.0
68;2021-05-29;1623;1196;0;272314;139023;0;41.3;21.1;0.0
68;2021-05-30;82;65;0;272396;139088;0;41.4;21.1;0.0
68;2021-05-31;4921;2299;0;277317;141387;0;42.1;21.5;0.0
68;2021-06-01;5731;2737;0;283048;144124;0;43.0;21.9;0.0
68;2021-06-02;4847;2959;0;287895;147083;0;43.7;22.3;0.0
68;2021-06-03;5697;3037;0;293592;150120;0;44.6;22.8;0.0
68;2021-06-04;4941;3265;0;298533;153385;0;45.3;23.3;0.0
68;2021-06-05;933;1222;0;299466;154607;0;45.5;23.5;0.0
68;2021-06-06;147;125;0;299613;154732;0;45.5;23.5;0.0
68;2021-06-07;4542;2932;0;304155;157664;0;46.2;23.9;0.0
68;2021-06-08;4676;3441;0;308831;161105;0;46.9;24.5;0.0
68;2021-06-09;4827;3299;0;313658;164404;0;47.6;25.0;0.0
68;2021-06-10;4940;3097;0;318598;167501;0;48.4;25.4;0.0
68;2021-06-11;4892;4034;0;323490;171535;0;49.1;26.0;0.0
68;2021-06-12;2971;1777;0;326461;173312;0;49.6;26.3;0.0
68;2021-06-13;585;676;0;327046;173988;0;49.7;26.4;0.0
68;2021-06-14;2427;4279;0;329473;178267;0;50.0;27.1;0.0
68;2021-06-15;2989;4691;0;332462;182958;0;50.5;27.8;0.0
68;2021-06-16;3301;4404;0;335763;187362;0;51.0;28.4;0.0
68;2021-06-17;2372;4386;0;338135;191748;0;51.3;29.1;0.0
68;2021-06-18;3284;5091;0;341419;196839;0;51.8;29.9;0.0
68;2021-06-19;2246;2197;0;343665;199036;0;52.2;30.2;0.0
68;2021-06-20;272;887;0;343937;199923;0;52.2;30.4;0.0
68;2021-06-21;1963;4959;0;345900;204882;0;52.5;31.1;0.0
68;2021-06-22;1856;5104;0;347756;209986;0;52.8;31.9;0.0
68;2021-06-23;2232;5634;0;349988;215620;0;53.1;32.7;0.0
68;2021-06-24;2087;4744;0;352075;220364;0;53.5;33.5;0.0
68;2021-06-25;2197;6378;0;354272;226742;0;53.8;34.4;0.0
68;2021-06-26;1262;2634;0;355534;229376;0;54.0;34.8;0.0
68;2021-06-27;168;854;0;355702;230230;0;54.0;35.0;0.0
68;2021-06-28;1525;6234;0;357227;236464;0;54.2;35.9;0.0
68;2021-06-29;1490;6448;0;358717;242912;0;54.5;36.9;0.0
68;2021-06-30;1769;6416;0;360486;249328;0;54.7;37.9;0.0
68;2021-07-01;2106;5257;0;362592;254585;0;55.1;38.7;0.0
68;2021-07-02;2174;6376;0;364766;260961;0;55.4;39.6;0.0
68;2021-07-03;1029;2020;0;365795;262981;0;55.5;39.9;0.0
68;2021-07-04;240;230;0;366035;263211;0;55.6;40.0;0.0
68;2021-07-05;1409;5228;0;367444;268439;0;55.8;40.8;0.0
68;2021-07-06;1963;5672;0;369407;274111;0;56.1;41.6;0.0
68;2021-07-07;2369;4970;0;371776;279081;0;56.5;42.4;0.0
68;2021-07-08;2388;4649;0;374164;283730;0;56.8;43.1;0.0
68;2021-07-09;2062;7100;0;376226;290830;0;57.1;44.2;0.0
68;2021-07-10;1023;2072;0;377249;292902;0;57.3;44.5;0.0
68;2021-07-11;157;205;0;377406;293107;0;57.3;44.5;0.0
68;2021-07-12;1613;6467;0;379019;299574;0;57.6;45.5;0.0
68;2021-07-13;2775;6320;0;381794;305894;0;58.0;46.4;0.0
68;2021-07-14;1777;1090;0;383571;306984;0;58.2;46.6;0.0
68;2021-07-15;3181;6497;0;386752;313481;0;58.7;47.6;0.0
68;2021-07-16;3809;6665;0;390561;320146;0;59.3;48.6;0.0
68;2021-07-17;3347;2399;0;393908;322545;0;59.8;49.0;0.0
68;2021-07-18;1016;301;0;394924;322846;0;60.0;49.0;0.0
68;2021-07-19;3177;5898;0;398101;328744;0;60.4;49.9;0.0
68;2021-07-20;4214;5466;0;402315;334210;0;61.1;50.7;0.0
68;2021-07-21;4396;5664;0;406711;339874;0;61.8;51.6;0.0
68;2021-07-22;4181;4701;0;410892;344575;0;62.4;52.3;0.0
68;2021-07-23;5005;5681;0;415897;350256;0;63.2;53.2;0.0
68;2021-07-24;3290;2154;0;419187;352410;0;63.7;53.5;0.0
68;2021-07-25;841;551;0;420028;352961;0;63.8;53.6;0.0
68;2021-07-26;4741;4258;0;424769;357219;0;64.5;54.2;0.0
68;2021-07-27;6124;3647;0;430893;360866;0;65.4;54.8;0.0
68;2021-07-28;6588;3715;0;437481;364581;0;66.4;55.4;0.0
68;2021-07-29;6181;3336;0;443662;367917;0;67.4;55.9;0.0
68;2021-07-30;6194;4246;0;449856;372163;0;68.3;56.5;0.0
68;2021-07-31;3788;1461;0;453644;373624;0;68.9;56.7;0.0
68;2021-08-01;1558;499;0;455202;374123;0;69.1;56.8;0.0
68;2021-08-02;4570;3075;0;459772;377198;0;69.8;57.3;0.0
68;2021-08-03;3561;2459;0;463333;379657;0;70.4;57.6;0.0
68;2021-08-04;3156;2678;1;466489;382335;1;70.8;58.1;0.0
68;2021-08-05;2801;2647;0;469290;384982;1;71.3;58.5;0.0
68;2021-08-06;3966;4160;0;473256;389142;1;71.9;59.1;0.0
68;2021-08-07;1347;1404;0;474603;390546;1;72.1;59.3;0.0
68;2021-08-08;389;819;0;474992;391365;1;72.1;59.4;0.0
68;2021-08-09;2475;3607;0;477467;394972;1;72.5;60.0;0.0
68;2021-08-10;2209;2961;0;479676;397933;1;72.8;60.4;0.0
68;2021-08-11;1912;2910;0;481588;400843;1;73.1;60.9;0.0
68;2021-08-12;1788;2827;0;483376;403670;1;73.4;61.3;0.0
68;2021-08-13;2606;4627;0;485982;408297;1;73.8;62.0;0.0
68;2021-08-14;753;1558;0;486735;409855;1;73.9;62.2;0.0
68;2021-08-15;64;468;0;486799;410323;1;73.9;62.3;0.0
68;2021-08-16;1899;4931;0;488698;415254;1;74.2;63.1;0.0
68;2021-08-17;1739;4706;1;490437;419960;2;74.5;63.8;0.0
68;2021-08-18;1247;3789;0;491684;423749;2;74.7;64.3;0.0
68;2021-08-19;1335;3783;0;493019;427532;2;74.9;64.9;0.0
68;2021-08-20;2159;6026;1;495178;433558;3;75.2;65.8;0.0
68;2021-08-21;549;1492;0;495727;435050;3;75.3;66.1;0.0
68;2021-08-22;127;489;0;495854;435539;3;75.3;66.1;0.0
68;2021-08-23;1188;5293;0;497042;440832;3;75.5;66.9;0.0
68;2021-08-24;1351;5723;0;498393;446555;3;75.7;67.8;0.0
68;2021-08-25;1580;3765;0;499973;450320;3;75.9;68.4;0.0
68;2021-08-26;1911;4424;0;501884;454744;3;76.2;69.0;0.0
68;2021-08-27;1775;6139;1;503659;460883;4;76.5;70.0;0.0
68;2021-08-28;447;1243;0;504106;462126;4;76.5;70.2;0.0
68;2021-08-29;47;433;0;504153;462559;4;76.6;70.2;0.0
68;2021-08-30;1285;4292;37;505438;466851;41;76.7;70.9;0.0
68;2021-08-31;1244;3914;128;506682;470765;169;76.9;71.5;0.0
68;2021-09-01;1007;2173;136;507689;472938;305;77.1;71.8;0.0
68;2021-09-02;916;1770;224;508605;474708;529;77.2;72.1;0.1
68;2021-09-03;1309;4169;297;509914;478877;826;77.4;72.7;0.1
68;2021-09-04;548;951;86;510462;479828;912;77.5;72.9;0.1
68;2021-09-05;198;142;58;510660;479970;970;77.5;72.9;0.1
68;2021-09-06;715;2029;248;511375;481999;1218;77.6;73.2;0.2
68;2021-09-07;626;1267;192;512001;483266;1410;77.7;73.4;0.2
68;2021-09-08;651;1382;159;512652;484648;1569;77.8;73.6;0.2
68;2021-09-09;911;1262;332;513563;485910;1901;78.0;73.8;0.3
68;2021-09-10;1475;2950;331;515038;488860;2232;78.2;74.2;0.3
68;2021-09-11;474;696;56;515512;489556;2288;78.3;74.3;0.3
68;2021-09-12;75;76;10;515587;489632;2298;78.3;74.3;0.3
68;2021-09-13;825;1217;224;516412;490849;2522;78.4;74.5;0.4
68;2021-09-14;973;1310;534;517385;492159;3056;78.6;74.7;0.5
68;2021-09-15;723;1569;555;518108;493728;3611;78.7;75.0;0.5
68;2021-09-16;629;1042;481;518737;494770;4092;78.8;75.1;0.6
68;2021-09-17;980;2255;582;519717;497025;4674;78.9;75.5;0.7
68;2021-09-18;453;793;188;520170;497818;4862;79.0;75.6;0.7
68;2021-09-19;23;74;19;520193;497892;4881;79.0;75.6;0.7
68;2021-09-20;556;954;320;520749;498846;5201;79.1;75.7;0.8
68;2021-09-21;591;1247;756;521340;500093;5957;79.2;75.9;0.9
68;2021-09-22;617;1168;629;521957;501261;6586;79.3;76.1;1.0
68;2021-09-23;355;693;698;522312;501954;7284;79.3;76.2;1.1
68;2021-09-24;638;1521;799;522950;503475;8083;79.4;76.4;1.2
68;2021-09-25;299;693;176;523249;504168;8259;79.5;76.6;1.3
68;2021-09-26;32;57;12;523281;504225;8271;79.5;76.6;1.3
68;2021-09-27;345;675;515;523626;504900;8786;79.5;76.7;1.3
68;2021-09-28;344;544;523;523970;505444;9309;79.6;76.7;1.4
68;2021-09-29;563;856;890;524533;506300;10199;79.6;76.9;1.5
68;2021-09-30;402;762;671;524935;507062;10870;79.7;77.0;1.7
68;2021-10-01;882;1535;702;525817;508597;11572;79.8;77.2;1.8
68;2021-10-02;333;577;203;526150;509174;11775;79.9;77.3;1.8
68;2021-10-03;61;99;15;526211;509273;11790;79.9;77.3;1.8
68;2021-10-04;338;451;440;526549;509724;12230;80.0;77.4;1.9
68;2021-10-05;361;593;508;526910;510317;12738;80.0;77.5;1.9
68;2021-10-06;418;864;563;527328;511181;13301;80.1;77.6;2.0
68;2021-10-07;391;590;668;527719;511771;13969;80.1;77.7;2.1
68;2021-10-08;1051;1582;1170;528770;513353;15139;80.3;77.9;2.3
68;2021-10-09;315;619;298;529085;513972;15437;80.3;78.0;2.3
68;2021-10-10;39;51;45;529124;514023;15482;80.3;78.1;2.4
68;2021-10-11;317;470;419;529441;514493;15901;80.4;78.1;2.4
68;2021-10-12;270;492;511;529711;514985;16412;80.4;78.2;2.5
68;2021-10-13;508;640;661;530219;515625;17073;80.5;78.3;2.6
68;2021-10-14;406;618;792;530625;516243;17865;80.6;78.4;2.7
68;2021-10-15;699;944;1293;531324;517187;19158;80.7;78.5;2.9
68;2021-10-16;229;390;320;531553;517577;19478;80.7;78.6;3.0
68;2021-10-17;29;33;34;531582;517610;19512;80.7;78.6;3.0
68;2021-10-18;262;353;435;531844;517963;19947;80.8;78.6;3.0
68;2021-10-19;278;440;415;532122;518403;20362;80.8;78.7;3.1
68;2021-10-20;441;526;986;532563;518929;21348;80.9;78.8;3.2
68;2021-10-21;366;552;896;532929;519481;22244;80.9;78.9;3.4
68;2021-10-22;582;772;1353;533511;520253;23597;81.0;79.0;3.6
68;2021-10-23;204;352;444;533715;520605;24041;81.0;79.1;3.7
68;2021-10-24;25;49;22;533740;520654;24063;81.0;79.1;3.7
68;2021-10-25;196;267;476;533936;520921;24539;81.1;79.1;3.7
68;2021-10-26;189;286;519;534125;521207;25058;81.1;79.1;3.8
68;2021-10-27;341;417;1058;534466;521624;26116;81.2;79.2;4.0
68;2021-10-28;308;411;1056;534774;522035;27172;81.2;79.3;4.1
68;2021-10-29;452;614;1554;535226;522649;28726;81.3;79.4;4.4
68;2021-10-30;178;310;493;535404;522959;29219;81.3;79.4;4.4
68;2021-10-31;14;42;47;535418;523001;29266;81.3;79.4;4.4
68;2021-11-01;207;35;20;535625;523036;29286;81.3;79.4;4.4
68;2021-11-02;195;361;746;535820;523397;30032;81.4;79.5;4.6
68;2021-11-03;309;496;885;536129;523893;30917;81.4;79.5;4.7
68;2021-11-04;305;365;1305;536434;524258;32222;81.5;79.6;4.9
68;2021-11-05;500;754;2203;536934;525012;34425;81.5;79.7;5.2
68;2021-11-06;177;312;644;537111;525324;35069;81.6;79.8;5.3
68;2021-11-07;22;74;34;537133;525398;35103;81.6;79.8;5.3
68;2021-11-08;200;297;1197;537333;525695;36300;81.6;79.8;5.5
68;2021-11-09;186;341;1326;537519;526036;37626;81.6;79.9;5.7
68;2021-11-10;325;523;2307;537844;526559;39933;81.7;80.0;6.1
68;2021-11-11;7;40;25;537851;526599;39958;81.7;80.0;6.1
68;2021-11-12;345;704;3140;538196;527303;43098;81.7;80.1;6.5
68;2021-11-13;173;274;1040;538369;527577;44138;81.7;80.1;6.7
68;2021-11-14;29;59;83;538398;527636;44221;81.8;80.1;6.7
68;2021-11-15;255;287;2262;538653;527923;46483;81.8;80.2;7.1
68;2021-11-16;383;332;2787;539036;528255;49270;81.8;80.2;7.5
68;2021-11-17;312;389;2738;539348;528644;52008;81.9;80.3;7.9
68;2021-11-18;234;348;2214;539582;528992;54222;81.9;80.3;8.2
68;2021-11-19;379;533;3497;539961;529525;57719;82.0;80.4;8.8
68;2021-11-20;180;275;1202;540141;529800;58921;82.0;80.4;8.9
68;2021-11-21;3;45;48;540144;529845;58969;82.0;80.5;9.0
68;2021-11-22;328;250;2262;540472;530095;61231;82.1;80.5;9.3
68;2021-11-23;417;288;3182;540889;530383;64413;82.1;80.5;9.8
68;2021-11-24;343;321;3046;541232;530704;67459;82.2;80.6;10.2
68;2021-11-25;307;343;3615;541539;531047;71074;82.2;80.6;10.8
68;2021-11-26;476;552;5611;542015;531599;76685;82.3;80.7;11.6
68;2021-11-27;200;325;2195;542215;531924;78880;82.3;80.8;12.0
68;2021-11-28;25;47;459;542240;531971;79339;82.3;80.8;12.0
68;2021-11-29;230;274;4076;542470;532245;83415;82.4;80.8;12.7
68;2021-11-30;321;286;5682;542791;532531;89097;82.4;80.9;13.5
68;2021-12-01;211;344;5500;543002;532875;94597;82.5;80.9;14.4
68;2021-12-02;227;245;7556;543229;533120;102153;82.5;81.0;15.5
68;2021-12-03;279;459;8375;543508;533579;110528;82.5;81.0;16.8
68;2021-12-04;173;284;3241;543681;533863;113769;82.6;81.1;17.3
68;2021-12-05;27;90;921;543708;533953;114690;82.6;81.1;17.4
68;2021-12-06;215;334;6218;543923;534287;120908;82.6;81.1;18.4
68;2021-12-07;236;320;7313;544159;534607;128221;82.6;81.2;19.5
68;2021-12-08;269;467;6724;544428;535074;134945;82.7;81.2;20.5
68;2021-12-09;258;340;8175;544686;535414;143120;82.7;81.3;21.7
68;2021-12-10;317;456;8800;545003;535870;151920;82.8;81.4;23.1
68;2021-12-11;209;267;3881;545212;536137;155801;82.8;81.4;23.7
68;2021-12-12;50;93;1109;545262;536230;156910;82.8;81.4;23.8
68;2021-12-13;245;344;6658;545507;536574;163568;82.8;81.5;24.8
68;2021-12-14;239;424;7721;545746;536998;171289;82.9;81.5;26.0
68;2021-12-15;267;512;7964;546013;537510;179253;82.9;81.6;27.2
68;2021-12-16;296;374;9016;546309;537884;188269;83.0;81.7;28.6
68;2021-12-17;296;501;9271;546605;538385;197540;83.0;81.8;30.0
68;2021-12-18;159;207;3672;546764;538592;201212;83.0;81.8;30.6
68;2021-12-19;62;86;1234;546826;538678;202446;83.0;81.8;30.7
69;2020-12-27;2;0;0;2;0;0;0.0;0.0;0.0
69;2020-12-28;10;1;0;12;1;0;0.0;0.0;0.0
69;2020-12-29;6;0;0;18;1;0;0.0;0.0;0.0
69;2020-12-30;6;1;0;24;2;0;0.0;0.0;0.0
69;2020-12-31;13;3;0;37;5;0;0.0;0.0;0.0
69;2021-01-01;2;0;0;39;5;0;0.0;0.0;0.0
69;2021-01-02;3;0;0;42;5;0;0.0;0.0;0.0
69;2021-01-03;4;2;0;46;7;0;0.0;0.0;0.0
69;2021-01-04;16;0;0;62;7;0;0.0;0.0;0.0
69;2021-01-05;198;7;0;260;14;0;0.0;0.0;0.0
69;2021-01-06;468;6;0;728;20;0;0.0;0.0;0.0
69;2021-01-07;736;5;0;1464;25;0;0.1;0.0;0.0
69;2021-01-08;750;1;0;2214;26;0;0.1;0.0;0.0
69;2021-01-09;47;3;0;2261;29;0;0.1;0.0;0.0
69;2021-01-10;3;1;0;2264;30;0;0.1;0.0;0.0
69;2021-01-11;1020;3;0;3284;33;0;0.2;0.0;0.0
69;2021-01-12;1283;9;0;4567;42;0;0.3;0.0;0.0
69;2021-01-13;1261;3;0;5828;45;0;0.4;0.0;0.0
69;2021-01-14;2121;23;0;7949;68;0;0.5;0.0;0.0
69;2021-01-15;1734;8;0;9683;76;0;0.6;0.0;0.0
69;2021-01-16;891;4;0;10574;80;0;0.7;0.0;0.0
69;2021-01-17;264;3;0;10838;83;0;0.7;0.0;0.0
69;2021-01-18;1694;16;0;12532;99;0;0.8;0.0;0.0
69;2021-01-19;3517;31;0;16049;130;0;1.0;0.0;0.0
69;2021-01-20;4252;32;0;20301;162;0;1.3;0.0;0.0
69;2021-01-21;3915;43;0;24216;205;0;1.5;0.0;0.0
69;2021-01-22;3010;29;0;27226;234;0;1.7;0.0;0.0
69;2021-01-23;1224;3;0;28450;237;0;1.8;0.0;0.0
69;2021-01-24;105;1;0;28555;238;0;1.8;0.0;0.0
69;2021-01-25;2082;47;0;30637;285;0;1.9;0.0;0.0
69;2021-01-26;2449;88;0;33086;373;0;2.1;0.0;0.0
69;2021-01-27;2233;175;0;35319;548;0;2.2;0.0;0.0
69;2021-01-28;2275;356;0;37594;904;0;2.4;0.1;0.0
69;2021-01-29;2050;280;0;39644;1184;0;2.5;0.1;0.0
69;2021-01-30;881;4;0;40525;1188;0;2.5;0.1;0.0
69;2021-01-31;63;1;0;40588;1189;0;2.5;0.1;0.0
69;2021-02-01;1078;377;0;41666;1566;0;2.6;0.1;0.0
69;2021-02-02;1558;425;0;43224;1991;0;2.7;0.1;0.0
69;2021-02-03;1381;528;0;44605;2519;0;2.8;0.2;0.0
69;2021-02-04;1749;905;0;46354;3424;0;2.9;0.2;0.0
69;2021-02-05;791;796;0;47145;4220;0;3.0;0.3;0.0
69;2021-02-06;384;58;0;47529;4278;0;3.0;0.3;0.0
69;2021-02-07;15;7;0;47544;4285;0;3.0;0.3;0.0
69;2021-02-08;1060;986;0;48604;5271;0;3.1;0.3;0.0
69;2021-02-09;1948;2042;0;50552;7313;0;3.2;0.5;0.0
69;2021-02-10;1819;2519;0;52371;9832;0;3.3;0.6;0.0
69;2021-02-11;1768;3097;0;54139;12929;0;3.4;0.8;0.0
69;2021-02-12;1776;1992;0;55915;14921;0;3.5;0.9;0.0
69;2021-02-13;425;751;0;56340;15672;0;3.5;1.0;0.0
69;2021-02-14;86;47;0;56426;15719;0;3.5;1.0;0.0
69;2021-02-15;945;1750;0;57371;17469;0;3.6;1.1;0.0
69;2021-02-16;973;2382;0;58344;19851;0;3.7;1.2;0.0
69;2021-02-17;987;2337;0;59331;22188;0;3.7;1.4;0.0
69;2021-02-18;952;2267;0;60283;24455;0;3.8;1.5;0.0
69;2021-02-19;878;1824;0;61161;26279;0;3.8;1.7;0.0
69;2021-02-20;321;916;0;61482;27195;0;3.9;1.7;0.0
69;2021-02-21;47;70;0;61529;27265;0;3.9;1.7;0.0
69;2021-02-22;574;2076;0;62103;29341;0;3.9;1.8;0.0
69;2021-02-23;733;2093;0;62836;31434;0;3.9;2.0;0.0
69;2021-02-24;1009;2175;0;63845;33609;0;4.0;2.1;0.0
69;2021-02-25;2141;2630;0;65986;36239;0;4.1;2.3;0.0
69;2021-02-26;2671;1821;0;68657;38060;0;4.3;2.4;0.0
69;2021-02-27;907;552;0;69564;38612;0;4.4;2.4;0.0
69;2021-02-28;124;94;0;69688;38706;0;4.4;2.4;0.0
69;2021-03-01;2151;924;0;71839;39630;0;4.5;2.5;0.0
69;2021-03-02;3194;1418;0;75033;41048;0;4.7;2.6;0.0
69;2021-03-03;3547;1247;0;78580;42295;0;4.9;2.7;0.0
69;2021-03-04;4726;1362;0;83306;43657;0;5.2;2.7;0.0
69;2021-03-05;5753;1284;0;89059;44941;0;5.6;2.8;0.0
69;2021-03-06;3384;424;0;92443;45365;0;5.8;2.8;0.0
69;2021-03-07;732;61;0;93175;45426;0;5.9;2.9;0.0
69;2021-03-08;2832;1102;0;96007;46528;0;6.0;2.9;0.0
69;2021-03-09;4491;1244;0;100498;47772;0;6.3;3.0;0.0
69;2021-03-10;4844;1027;0;105342;48799;0;6.6;3.1;0.0
69;2021-03-11;6438;1043;0;111780;49842;0;7.0;3.1;0.0
69;2021-03-12;8416;1189;0;120196;51031;0;7.5;3.2;0.0
69;2021-03-13;4598;264;0;124794;51295;0;7.8;3.2;0.0
69;2021-03-14;2467;151;0;127261;51446;0;8.0;3.2;0.0
69;2021-03-15;4527;724;0;131788;52170;0;8.3;3.3;0.0
69;2021-03-16;3654;721;0;135442;52891;0;8.5;3.3;0.0
69;2021-03-17;3817;923;0;139259;53814;0;8.7;3.4;0.0
69;2021-03-18;4691;1573;0;143950;55387;0;9.0;3.5;0.0
69;2021-03-19;6380;1029;0;150330;56416;0;9.4;3.5;0.0
69;2021-03-20;3486;255;0;153816;56671;0;9.7;3.6;0.0
69;2021-03-21;1799;96;0;155615;56767;0;9.8;3.6;0.0
69;2021-03-22;4423;813;0;160038;57580;0;10.1;3.6;0.0
69;2021-03-23;7042;856;0;167080;58436;0;10.5;3.7;0.0
69;2021-03-24;6239;1017;0;173319;59453;0;10.9;3.7;0.0
69;2021-03-25;8289;1141;0;181608;60594;0;11.4;3.8;0.0
69;2021-03-26;8550;1335;0;190158;61929;0;11.9;3.9;0.0
69;2021-03-27;3099;804;0;193257;62733;0;12.1;3.9;0.0
69;2021-03-28;2055;184;0;195312;62917;0;12.3;4.0;0.0
69;2021-03-29;3999;2130;0;199311;65047;0;12.5;4.1;0.0
69;2021-03-30;7381;2603;0;206692;67650;0;13.0;4.2;0.0
69;2021-03-31;6033;3099;0;212725;70749;0;13.4;4.4;0.0
69;2021-04-01;8084;2699;0;220809;73448;0;13.9;4.6;0.0
69;2021-04-02;7935;3100;0;228744;76548;0;14.4;4.8;0.0
69;2021-04-03;4993;2070;0;233737;78618;0;14.7;4.9;0.0
69;2021-04-04;5907;535;0;239644;79153;0;15.0;5.0;0.0
69;2021-04-05;5501;774;0;245145;79927;0;15.4;5.0;0.0
69;2021-04-06;4984;3376;0;250129;83303;0;15.7;5.2;0.0
69;2021-04-07;5141;3746;0;255270;87049;0;16.0;5.5;0.0
69;2021-04-08;6323;3907;0;261593;90956;0;16.4;5.7;0.0
69;2021-04-09;9167;3763;0;270760;94719;0;17.0;5.9;0.0
69;2021-04-10;2992;2378;0;273752;97097;0;17.2;6.1;0.0
69;2021-04-11;1894;1741;0;275646;98838;0;17.3;6.2;0.0
69;2021-04-12;5306;3511;0;280952;102349;0;17.6;6.4;0.0
69;2021-04-13;7015;4016;0;287967;106365;0;18.1;6.7;0.0
69;2021-04-14;6613;4042;0;294580;110407;0;18.5;6.9;0.0
69;2021-04-15;7733;4437;0;302313;114844;0;19.0;7.2;0.0
69;2021-04-16;7783;4390;0;310096;119234;0;19.5;7.5;0.0
69;2021-04-17;4765;2225;0;314861;121459;0;19.8;7.6;0.0
69;2021-04-18;1698;1655;0;316559;123114;0;19.9;7.7;0.0
69;2021-04-19;6637;3666;0;323196;126780;0;20.3;8.0;0.0
69;2021-04-20;6451;4549;0;329647;131329;0;20.7;8.2;0.0
69;2021-04-21;5690;4286;0;335337;135615;0;21.1;8.5;0.0
69;2021-04-22;6337;5197;0;341674;140812;0;21.5;8.8;0.0
69;2021-04-23;6668;4755;0;348342;145567;0;21.9;9.1;0.0
69;2021-04-24;3229;2016;0;351571;147583;0;22.1;9.3;0.0
69;2021-04-25;2122;1467;0;353693;149050;0;22.2;9.4;0.0
69;2021-04-26;4591;3796;0;358284;152846;0;22.5;9.6;0.0
69;2021-04-27;6616;5107;0;364900;157953;0;22.9;9.9;0.0
69;2021-04-28;6369;4699;0;371269;162652;0;23.3;10.2;0.0
69;2021-04-29;6763;5279;0;378032;167931;0;23.7;10.5;0.0
69;2021-04-30;7089;5986;0;385121;173917;0;24.2;10.9;0.0
69;2021-05-01;3375;635;0;388496;174552;0;24.4;11.0;0.0
69;2021-05-02;1583;5210;0;390079;179762;0;24.5;11.3;0.0
69;2021-05-03;5745;7604;0;395824;187366;0;24.9;11.8;0.0
69;2021-05-04;7362;7605;0;403186;194971;0;25.3;12.2;0.0
69;2021-05-05;10377;5503;0;413563;200474;0;26.0;12.6;0.0
69;2021-05-06;11428;6056;0;424991;206530;0;26.7;13.0;0.0
69;2021-05-07;10824;6972;0;435815;213502;0;27.4;13.4;0.0
69;2021-05-08;4280;1588;0;440095;215090;0;27.6;13.5;0.0
69;2021-05-09;5935;2509;0;446030;217599;0;28.0;13.7;0.0
69;2021-05-10;6781;5984;0;452811;223583;0;28.4;14.0;0.0
69;2021-05-11;9849;6840;0;462660;230423;0;29.1;14.5;0.0
69;2021-05-12;12028;6601;0;474688;237024;0;29.8;14.9;0.0
69;2021-05-13;10778;2469;0;485466;239493;0;30.5;15.0;0.0
69;2021-05-14;12447;5130;0;497913;244623;0;31.3;15.4;0.0
69;2021-05-15;9204;2574;0;507117;247197;0;31.8;15.5;0.0
69;2021-05-16;8029;1758;0;515146;248955;0;32.4;15.6;0.0
69;2021-05-17;11054;5411;0;526200;254366;0;33.0;16.0;0.0
69;2021-05-18;12940;6049;0;539140;260415;0;33.9;16.4;0.0
69;2021-05-19;13210;5572;0;552350;265987;0;34.7;16.7;0.0
69;2021-05-20;11589;5827;0;563939;271814;0;35.4;17.1;0.0
69;2021-05-21;11483;6485;0;575422;278299;0;36.1;17.5;0.0
69;2021-05-22;7221;2585;0;582643;280884;0;36.6;17.6;0.0
69;2021-05-23;5165;1501;0;587808;282385;0;36.9;17.7;0.0
69;2021-05-24;9107;1961;0;596915;284346;0;37.5;17.9;0.0
69;2021-05-25;10336;6152;0;607251;290498;0;38.1;18.2;0.0
69;2021-05-26;10964;6010;0;618215;296508;0;38.8;18.6;0.0
69;2021-05-27;10932;6641;0;629147;303149;0;39.5;19.0;0.0
69;2021-05-28;11761;8576;0;640908;311725;0;40.2;19.6;0.0
69;2021-05-29;8451;5761;0;649359;317486;0;40.8;19.9;0.0
69;2021-05-30;7219;2871;0;656578;320357;0;41.2;20.1;0.0
69;2021-05-31;11189;6257;0;667767;326614;0;41.9;20.5;0.0
69;2021-06-01;12097;7332;0;679864;333946;0;42.7;21.0;0.0
69;2021-06-02;14198;6537;0;694062;340483;0;43.6;21.4;0.0
69;2021-06-03;15796;7216;0;709858;347699;0;44.6;21.8;0.0
69;2021-06-04;13498;8506;0;723356;356205;0;45.4;22.4;0.0
69;2021-06-05;10239;3535;0;733595;359740;0;46.1;22.6;0.0
69;2021-06-06;6981;1681;0;740576;361421;0;46.5;22.7;0.0
69;2021-06-07;11978;6901;0;752554;368322;0;47.3;23.1;0.0
69;2021-06-08;14535;8020;0;767089;376342;0;48.2;23.6;0.0
69;2021-06-09;13602;7236;0;780691;383578;0;49.0;24.1;0.0
69;2021-06-10;14349;7085;0;795040;390663;0;49.9;24.5;0.0
69;2021-06-11;14329;9487;0;809369;400150;0;50.8;25.1;0.0
69;2021-06-12;7898;4219;0;817267;404369;0;51.3;25.4;0.0
69;2021-06-13;4867;2014;0;822134;406383;0;51.6;25.5;0.0
69;2021-06-14;7253;8864;0;829387;415247;0;52.1;26.1;0.0
69;2021-06-15;9312;10614;0;838699;425861;0;52.7;26.7;0.0
69;2021-06-16;9539;11587;0;848238;437448;0;53.3;27.5;0.0
69;2021-06-17;9755;12399;0;857993;449847;0;53.9;28.3;0.0
69;2021-06-18;9967;14132;0;867960;463979;0;54.5;29.1;0.0
69;2021-06-19;5950;8276;0;873910;472255;0;54.9;29.7;0.0
69;2021-06-20;4408;4442;0;878318;476697;0;55.2;29.9;0.0
69;2021-06-21;5358;12094;0;883676;488791;0;55.5;30.7;0.0
69;2021-06-22;6189;13316;0;889865;502107;0;55.9;31.5;0.0
69;2021-06-23;7043;12633;0;896908;514740;0;56.3;32.3;0.0
69;2021-06-24;7623;13011;0;904531;527751;0;56.8;33.1;0.0
69;2021-06-25;6388;15947;0;910919;543698;0;57.2;34.1;0.0
69;2021-06-26;3566;9592;0;914485;553290;0;57.4;34.7;0.0
69;2021-06-27;2882;6993;0;917367;560283;0;57.6;35.2;0.0
69;2021-06-28;3987;14716;0;921354;574999;0;57.9;36.1;0.0
69;2021-06-29;4797;15268;0;926151;590267;0;58.2;37.1;0.0
69;2021-06-30;5923;14073;0;932074;604340;0;58.5;38.0;0.0
69;2021-07-01;7495;11991;0;939569;616331;0;59.0;38.7;0.0
69;2021-07-02;6498;14408;0;946067;630739;0;59.4;39.6;0.0
69;2021-07-03;5075;8900;0;951142;639639;0;59.7;40.2;0.0
69;2021-07-04;3472;5486;0;954614;645125;0;60.0;40.5;0.0
69;2021-07-05;5517;13248;0;960131;658373;0;60.3;41.3;0.0
69;2021-07-06;5434;14261;0;965565;672634;0;60.6;42.2;0.0
69;2021-07-07;6976;13417;0;972541;686051;0;61.1;43.1;0.0
69;2021-07-08;7162;13103;0;979703;699154;0;61.5;43.9;0.0
69;2021-07-09;7061;16264;0;986764;715418;0;62.0;44.9;0.0
69;2021-07-10;2980;10895;0;989744;726313;0;62.2;45.6;0.0
69;2021-07-11;3623;5434;0;993367;731747;0;62.4;46.0;0.0
69;2021-07-12;3920;16490;0;997287;748237;0;62.6;47.0;0.0
69;2021-07-13;6305;18551;0;1003592;766788;0;63.0;48.2;0.0
69;2021-07-14;5039;6543;0;1008631;773331;0;63.3;48.6;0.0
69;2021-07-15;7930;18508;0;1016561;791839;0;63.8;49.7;0.0
69;2021-07-16;9749;17534;0;1026310;809373;0;64.5;50.8;0.0
69;2021-07-17;5110;10939;0;1031420;820312;0;64.8;51.5;0.0
69;2021-07-18;3135;7392;0;1034555;827704;0;65.0;52.0;0.0
69;2021-07-19;6878;14932;0;1041433;842636;0;65.4;52.9;0.0
69;2021-07-20;9347;17003;0;1050780;859639;0;66.0;54.0;0.0
69;2021-07-21;9680;15827;0;1060460;875466;0;66.6;55.0;0.0
69;2021-07-22;11526;15317;0;1071986;890783;0;67.3;55.9;0.0
69;2021-07-23;10994;15734;3;1082980;906517;3;68.0;56.9;0.0
69;2021-07-24;6003;9982;0;1088983;916499;3;68.4;57.6;0.0
69;2021-07-25;4242;5690;0;1093225;922189;3;68.7;57.9;0.0
69;2021-07-26;8728;11741;0;1101953;933930;3;69.2;58.7;0.0
69;2021-07-27;12566;11752;1;1114519;945682;4;70.0;59.4;0.0
69;2021-07-28;11723;11166;0;1126242;956848;4;70.7;60.1;0.0
69;2021-07-29;13892;10864;1;1140134;967712;5;71.6;60.8;0.0
69;2021-07-30;13183;11193;1;1153317;978905;6;72.4;61.5;0.0
69;2021-07-31;7736;6677;0;1161053;985582;6;72.9;61.9;0.0
69;2021-08-01;4423;4461;0;1165476;990043;6;73.2;62.2;0.0
69;2021-08-02;10769;8327;0;1176245;998370;6;73.9;62.7;0.0
69;2021-08-03;12136;7667;0;1188381;1006037;6;74.6;63.2;0.0
69;2021-08-04;11648;7407;0;1200029;1013444;6;75.4;63.6;0.0
69;2021-08-05;10350;7148;0;1210379;1020592;6;76.0;64.1;0.0
69;2021-08-06;9286;7612;0;1219665;1028204;6;76.6;64.6;0.0
69;2021-08-07;4476;4447;1;1224141;1032651;7;76.9;64.9;0.0
69;2021-08-08;3588;3175;0;1227729;1035826;7;77.1;65.1;0.0
69;2021-08-09;6819;8598;0;1234548;1044424;7;77.5;65.6;0.0
69;2021-08-10;7425;6935;0;1241973;1051359;7;78.0;66.0;0.0
69;2021-08-11;7132;7452;0;1249105;1058811;7;78.4;66.5;0.0
69;2021-08-12;6559;6894;0;1255664;1065705;7;78.9;66.9;0.0
69;2021-08-13;6134;8087;0;1261798;1073792;7;79.2;67.4;0.0
69;2021-08-14;3917;5142;0;1265715;1078934;7;79.5;67.8;0.0
69;2021-08-15;2094;2242;0;1267809;1081176;7;79.6;67.9;0.0
69;2021-08-16;4898;8854;0;1272707;1090030;7;79.9;68.5;0.0
69;2021-08-17;5821;8223;0;1278528;1098253;7;80.3;69.0;0.0
69;2021-08-18;5520;9200;0;1284048;1107453;7;80.6;69.5;0.0
69;2021-08-19;5468;8880;0;1289516;1116333;7;81.0;70.1;0.0
69;2021-08-20;5338;8683;0;1294854;1125016;7;81.3;70.7;0.0
69;2021-08-21;2465;3999;0;1297319;1129015;7;81.5;70.9;0.0
69;2021-08-22;1609;2207;0;1298928;1131222;7;81.6;71.0;0.0
69;2021-08-23;3380;11550;0;1302308;1142772;7;81.8;71.8;0.0
69;2021-08-24;4401;12095;0;1306709;1154867;7;82.1;72.5;0.0
69;2021-08-25;3877;11443;0;1310586;1166310;7;82.3;73.2;0.0
69;2021-08-26;3836;10078;0;1314422;1176388;7;82.5;73.9;0.0
69;2021-08-27;3929;12782;0;1318351;1189170;7;82.8;74.7;0.0
69;2021-08-28;1691;7403;0;1320042;1196573;7;82.9;75.1;0.0
69;2021-08-29;1089;5370;0;1321131;1201943;7;83.0;75.5;0.0
69;2021-08-30;3012;10150;88;1324143;1212093;95;83.2;76.1;0.0
69;2021-08-31;3581;8612;199;1327724;1220705;294;83.4;76.7;0.0
69;2021-09-01;3903;7908;381;1331627;1228613;675;83.6;77.2;0.0
69;2021-09-02;3732;6945;902;1335359;1235558;1577;83.9;77.6;0.1
69;2021-09-03;3578;8921;853;1338937;1244479;2430;84.1;78.2;0.2
69;2021-09-04;1977;6905;214;1340914;1251384;2644;84.2;78.6;0.2
69;2021-09-05;1120;2894;230;1342034;1254278;2874;84.3;78.8;0.2
69;2021-09-06;2163;5008;819;1344197;1259286;3693;84.4;79.1;0.2
69;2021-09-07;1986;4586;957;1346183;1263872;4650;84.5;79.4;0.3
69;2021-09-08;2437;5349;705;1348620;1269221;5355;84.7;79.7;0.3
69;2021-09-09;2126;4468;1003;1350746;1273689;6358;84.8;80.0;0.4
69;2021-09-10;2418;5385;1053;1353164;1279074;7411;85.0;80.3;0.5
69;2021-09-11;1467;4150;219;1354631;1283224;7630;85.1;80.6;0.5
69;2021-09-12;409;1715;112;1355040;1284939;7742;85.1;80.7;0.5
69;2021-09-13;1505;3515;1045;1356545;1288454;8787;85.2;80.9;0.6
69;2021-09-14;1612;3135;1505;1358157;1291589;10292;85.3;81.1;0.6
69;2021-09-15;1777;4171;1207;1359934;1295760;11499;85.4;81.4;0.7
69;2021-09-16;1422;2680;1522;1361356;1298440;13021;85.5;81.5;0.8
69;2021-09-17;1641;4099;1577;1362997;1302539;14598;85.6;81.8;0.9
69;2021-09-18;1005;3503;265;1364002;1306042;14863;85.7;82.0;0.9
69;2021-09-19;383;1188;121;1364385;1307230;14984;85.7;82.1;0.9
69;2021-09-20;888;2366;1036;1365273;1309596;16020;85.7;82.2;1.0
69;2021-09-21;877;2619;1472;1366150;1312215;17492;85.8;82.4;1.1
69;2021-09-22;1031;3566;1097;1367181;1315781;18589;85.9;82.6;1.2
69;2021-09-23;804;2517;1470;1367985;1318298;20059;85.9;82.8;1.3
69;2021-09-24;1153;3477;1074;1369138;1321775;21133;86.0;83.0;1.3
69;2021-09-25;665;2330;228;1369803;1324105;21361;86.0;83.2;1.3
69;2021-09-26;263;958;64;1370066;1325063;21425;86.0;83.2;1.3
69;2021-09-27;604;1735;964;1370670;1326798;22389;86.1;83.3;1.4
69;2021-09-28;772;1696;1312;1371442;1328494;23701;86.1;83.4;1.5
69;2021-09-29;1018;2728;1214;1372460;1331222;24915;86.2;83.6;1.6
69;2021-09-30;872;1857;1294;1373332;1333079;26209;86.2;83.7;1.6
69;2021-10-01;1738;2979;1768;1375070;1336058;27977;86.4;83.9;1.8
69;2021-10-02;924;1873;407;1375994;1337931;28384;86.4;84.0;1.8
69;2021-10-03;255;513;160;1376249;1338444;28544;86.4;84.1;1.8
69;2021-10-04;919;1653;1374;1377168;1340097;29918;86.5;84.2;1.9
69;2021-10-05;767;1329;1509;1377935;1341426;31427;86.5;84.2;2.0
69;2021-10-06;1069;2010;1605;1379004;1343436;33032;86.6;84.4;2.1
69;2021-10-07;819;1400;1765;1379823;1344836;34797;86.7;84.5;2.2
69;2021-10-08;1218;2140;2193;1381041;1346976;36990;86.7;84.6;2.3
69;2021-10-09;649;1210;584;1381690;1348186;37574;86.8;84.7;2.4
69;2021-10-10;68;271;132;1381758;1348457;37706;86.8;84.7;2.4
69;2021-10-11;593;1198;1485;1382351;1349655;39191;86.8;84.8;2.5
69;2021-10-12;692;1043;1777;1383043;1350698;40968;86.9;84.8;2.6
69;2021-10-13;1056;1676;2264;1384099;1352374;43232;86.9;84.9;2.7
69;2021-10-14;768;1205;2248;1384867;1353579;45480;87.0;85.0;2.9
69;2021-10-15;1093;1700;2878;1385960;1355279;48358;87.0;85.1;3.0
69;2021-10-16;702;1129;751;1386662;1356408;49109;87.1;85.2;3.1
69;2021-10-17;31;155;64;1386693;1356563;49173;87.1;85.2;3.1
69;2021-10-18;536;809;1876;1387229;1357372;51049;87.1;85.2;3.2
69;2021-10-19;295;728;2175;1387524;1358100;53224;87.1;85.3;3.3
69;2021-10-20;582;1175;2887;1388106;1359275;56111;87.2;85.4;3.5
69;2021-10-21;336;838;2722;1388442;1360113;58833;87.2;85.4;3.7
69;2021-10-22;510;1272;3081;1388952;1361385;61914;87.2;85.5;3.9
69;2021-10-23;456;987;1176;1389408;1362372;63090;87.3;85.6;4.0
69;2021-10-24;21;87;89;1389429;1362459;63179;87.3;85.6;4.0
69;2021-10-25;339;718;2128;1389768;1363177;65307;87.3;85.6;4.1
69;2021-10-26;306;620;2152;1390074;1363797;67459;87.3;85.6;4.2
69;2021-10-27;471;1185;3332;1390545;1364982;70791;87.3;85.7;4.4
69;2021-10-28;370;715;2681;1390915;1365697;73472;87.3;85.8;4.6
69;2021-10-29;436;1023;3368;1391351;1366720;76840;87.4;85.8;4.8
69;2021-10-30;225;606;1048;1391576;1367326;77888;87.4;85.9;4.9
69;2021-10-31;26;69;69;1391602;1367395;77957;87.4;85.9;4.9
69;2021-11-01;97;46;24;1391699;1367441;77981;87.4;85.9;4.9
69;2021-11-02;315;746;2259;1392014;1368187;80240;87.4;85.9;5.0
69;2021-11-03;425;972;3709;1392439;1369159;83949;87.4;86.0;5.3
69;2021-11-04;342;720;3415;1392781;1369879;87364;87.5;86.0;5.5
69;2021-11-05;467;992;4453;1393248;1370871;91817;87.5;86.1;5.8
69;2021-11-06;229;604;1352;1393477;1371475;93169;87.5;86.1;5.9
69;2021-11-07;24;48;102;1393501;1371523;93271;87.5;86.1;5.9
69;2021-11-08;200;566;3165;1393701;1372089;96436;87.5;86.2;6.1
69;2021-11-09;218;507;4114;1393919;1372596;100550;87.5;86.2;6.3
69;2021-11-10;455;845;4956;1394374;1373441;105506;87.6;86.3;6.6
69;2021-11-11;80;120;714;1394454;1373561;106220;87.6;86.3;6.7
69;2021-11-12;409;649;5910;1394863;1374210;112130;87.6;86.3;7.0
69;2021-11-13;285;440;1956;1395148;1374650;114086;87.6;86.3;7.2
69;2021-11-14;17;35;165;1395165;1374685;114251;87.6;86.3;7.2
69;2021-11-15;209;439;3933;1395374;1375124;118184;87.6;86.4;7.4
69;2021-11-16;276;476;5072;1395650;1375600;123256;87.6;86.4;7.7
69;2021-11-17;441;670;5511;1396091;1376270;128767;87.7;86.4;8.1
69;2021-11-18;247;418;5714;1396338;1376688;134481;87.7;86.5;8.4
69;2021-11-19;493;723;7568;1396831;1377411;142049;87.7;86.5;8.9
69;2021-11-20;331;374;2223;1397162;1377785;144272;87.7;86.5;9.1
69;2021-11-21;24;71;147;1397186;1377856;144419;87.7;86.5;9.1
69;2021-11-22;282;350;4621;1397468;1378206;149040;87.8;86.6;9.4
69;2021-11-23;282;342;5303;1397750;1378548;154343;87.8;86.6;9.7
69;2021-11-24;467;609;6187;1398217;1379157;160530;87.8;86.6;10.1
69;2021-11-25;295;424;7258;1398512;1379581;167788;87.8;86.6;10.5
69;2021-11-26;399;596;11816;1398911;1380177;179604;87.9;86.7;11.3
69;2021-11-27;368;547;6274;1399279;1380724;185878;87.9;86.7;11.7
69;2021-11-28;32;69;586;1399311;1380793;186464;87.9;86.7;11.7
69;2021-11-29;206;318;8166;1399517;1381111;194630;87.9;86.7;12.2
69;2021-11-30;251;384;10774;1399768;1381495;205404;87.9;86.8;12.9
69;2021-12-01;322;522;11740;1400090;1382017;217144;87.9;86.8;13.6
69;2021-12-02;261;342;14199;1400351;1382359;231343;87.9;86.8;14.5
69;2021-12-03;305;538;17460;1400656;1382897;248803;88.0;86.8;15.6
69;2021-12-04;186;413;9270;1400842;1383310;258073;88.0;86.9;16.2
69;2021-12-05;32;87;3261;1400874;1383397;261334;88.0;86.9;16.4
69;2021-12-06;198;393;12706;1401072;1383790;274040;88.0;86.9;17.2
69;2021-12-07;256;432;16277;1401328;1384222;290317;88.0;86.9;18.2
69;2021-12-08;331;578;13936;1401659;1384800;304253;88.0;87.0;19.1
69;2021-12-09;246;402;16972;1401905;1385202;321225;88.0;87.0;20.2
69;2021-12-10;307;534;19567;1402212;1385736;340792;88.1;87.0;21.4
69;2021-12-11;211;406;9140;1402423;1386142;349932;88.1;87.1;22.0
69;2021-12-12;41;98;2875;1402464;1386240;352807;88.1;87.1;22.2
69;2021-12-13;251;421;17113;1402715;1386661;369920;88.1;87.1;23.2
69;2021-12-14;284;394;21334;1402999;1387055;391254;88.1;87.1;24.6
69;2021-12-15;309;532;18878;1403308;1387587;410132;88.1;87.1;25.8
69;2021-12-16;307;467;22530;1403615;1388054;432662;88.1;87.2;27.2
69;2021-12-17;359;554;24917;1403974;1388608;457579;88.2;87.2;28.7
69;2021-12-18;216;338;12188;1404190;1388946;469767;88.2;87.2;29.5
69;2021-12-19;90;110;7419;1404280;1389056;477186;88.2;87.2;30.0
70;2020-12-27;0;0;0;0;0;0;0.0;0.0;0.0
70;2020-12-28;0;0;0;0;0;0;0.0;0.0;0.0
70;2020-12-29;0;0;0;0;0;0;0.0;0.0;0.0
70;2020-12-30;0;0;0;0;0;0;0.0;0.0;0.0
70;2020-12-31;0;0;0;0;0;0;0.0;0.0;0.0
70;2021-01-01;1;0;0;1;0;0;0.0;0.0;0.0
70;2021-01-02;0;0;0;1;0;0;0.0;0.0;0.0
70;2021-01-03;0;0;0;1;0;0;0.0;0.0;0.0
70;2021-01-04;0;0;0;1;0;0;0.0;0.0;0.0
70;2021-01-05;2;1;0;3;1;0;0.0;0.0;0.0
70;2021-01-06;26;0;0;29;1;0;0.0;0.0;0.0
70;2021-01-07;129;0;0;158;1;0;0.1;0.0;0.0
70;2021-01-08;67;0;0;225;1;0;0.1;0.0;0.0
70;2021-01-09;19;1;0;244;2;0;0.1;0.0;0.0
70;2021-01-10;0;0;0;244;2;0;0.1;0.0;0.0
70;2021-01-11;175;1;0;419;3;0;0.2;0.0;0.0
70;2021-01-12;240;2;0;659;5;0;0.3;0.0;0.0
70;2021-01-13;219;2;0;878;7;0;0.4;0.0;0.0
70;2021-01-14;214;5;0;1092;12;0;0.5;0.0;0.0
70;2021-01-15;218;3;0;1310;15;0;0.6;0.0;0.0
70;2021-01-16;80;0;0;1390;15;0;0.7;0.0;0.0
70;2021-01-17;7;0;0;1397;15;0;0.7;0.0;0.0
70;2021-01-18;418;0;0;1815;15;0;0.9;0.0;0.0
70;2021-01-19;493;2;0;2308;17;0;1.1;0.0;0.0
70;2021-01-20;495;1;0;2803;18;0;1.4;0.0;0.0
70;2021-01-21;671;3;0;3474;21;0;1.7;0.0;0.0
70;2021-01-22;503;3;0;3977;24;0;2.0;0.0;0.0
70;2021-01-23;250;2;0;4227;26;0;2.1;0.0;0.0
70;2021-01-24;13;0;0;4240;26;0;2.1;0.0;0.0
70;2021-01-25;381;1;0;4621;27;0;2.3;0.0;0.0
70;2021-01-26;367;3;0;4988;30;0;2.5;0.0;0.0
70;2021-01-27;344;14;0;5332;44;0;2.6;0.0;0.0
70;2021-01-28;351;39;0;5683;83;0;2.8;0.0;0.0
70;2021-01-29;329;86;0;6012;169;0;3.0;0.1;0.0
70;2021-01-30;249;20;0;6261;189;0;3.1;0.1;0.0
70;2021-01-31;1;0;0;6262;189;0;3.1;0.1;0.0
70;2021-02-01;260;58;0;6522;247;0;3.2;0.1;0.0
70;2021-02-02;289;127;0;6811;374;0;3.3;0.2;0.0
70;2021-02-03;261;87;0;7072;461;0;3.5;0.2;0.0
70;2021-02-04;288;157;0;7360;618;0;3.6;0.3;0.0
70;2021-02-05;263;117;0;7623;735;0;3.7;0.4;0.0
70;2021-02-06;212;45;0;7835;780;0;3.9;0.4;0.0
70;2021-02-07;0;0;0;7835;780;0;3.9;0.4;0.0
70;2021-02-08;184;250;0;8019;1030;0;3.9;0.5;0.0
70;2021-02-09;211;245;0;8230;1275;0;4.0;0.6;0.0
70;2021-02-10;243;294;0;8473;1569;0;4.2;0.8;0.0
70;2021-02-11;377;365;0;8850;1934;0;4.4;1.0;0.0
70;2021-02-12;228;499;0;9078;2433;0;4.5;1.2;0.0
70;2021-02-13;93;223;0;9171;2656;0;4.5;1.3;0.0
70;2021-02-14;1;31;0;9172;2687;0;4.5;1.3;0.0
70;2021-02-15;82;383;0;9254;3070;0;4.6;1.5;0.0
70;2021-02-16;115;440;0;9369;3510;0;4.6;1.7;0.0
70;2021-02-17;172;362;0;9541;3872;0;4.7;1.9;0.0
70;2021-02-18;213;300;0;9754;4172;0;4.8;2.1;0.0
70;2021-02-19;195;230;0;9949;4402;0;4.9;2.2;0.0
70;2021-02-20;193;91;0;10142;4493;0;5.0;2.2;0.0
70;2021-02-21;3;9;0;10145;4502;0;5.0;2.2;0.0
70;2021-02-22;114;245;0;10259;4747;0;5.0;2.3;0.0
70;2021-02-23;129;271;0;10388;5018;0;5.1;2.5;0.0
70;2021-02-24;157;267;0;10545;5285;0;5.2;2.6;0.0
70;2021-02-25;348;261;0;10893;5546;0;5.4;2.7;0.0
70;2021-02-26;392;184;0;11285;5730;0;5.5;2.8;0.0
70;2021-02-27;157;224;0;11442;5954;0;5.6;2.9;0.0
70;2021-02-28;0;3;0;11442;5957;0;5.6;2.9;0.0
70;2021-03-01;275;254;0;11717;6211;0;5.8;3.1;0.0
70;2021-03-02;497;290;0;12214;6501;0;6.0;3.2;0.0
70;2021-03-03;483;270;0;12697;6771;0;6.2;3.3;0.0
70;2021-03-04;694;296;0;13391;7067;0;6.6;3.5;0.0
70;2021-03-05;787;276;0;14178;7343;0;7.0;3.6;0.0
70;2021-03-06;546;121;0;14724;7464;0;7.2;3.7;0.0
70;2021-03-07;230;24;0;14954;7488;0;7.4;3.7;0.0
70;2021-03-08;563;243;0;15517;7731;0;7.6;3.8;0.0
70;2021-03-09;861;221;0;16378;7952;0;8.1;3.9;0.0
70;2021-03-10;654;214;0;17032;8166;0;8.4;4.0;0.0
70;2021-03-11;786;270;0;17818;8436;0;8.8;4.1;0.0
70;2021-03-12;1055;183;0;18873;8619;0;9.3;4.2;0.0
70;2021-03-13;614;128;0;19487;8747;0;9.6;4.3;0.0
70;2021-03-14;22;4;0;19509;8751;0;9.6;4.3;0.0
70;2021-03-15;748;107;0;20257;8858;0;10.0;4.4;0.0
70;2021-03-16;651;103;0;20908;8961;0;10.3;4.4;0.0
70;2021-03-17;580;179;0;21488;9140;0;10.6;4.5;0.0
70;2021-03-18;645;148;0;22133;9288;0;10.9;4.6;0.0
70;2021-03-19;981;150;0;23114;9438;0;11.4;4.6;0.0
70;2021-03-20;652;187;0;23766;9625;0;11.7;4.7;0.0
70;2021-03-21;13;0;0;23779;9625;0;11.7;4.7;0.0
70;2021-03-22;807;100;0;24586;9725;0;12.1;4.8;0.0
70;2021-03-23;1320;174;0;25906;9899;0;12.7;4.9;0.0
70;2021-03-24;1279;113;0;27185;10012;0;13.4;4.9;0.0
70;2021-03-25;1283;199;0;28468;10211;0;14.0;5.0;0.0
70;2021-03-26;1540;305;0;30008;10516;0;14.8;5.2;0.0
70;2021-03-27;983;123;0;30991;10639;0;15.2;5.2;0.0
70;2021-03-28;10;14;0;31001;10653;0;15.2;5.2;0.0
70;2021-03-29;734;399;0;31735;11052;0;15.6;5.4;0.0
70;2021-03-30;1095;289;0;32830;11341;0;16.1;5.6;0.0
70;2021-03-31;934;310;0;33764;11651;0;16.6;5.7;0.0
70;2021-04-01;1170;415;0;34934;12066;0;17.2;5.9;0.0
70;2021-04-02;1272;330;0;36206;12396;0;17.8;6.1;0.0
70;2021-04-03;617;307;0;36823;12703;0;18.1;6.2;0.0
70;2021-04-04;9;3;0;36832;12706;0;18.1;6.2;0.0
70;2021-04-05;10;2;0;36842;12708;0;18.1;6.2;0.0
70;2021-04-06;822;543;0;37664;13251;0;18.5;6.5;0.0
70;2021-04-07;862;580;0;38526;13831;0;18.9;6.8;0.0
70;2021-04-08;1336;553;0;39862;14384;0;19.6;7.1;0.0
70;2021-04-09;1445;568;0;41307;14952;0;20.3;7.4;0.0
70;2021-04-10;847;319;0;42154;15271;0;20.7;7.5;0.0
70;2021-04-11;32;7;0;42186;15278;0;20.7;7.5;0.0
70;2021-04-12;712;667;0;42898;15945;0;21.1;7.8;0.0
70;2021-04-13;992;779;0;43890;16724;0;21.6;8.2;0.0
70;2021-04-14;859;566;0;44749;17290;0;22.0;8.5;0.0
70;2021-04-15;1161;610;0;45910;17900;0;22.6;8.8;0.0
70;2021-04-16;1271;551;0;47181;18451;0;23.2;9.1;0.0
70;2021-04-17;684;469;0;47865;18920;0;23.5;9.3;0.0
70;2021-04-18;62;6;0;47927;18926;0;23.6;9.3;0.0
70;2021-04-19;577;845;0;48504;19771;0;23.9;9.7;0.0
70;2021-04-20;737;855;0;49241;20626;0;24.2;10.1;0.0
70;2021-04-21;565;904;0;49806;21530;0;24.5;10.6;0.0
70;2021-04-22;843;854;0;50649;22384;0;24.9;11.0;0.0
70;2021-04-23;926;800;0;51575;23184;0;25.4;11.4;0.0
70;2021-04-24;457;650;0;52032;23834;0;25.6;11.7;0.0
70;2021-04-25;17;7;0;52049;23841;0;25.6;11.7;0.0
70;2021-04-26;1064;647;0;53113;24488;0;26.1;12.0;0.0
70;2021-04-27;1220;800;0;54333;25288;0;26.7;12.4;0.0
70;2021-04-28;958;821;0;55291;26109;0;27.2;12.8;0.0
70;2021-04-29;1406;914;0;56697;27023;0;27.9;13.3;0.0
70;2021-04-30;1585;907;0;58282;27930;0;28.7;13.7;0.0
70;2021-05-01;1583;130;0;59865;28060;0;29.4;13.8;0.0
70;2021-05-02;33;5;0;59898;28065;0;29.5;13.8;0.0
70;2021-05-03;1237;563;0;61135;28628;0;30.1;14.1;0.0
70;2021-05-04;1334;793;0;62469;29421;0;30.7;14.5;0.0
70;2021-05-05;1213;886;0;63682;30307;0;31.3;14.9;0.0
70;2021-05-06;1851;1288;0;65533;31595;0;32.2;15.5;0.0
70;2021-05-07;2089;1297;0;67622;32892;0;33.3;16.2;0.0
70;2021-05-08;1224;189;0;68846;33081;0;33.9;16.3;0.0
70;2021-05-09;38;64;0;68884;33145;0;33.9;16.3;0.0
70;2021-05-10;1048;970;0;69932;34115;0;34.4;16.8;0.0
70;2021-05-11;1279;1128;0;71211;35243;0;35.0;17.3;0.0
70;2021-05-12;1209;901;0;72420;36144;0;35.6;17.8;0.0
70;2021-05-13;1552;169;0;73972;36313;0;36.4;17.9;0.0
70;2021-05-14;2095;740;0;76067;37053;0;37.4;18.2;0.0
70;2021-05-15;2367;505;0;78434;37558;0;38.6;18.5;0.0
70;2021-05-16;900;68;0;79334;37626;0;39.0;18.5;0.0
70;2021-05-17;1278;390;0;80612;38016;0;39.6;18.7;0.0
70;2021-05-18;1399;602;0;82011;38618;0;40.3;19.0;0.0
70;2021-05-19;1564;554;0;83575;39172;0;41.1;19.3;0.0
70;2021-05-20;1722;652;0;85297;39824;0;41.9;19.6;0.0
70;2021-05-21;1776;866;0;87073;40690;0;42.8;20.0;0.0
70;2021-05-22;1146;651;0;88219;41341;0;43.4;20.3;0.0
70;2021-05-23;59;20;0;88278;41361;0;43.4;20.3;0.0
70;2021-05-24;236;45;0;88514;41406;0;43.5;20.4;0.0
70;2021-05-25;953;947;0;89467;42353;0;44.0;20.8;0.0
70;2021-05-26;1040;963;0;90507;43316;0;44.5;21.3;0.0
70;2021-05-27;1301;1019;0;91808;44335;0;45.1;21.8;0.0
70;2021-05-28;1511;1220;0;93319;45555;0;45.9;22.4;0.0
70;2021-05-29;1252;577;0;94571;46132;0;46.5;22.7;0.0
70;2021-05-30;10;22;0;94581;46154;0;46.5;22.7;0.0
70;2021-05-31;1007;717;0;95588;46871;0;47.0;23.0;0.0
70;2021-06-01;1284;926;0;96872;47797;0;47.6;23.5;0.0
70;2021-06-02;1146;755;0;98018;48552;0;48.2;23.9;0.0
70;2021-06-03;1344;930;0;99362;49482;0;48.9;24.3;0.0
70;2021-06-04;1387;1180;0;100749;50662;0;49.5;24.9;0.0
70;2021-06-05;960;638;0;101709;51300;0;50.0;25.2;0.0
70;2021-06-06;564;85;0;102273;51385;0;50.3;25.3;0.0
70;2021-06-07;1073;1029;0;103346;52414;0;50.8;25.8;0.0
70;2021-06-08;1300;1218;0;104646;53632;0;51.5;26.4;0.0
70;2021-06-09;1126;981;0;105772;54613;0;52.0;26.9;0.0
70;2021-06-10;1400;903;0;107172;55516;0;52.7;27.3;0.0
70;2021-06-11;1587;1947;0;108759;57463;0;53.5;28.3;0.0
70;2021-06-12;855;1892;0;109614;59355;0;53.9;29.2;0.0
70;2021-06-13;191;28;0;109805;59383;0;54.0;29.2;0.0
70;2021-06-14;550;1237;0;110355;60620;0;54.3;29.8;0.0
70;2021-06-15;548;1470;0;110903;62090;0;54.5;30.5;0.0
70;2021-06-16;717;1383;0;111620;63473;0;54.9;31.2;0.0
70;2021-06-17;1008;2108;0;112628;65581;0;55.4;32.2;0.0
70;2021-06-18;1053;2254;0;113681;67835;0;55.9;33.4;0.0
70;2021-06-19;1058;1524;0;114739;69359;0;56.4;34.1;0.0
70;2021-06-20;11;19;0;114750;69378;0;56.4;34.1;0.0
70;2021-06-21;696;1477;0;115446;70855;0;56.8;34.8;0.0
70;2021-06-22;683;1610;0;116129;72465;0;57.1;35.6;0.0
70;2021-06-23;627;1551;0;116756;74016;0;57.4;36.4;0.0
70;2021-06-24;804;2044;0;117560;76060;0;57.8;37.4;0.0
70;2021-06-25;693;2628;0;118253;78688;0;58.1;38.7;0.0
70;2021-06-26;860;2025;0;119113;80713;0;58.6;39.7;0.0
70;2021-06-27;162;709;0;119275;81422;0;58.6;40.0;0.0
70;2021-06-28;369;1449;0;119644;82871;0;58.8;40.7;0.0
70;2021-06-29;413;1735;0;120057;84606;0;59.0;41.6;0.0
70;2021-06-30;441;1723;0;120498;86329;0;59.3;42.4;0.0
70;2021-07-01;634;1763;0;121132;88092;0;59.6;43.3;0.0
70;2021-07-02;846;1636;0;121978;89728;0;60.0;44.1;0.0
70;2021-07-03;785;1030;0;122763;90758;0;60.4;44.6;0.0
70;2021-07-04;43;95;0;122806;90853;0;60.4;44.7;0.0
70;2021-07-05;616;1111;0;123422;91964;0;60.7;45.2;0.0
70;2021-07-06;687;1382;0;124109;93346;0;61.0;45.9;0.0
70;2021-07-07;530;1430;0;124639;94776;0;61.3;46.6;0.0
70;2021-07-08;732;1495;0;125371;96271;0;61.6;47.3;0.0
70;2021-07-09;848;1746;0;126219;98017;0;62.1;48.2;0.0
70;2021-07-10;745;1040;0;126964;99057;0;62.4;48.7;0.0
70;2021-07-11;18;48;0;126982;99105;0;62.4;48.7;0.0
70;2021-07-12;454;1420;0;127436;100525;0;62.7;49.4;0.0
70;2021-07-13;932;1916;0;128368;102441;0;63.1;50.4;0.0
70;2021-07-14;72;32;0;128440;102473;0;63.2;50.4;0.0
70;2021-07-15;1298;1677;0;129738;104150;0;63.8;51.2;0.0
70;2021-07-16;1602;2077;0;131340;106227;0;64.6;52.2;0.0
70;2021-07-17;1354;1420;0;132694;107647;0;65.2;52.9;0.0
70;2021-07-18;852;617;0;133546;108264;0;65.7;53.2;0.0
70;2021-07-19;931;1147;0;134477;109411;0;66.1;53.8;0.0
70;2021-07-20;1319;1411;0;135796;110822;0;66.8;54.5;0.0
70;2021-07-21;1224;1352;0;137020;112174;0;67.4;55.2;0.0
70;2021-07-22;1676;1629;0;138696;113803;0;68.2;56.0;0.0
70;2021-07-23;1574;2323;0;140270;116126;0;69.0;57.1;0.0
70;2021-07-24;1245;1744;0;141515;117870;0;69.6;58.0;0.0
70;2021-07-25;83;69;0;141598;117939;0;69.6;58.0;0.0
70;2021-07-26;1120;1039;0;142718;118978;0;70.2;58.5;0.0
70;2021-07-27;1406;1000;0;144124;119978;0;70.9;59.0;0.0
70;2021-07-28;1316;1067;0;145440;121045;0;71.5;59.5;0.0
70;2021-07-29;1722;1239;0;147162;122284;0;72.4;60.1;0.0
70;2021-07-30;1890;1323;0;149052;123607;0;73.3;60.8;0.0
70;2021-07-31;1582;1060;0;150634;124667;0;74.1;61.3;0.0
70;2021-08-01;114;17;0;150748;124684;0;74.1;61.3;0.0
70;2021-08-02;802;751;0;151550;125435;0;74.5;61.7;0.0
70;2021-08-03;1285;1036;0;152835;126471;0;75.2;62.2;0.0
70;2021-08-04;1099;857;0;153934;127328;0;75.7;62.6;0.0
70;2021-08-05;1423;1071;0;155357;128399;0;76.4;63.1;0.0
70;2021-08-06;1597;1309;0;156954;129708;0;77.2;63.8;0.0
70;2021-08-07;1039;972;0;157993;130680;0;77.7;64.3;0.0
70;2021-08-08;50;79;0;158043;130759;0;77.7;64.3;0.0
70;2021-08-09;543;829;0;158586;131588;0;78.0;64.7;0.0
70;2021-08-10;881;1194;0;159467;132782;0;78.4;65.3;0.0
70;2021-08-11;724;783;0;160191;133565;0;78.8;65.7;0.0
70;2021-08-12;829;1241;0;161020;134806;0;79.2;66.3;0.0
70;2021-08-13;968;1528;0;161988;136334;0;79.7;67.0;0.0
70;2021-08-14;684;955;0;162672;137289;0;80.0;67.5;0.0
70;2021-08-15;43;36;0;162715;137325;0;80.0;67.5;0.0
70;2021-08-16;539;936;0;163254;138261;0;80.3;68.0;0.0
70;2021-08-17;624;1293;0;163878;139554;0;80.6;68.6;0.0
70;2021-08-18;486;947;0;164364;140501;0;80.8;69.1;0.0
70;2021-08-19;511;1307;0;164875;141808;0;81.1;69.7;0.0
70;2021-08-20;493;1872;0;165368;143680;0;81.3;70.6;0.0
70;2021-08-21;409;1107;0;165777;144787;0;81.5;71.2;0.0
70;2021-08-22;22;109;0;165799;144896;0;81.5;71.2;0.0
70;2021-08-23;305;951;0;166104;145847;0;81.7;71.7;0.0
70;2021-08-24;377;1360;0;166481;147207;0;81.9;72.4;0.0
70;2021-08-25;319;1244;0;166800;148451;0;82.0;73.0;0.0
70;2021-08-26;418;1395;0;167218;149846;0;82.2;73.7;0.0
70;2021-08-27;395;1993;0;167613;151839;0;82.4;74.7;0.0
70;2021-08-28;351;1528;0;167964;153367;0;82.6;75.4;0.0
70;2021-08-29;19;45;0;167983;153412;0;82.6;75.4;0.0
70;2021-08-30;302;812;4;168285;154224;4;82.7;75.8;0.0
70;2021-08-31;357;1127;11;168642;155351;15;82.9;76.4;0.0
70;2021-09-01;308;885;201;168950;156236;216;83.1;76.8;0.1
70;2021-09-02;282;980;166;169232;157216;382;83.2;77.3;0.2
70;2021-09-03;297;1022;188;169529;158238;570;83.4;77.8;0.3
70;2021-09-04;452;1019;136;169981;159257;706;83.6;78.3;0.3
70;2021-09-05;23;33;9;170004;159290;715;83.6;78.3;0.4
70;2021-09-06;155;593;97;170159;159883;812;83.7;78.6;0.4
70;2021-09-07;202;729;135;170361;160612;947;83.8;79.0;0.5
70;2021-09-08;192;756;102;170553;161368;1049;83.9;79.3;0.5
70;2021-09-09;179;674;138;170732;162042;1187;84.0;79.7;0.6
70;2021-09-10;251;783;124;170983;162825;1311;84.1;80.1;0.6
70;2021-09-11;288;799;82;171271;163624;1393;84.2;80.5;0.7
70;2021-09-12;19;44;6;171290;163668;1399;84.2;80.5;0.7
70;2021-09-13;165;369;156;171455;164037;1555;84.3;80.7;0.8
70;2021-09-14;321;400;158;171776;164437;1713;84.5;80.9;0.8
70;2021-09-15;183;485;138;171959;164922;1851;84.6;81.1;0.9
70;2021-09-16;233;386;177;172192;165308;2028;84.7;81.3;1.0
70;2021-09-17;230;483;122;172422;165791;2150;84.8;81.5;1.1
70;2021-09-18;163;434;80;172585;166225;2230;84.9;81.7;1.1
70;2021-09-19;3;23;0;172588;166248;2230;84.9;81.7;1.1
70;2021-09-20;101;212;123;172689;166460;2353;84.9;81.9;1.2
70;2021-09-21;148;275;154;172837;166735;2507;85.0;82.0;1.2
70;2021-09-22;99;347;130;172936;167082;2637;85.0;82.2;1.3
70;2021-09-23;68;207;203;173004;167289;2840;85.1;82.3;1.4
70;2021-09-24;189;393;162;173193;167682;3002;85.2;82.5;1.5
70;2021-09-25;136;461;115;173329;168143;3117;85.2;82.7;1.5
70;2021-09-26;2;6;0;173331;168149;3117;85.2;82.7;1.5
70;2021-09-27;58;209;105;173389;168358;3222;85.3;82.8;1.6
70;2021-09-28;79;191;235;173468;168549;3457;85.3;82.9;1.7
70;2021-09-29;102;241;154;173570;168790;3611;85.3;83.0;1.8
70;2021-09-30;101;168;235;173671;168958;3846;85.4;83.1;1.9
70;2021-10-01;138;265;222;173809;169223;4068;85.5;83.2;2.0
70;2021-10-02;116;304;152;173925;169527;4220;85.5;83.4;2.1
70;2021-10-03;2;2;2;173927;169529;4222;85.5;83.4;2.1
70;2021-10-04;80;168;185;174007;169697;4407;85.6;83.4;2.2
70;2021-10-05;87;283;228;174094;169980;4635;85.6;83.6;2.3
70;2021-10-06;127;215;237;174221;170195;4872;85.7;83.7;2.4
70;2021-10-07;89;210;301;174310;170405;5173;85.7;83.8;2.5
70;2021-10-08;151;247;329;174461;170652;5502;85.8;83.9;2.7
70;2021-10-09;140;293;170;174601;170945;5672;85.9;84.1;2.8
70;2021-10-10;4;4;15;174605;170949;5687;85.9;84.1;2.8
70;2021-10-11;72;119;194;174677;171068;5881;85.9;84.1;2.9
70;2021-10-12;50;114;266;174727;171182;6147;85.9;84.2;3.0
70;2021-10-13;99;176;342;174826;171358;6489;86.0;84.3;3.2
70;2021-10-14;53;116;198;174879;171474;6687;86.0;84.3;3.3
70;2021-10-15;153;207;373;175032;171681;7060;86.1;84.4;3.5
70;2021-10-16;131;165;255;175163;171846;7315;86.1;84.5;3.6
70;2021-10-17;4;12;0;175167;171858;7315;86.1;84.5;3.6
70;2021-10-18;54;100;209;175221;171958;7524;86.2;84.6;3.7
70;2021-10-19;78;83;339;175299;172041;7863;86.2;84.6;3.9
70;2021-10-20;106;137;364;175405;172178;8227;86.2;84.7;4.0
70;2021-10-21;55;90;386;175460;172268;8613;86.3;84.7;4.2
70;2021-10-22;96;139;570;175556;172407;9183;86.3;84.8;4.5
70;2021-10-23;127;166;281;175683;172573;9464;86.4;84.9;4.7
70;2021-10-24;2;2;1;175685;172575;9465;86.4;84.9;4.7
70;2021-10-25;51;78;309;175736;172653;9774;86.4;84.9;4.8
70;2021-10-26;51;88;321;175787;172741;10095;86.4;84.9;5.0
70;2021-10-27;80;122;443;175867;172863;10538;86.5;85.0;5.2
70;2021-10-28;44;69;240;175911;172932;10778;86.5;85.0;5.3
70;2021-10-29;107;140;460;176018;173072;11238;86.6;85.1;5.5
70;2021-10-30;69;131;247;176087;173203;11485;86.6;85.2;5.6
70;2021-10-31;1;2;0;176088;173205;11485;86.6;85.2;5.6
70;2021-11-01;8;5;1;176096;173210;11486;86.6;85.2;5.6
70;2021-11-02;67;103;430;176163;173313;11916;86.6;85.2;5.9
70;2021-11-03;84;129;585;176247;173442;12501;86.7;85.3;6.1
70;2021-11-04;38;44;332;176285;173486;12833;86.7;85.3;6.3
70;2021-11-05;97;144;863;176382;173630;13696;86.7;85.4;6.7
70;2021-11-06;103;143;497;176485;173773;14193;86.8;85.4;7.0
70;2021-11-07;1;4;0;176486;173777;14193;86.8;85.4;7.0
70;2021-11-08;43;70;563;176529;173847;14756;86.8;85.5;7.3
70;2021-11-09;46;76;704;176575;173923;15460;86.8;85.5;7.6
70;2021-11-10;86;127;837;176661;174050;16297;86.9;85.6;8.0
70;2021-11-11;0;5;5;176661;174055;16302;86.9;85.6;8.0
70;2021-11-12;103;134;891;176764;174189;17193;86.9;85.7;8.5
70;2021-11-13;99;148;708;176863;174337;17901;87.0;85.7;8.8
70;2021-11-14;3;7;7;176866;174344;17908;87.0;85.7;8.8
70;2021-11-15;38;44;678;176904;174388;18586;87.0;85.7;9.1
70;2021-11-16;35;38;670;176939;174426;19256;87.0;85.8;9.5
70;2021-11-17;94;117;1043;177033;174543;20299;87.1;85.8;10.0
70;2021-11-18;43;63;719;177076;174606;21018;87.1;85.9;10.3
70;2021-11-19;104;112;995;177180;174718;22013;87.1;85.9;10.8
70;2021-11-20;124;106;590;177304;174824;22603;87.2;86.0;11.1
70;2021-11-21;0;3;2;177304;174827;22605;87.2;86.0;11.1
70;2021-11-22;45;35;782;177349;174862;23387;87.2;86.0;11.5
70;2021-11-23;42;44;901;177391;174906;24288;87.2;86.0;11.9
70;2021-11-24;94;98;1187;177485;175004;25475;87.3;86.1;12.5
70;2021-11-25;62;55;779;177547;175059;26254;87.3;86.1;12.9
70;2021-11-26;110;99;1679;177657;175158;27933;87.4;86.1;13.7
70;2021-11-27;120;133;1034;177777;175291;28967;87.4;86.2;14.2
70;2021-11-28;1;2;47;177778;175293;29014;87.4;86.2;14.3
70;2021-11-29;22;40;1130;177800;175333;30144;87.4;86.2;14.8
70;2021-11-30;71;51;1813;177871;175384;31957;87.5;86.2;15.7
70;2021-12-01;81;106;1796;177952;175490;33753;87.5;86.3;16.6
70;2021-12-02;55;35;2157;178007;175525;35910;87.5;86.3;17.7
70;2021-12-03;67;103;2612;178074;175628;38522;87.6;86.4;18.9
70;2021-12-04;81;101;1999;178155;175729;40521;87.6;86.4;19.9
70;2021-12-05;22;10;443;178177;175739;40964;87.6;86.4;20.1
70;2021-12-06;33;62;1505;178210;175801;42469;87.6;86.4;20.9
70;2021-12-07;73;39;2624;178283;175840;45093;87.7;86.5;22.2
70;2021-12-08;59;90;2344;178342;175930;47437;87.7;86.5;23.3
70;2021-12-09;49;75;3031;178391;176005;50468;87.7;86.5;24.8
70;2021-12-10;68;93;3575;178459;176098;54043;87.8;86.6;26.6
70;2021-12-11;80;134;2736;178539;176232;56779;87.8;86.7;27.9
70;2021-12-12;30;7;557;178569;176239;57336;87.8;86.7;28.2
70;2021-12-13;50;46;2055;178619;176285;59391;87.8;86.7;29.2
70;2021-12-14;76;45;2953;178695;176330;62344;87.9;86.7;30.7
70;2021-12-15;65;78;2590;178760;176408;64934;87.9;86.7;31.9
70;2021-12-16;86;73;3319;178846;176481;68253;87.9;86.8;33.6
70;2021-12-17;93;99;3186;178939;176580;71439;88.0;86.8;35.1
70;2021-12-18;95;127;2096;179034;176707;73535;88.0;86.9;36.2
70;2021-12-19;3;11;146;179037;176718;73681;88.0;86.9;36.2
71;2020-12-27;1;0;0;1;0;0;0.0;0.0;0.0
71;2020-12-28;8;0;0;9;0;0;0.0;0.0;0.0
71;2020-12-29;2;0;0;11;0;0;0.0;0.0;0.0
71;2020-12-30;0;0;0;11;0;0;0.0;0.0;0.0
71;2020-12-31;0;0;0;11;0;0;0.0;0.0;0.0
71;2021-01-01;94;0;0;105;0;0;0.0;0.0;0.0
71;2021-01-02;8;0;0;113;0;0;0.0;0.0;0.0
71;2021-01-03;0;0;0;113;0;0;0.0;0.0;0.0
71;2021-01-04;3;0;0;116;0;0;0.0;0.0;0.0
71;2021-01-05;15;1;0;131;1;0;0.0;0.0;0.0
71;2021-01-06;75;0;0;206;1;0;0.0;0.0;0.0
71;2021-01-07;78;1;0;284;2;0;0.1;0.0;0.0
71;2021-01-08;152;0;0;436;2;0;0.1;0.0;0.0
71;2021-01-09;93;0;0;529;2;0;0.1;0.0;0.0
71;2021-01-10;2;0;0;531;2;0;0.1;0.0;0.0
71;2021-01-11;237;0;0;768;2;0;0.2;0.0;0.0
71;2021-01-12;770;1;0;1538;3;0;0.3;0.0;0.0
71;2021-01-13;551;2;0;2089;5;0;0.4;0.0;0.0
71;2021-01-14;590;7;0;2679;12;0;0.6;0.0;0.0
71;2021-01-15;641;2;0;3320;14;0;0.7;0.0;0.0
71;2021-01-16;23;0;0;3343;14;0;0.7;0.0;0.0
71;2021-01-17;3;0;0;3346;14;0;0.7;0.0;0.0
71;2021-01-18;954;5;0;4300;19;0;0.9;0.0;0.0
71;2021-01-19;1579;7;0;5879;26;0;1.2;0.0;0.0
71;2021-01-20;1494;8;0;7373;34;0;1.5;0.0;0.0
71;2021-01-21;1913;15;0;9286;49;0;1.9;0.0;0.0
71;2021-01-22;1348;4;0;10634;53;0;2.2;0.0;0.0
71;2021-01-23;772;6;0;11406;59;0;2.4;0.0;0.0
71;2021-01-24;2;0;0;11408;59;0;2.4;0.0;0.0
71;2021-01-25;1009;7;0;12417;66;0;2.6;0.0;0.0
71;2021-01-26;1535;28;0;13952;94;0;2.9;0.0;0.0
71;2021-01-27;1166;33;0;15118;127;0;3.2;0.0;0.0
71;2021-01-28;1092;100;0;16210;227;0;3.4;0.0;0.0
71;2021-01-29;1026;137;0;17236;364;0;3.6;0.1;0.0
71;2021-01-30;584;2;0;17820;366;0;3.7;0.1;0.0
71;2021-01-31;5;15;0;17825;381;0;3.7;0.1;0.0
71;2021-02-01;748;210;0;18573;591;0;3.9;0.1;0.0
71;2021-02-02;780;332;0;19353;923;0;4.0;0.2;0.0
71;2021-02-03;763;401;0;20116;1324;0;4.2;0.3;0.0
71;2021-02-04;736;569;0;20852;1893;0;4.3;0.4;0.0
71;2021-02-05;703;502;0;21555;2395;0;4.5;0.5;0.0
71;2021-02-06;514;21;0;22069;2416;0;4.6;0.5;0.0
71;2021-02-07;3;46;0;22072;2462;0;4.6;0.5;0.0
71;2021-02-08;605;630;0;22677;3092;0;4.7;0.6;0.0
71;2021-02-09;385;972;0;23062;4064;0;4.8;0.8;0.0
71;2021-02-10;418;937;0;23480;5001;0;4.9;1.0;0.0
71;2021-02-11;512;1208;0;23992;6209;0;5.0;1.3;0.0
71;2021-02-12;543;1004;0;24535;7213;0;5.1;1.5;0.0
71;2021-02-13;147;509;0;24682;7722;0;5.1;1.6;0.0
71;2021-02-14;8;4;0;24690;7726;0;5.1;1.6;0.0
71;2021-02-15;311;876;0;25001;8602;0;5.2;1.8;0.0
71;2021-02-16;386;1333;0;25387;9935;0;5.3;2.1;0.0
71;2021-02-17;437;1106;0;25824;11041;0;5.4;2.3;0.0
71;2021-02-18;499;879;0;26323;11920;0;5.5;2.5;0.0
71;2021-02-19;525;749;0;26848;12669;0;5.6;2.6;0.0
71;2021-02-20;221;368;0;27069;13037;0;5.6;2.7;0.0
71;2021-02-21;0;11;0;27069;13048;0;5.6;2.7;0.0
71;2021-02-22;228;857;0;27297;13905;0;5.7;2.9;0.0
71;2021-02-23;448;952;0;27745;14857;0;5.8;3.1;0.0
71;2021-02-24;444;760;0;28189;15617;0;5.9;3.3;0.0
71;2021-02-25;530;757;0;28719;16374;0;6.0;3.4;0.0
71;2021-02-26;845;568;0;29564;16942;0;6.2;3.5;0.0
71;2021-02-27;468;340;0;30032;17282;0;6.3;3.6;0.0
71;2021-02-28;56;17;0;30088;17299;0;6.3;3.6;0.0
71;2021-03-01;1139;702;0;31227;18001;0;6.5;3.8;0.0
71;2021-03-02;1509;716;0;32736;18717;0;6.8;3.9;0.0
71;2021-03-03;1751;757;0;34487;19474;0;7.2;4.1;0.0
71;2021-03-04;1997;823;0;36484;20297;0;7.6;4.2;0.0
71;2021-03-05;2252;684;0;38736;20981;0;8.1;4.4;0.0
71;2021-03-06;793;74;0;39529;21055;0;8.2;4.4;0.0
71;2021-03-07;74;13;0;39603;21068;0;8.3;4.4;0.0
71;2021-03-08;1424;798;0;41027;21866;0;8.6;4.6;0.0
71;2021-03-09;2111;594;0;43138;22460;0;9.0;4.7;0.0
71;2021-03-10;2124;461;0;45262;22921;0;9.4;4.8;0.0
71;2021-03-11;2580;681;0;47842;23602;0;10.0;4.9;0.0
71;2021-03-12;2534;610;0;50376;24212;0;10.5;5.0;0.0
71;2021-03-13;1081;104;0;51457;24316;0;10.7;5.1;0.0
71;2021-03-14;58;8;0;51515;24324;0;10.7;5.1;0.0
71;2021-03-15;1775;478;0;53290;24802;0;11.1;5.2;0.0
71;2021-03-16;1769;218;0;55059;25020;0;11.5;5.2;0.0
71;2021-03-17;2079;259;0;57138;25279;0;11.9;5.3;0.0
71;2021-03-18;1891;455;0;59029;25734;0;12.3;5.4;0.0
71;2021-03-19;2322;327;0;61351;26061;0;12.8;5.4;0.0
71;2021-03-20;1029;52;0;62380;26113;0;13.0;5.4;0.0
71;2021-03-21;25;4;0;62405;26117;0;13.0;5.4;0.0
71;2021-03-22;2447;372;0;64852;26489;0;13.5;5.5;0.0
71;2021-03-23;3284;487;0;68136;26976;0;14.2;5.6;0.0
71;2021-03-24;3187;457;0;71323;27433;0;14.9;5.7;0.0
71;2021-03-25;3866;559;0;75189;27992;0;15.7;5.8;0.0
71;2021-03-26;3809;335;0;78998;28327;0;16.5;5.9;0.0
71;2021-03-27;937;101;0;79935;28428;0;16.7;5.9;0.0
71;2021-03-28;75;11;0;80010;28439;0;16.7;5.9;0.0
71;2021-03-29;2321;1113;0;82331;29552;0;17.2;6.2;0.0
71;2021-03-30;3000;1311;0;85331;30863;0;17.8;6.4;0.0
71;2021-03-31;2456;1495;0;87787;32358;0;18.3;6.7;0.0
71;2021-04-01;2645;1282;0;90432;33640;0;18.9;7.0;0.0
71;2021-04-02;2385;1411;0;92817;35051;0;19.4;7.3;0.0
71;2021-04-03;297;48;0;93114;35099;0;19.4;7.3;0.0
71;2021-04-04;22;8;0;93136;35107;0;19.4;7.3;0.0
71;2021-04-05;95;2;0;93231;35109;0;19.4;7.3;0.0
71;2021-04-06;2096;1827;0;95327;36936;0;19.9;7.7;0.0
71;2021-04-07;2276;1743;0;97603;38679;0;20.3;8.1;0.0
71;2021-04-08;3156;1757;0;100759;40436;0;21.0;8.4;0.0
71;2021-04-09;3871;1620;0;104630;42056;0;21.8;8.8;0.0
71;2021-04-10;830;97;0;105460;42153;0;22.0;8.8;0.0
71;2021-04-11;108;13;0;105568;42166;0;22.0;8.8;0.0
71;2021-04-12;2279;1674;0;107847;43840;0;22.5;9.1;0.0
71;2021-04-13;2528;1833;0;110375;45673;0;23.0;9.5;0.0
71;2021-04-14;2318;1905;0;112693;47578;0;23.5;9.9;0.0
71;2021-04-15;2701;1654;0;115394;49232;0;24.1;10.3;0.0
71;2021-04-16;2564;1668;0;117958;50900;0;24.6;10.6;0.0
71;2021-04-17;947;356;0;118905;51256;0;24.8;10.7;0.0
71;2021-04-18;126;20;0;119031;51276;0;24.8;10.7;0.0
71;2021-04-19;1637;2362;0;120668;53638;0;25.2;11.2;0.0
71;2021-04-20;2104;2435;0;122772;56073;0;25.6;11.7;0.0
71;2021-04-21;2007;2372;0;124779;58445;0;26.0;12.2;0.0
71;2021-04-22;2371;2254;0;127150;60699;0;26.5;12.7;0.0
71;2021-04-23;2695;2089;0;129845;62788;0;27.1;13.1;0.0
71;2021-04-24;574;103;0;130419;62891;0;27.2;13.1;0.0
71;2021-04-25;43;7;0;130462;62898;0;27.2;13.1;0.0
71;2021-04-26;2277;1988;0;132739;64886;0;27.7;13.5;0.0
71;2021-04-27;2815;2176;0;135554;67062;0;28.3;14.0;0.0
71;2021-04-28;2893;2097;0;138447;69159;0;28.9;14.4;0.0
71;2021-04-29;3530;2102;0;141977;71261;0;29.6;14.9;0.0
71;2021-04-30;3690;1595;0;145667;72856;0;30.4;15.2;0.0
71;2021-05-01;137;64;0;145804;72920;0;30.4;15.2;0.0
71;2021-05-02;57;33;0;145861;72953;0;30.4;15.2;0.0
71;2021-05-03;3913;1403;0;149774;74356;0;31.2;15.5;0.0
71;2021-05-04;2765;2240;0;152539;76596;0;31.8;16.0;0.0
71;2021-05-05;3177;1976;0;155716;78572;0;32.5;16.4;0.0
71;2021-05-06;3365;2199;0;159081;80771;0;33.2;16.8;0.0
71;2021-05-07;3419;2619;0;162500;83390;0;33.9;17.4;0.0
71;2021-05-08;309;220;0;162809;83610;0;33.9;17.4;0.0
71;2021-05-09;93;56;0;162902;83666;0;34.0;17.4;0.0
71;2021-05-10;3363;2197;0;166265;85863;0;34.7;17.9;0.0
71;2021-05-11;4228;2258;0;170493;88121;0;35.5;18.4;0.0
71;2021-05-12;3781;2422;0;174274;90543;0;36.3;18.9;0.0
71;2021-05-13;1541;176;0;175815;90719;0;36.7;18.9;0.0
71;2021-05-14;3642;2034;0;179457;92753;0;37.4;19.3;0.0
71;2021-05-15;652;336;0;180109;93089;0;37.5;19.4;0.0
71;2021-05-16;87;17;0;180196;93106;0;37.6;19.4;0.0
71;2021-05-17;3698;1768;0;183894;94874;0;38.3;19.8;0.0
71;2021-05-18;3360;2288;0;187254;97162;0;39.0;20.3;0.0
71;2021-05-19;3765;2152;0;191019;99314;0;39.8;20.7;0.0
71;2021-05-20;4301;2176;0;195320;101490;0;40.7;21.2;0.0
71;2021-05-21;3768;2392;0;199088;103882;0;41.5;21.7;0.0
71;2021-05-22;631;369;0;199719;104251;0;41.6;21.7;0.0
71;2021-05-23;100;60;0;199819;104311;0;41.7;21.7;0.0
71;2021-05-24;400;144;0;200219;104455;0;41.7;21.8;0.0
71;2021-05-25;2713;2896;0;202932;107351;0;42.3;22.4;0.0
71;2021-05-26;3086;2323;0;206018;109674;0;43.0;22.9;0.0
71;2021-05-27;3554;2412;0;209572;112086;0;43.7;23.4;0.0
71;2021-05-28;2980;3000;0;212552;115086;0;44.3;24.0;0.0
71;2021-05-29;887;720;0;213439;115806;0;44.5;24.1;0.0
71;2021-05-30;127;82;0;213566;115888;0;44.5;24.2;0.0
71;2021-05-31;2755;3229;0;216321;119117;0;45.1;24.8;0.0
71;2021-06-01;3521;3390;0;219842;122507;0;45.8;25.5;0.0
71;2021-06-02;3844;2535;0;223686;125042;0;46.6;26.1;0.0
71;2021-06-03;4147;2433;0;227833;127475;0;47.5;26.6;0.0
71;2021-06-04;3677;3427;0;231510;130902;0;48.3;27.3;0.0
71;2021-06-05;1118;729;0;232628;131631;0;48.5;27.4;0.0
71;2021-06-06;138;103;0;232766;131734;0;48.5;27.5;0.0
71;2021-06-07;3191;3701;0;235957;135435;0;49.2;28.2;0.0
71;2021-06-08;3794;3646;0;239751;139081;0;50.0;29.0;0.0
71;2021-06-09;4408;2611;0;244159;141692;0;50.9;29.5;0.0
71;2021-06-10;4931;2719;0;249090;144411;0;51.9;30.1;0.0
71;2021-06-11;4120;3510;0;253210;147921;0;52.8;30.8;0.0
71;2021-06-12;1063;684;0;254273;148605;0;53.0;31.0;0.0
71;2021-06-13;153;200;0;254426;148805;0;53.0;31.0;0.0
71;2021-06-14;3176;3553;0;257602;152358;0;53.7;31.8;0.0
71;2021-06-15;3809;3341;0;261411;155699;0;54.5;32.5;0.0
71;2021-06-16;4177;2617;0;265588;158316;0;55.4;33.0;0.0
71;2021-06-17;3977;2912;0;269565;161228;0;56.2;33.6;0.0
71;2021-06-18;3954;3476;0;273519;164704;0;57.0;34.3;0.0
71;2021-06-19;1291;838;0;274810;165542;0;57.3;34.5;0.0
71;2021-06-20;69;69;0;274879;165611;0;57.3;34.5;0.0
71;2021-06-21;2033;3929;0;276912;169540;0;57.7;35.3;0.0
71;2021-06-22;2447;4193;0;279359;173733;0;58.2;36.2;0.0
71;2021-06-23;2865;3303;0;282224;177036;0;58.8;36.9;0.0
71;2021-06-24;3108;2896;0;285332;179932;0;59.5;37.5;0.0
71;2021-06-25;2455;4350;0;287787;184282;0;60.0;38.4;0.0
71;2021-06-26;503;1006;0;288290;185288;0;60.1;38.6;0.0
71;2021-06-27;60;121;0;288350;185409;0;60.1;38.7;0.0
71;2021-06-28;1444;4404;0;289794;189813;0;60.4;39.6;0.0
71;2021-06-29;1836;4594;0;291630;194407;0;60.8;40.5;0.0
71;2021-06-30;2297;3857;0;293927;198264;0;61.3;41.3;0.0
71;2021-07-01;2500;3805;0;296427;202069;0;61.8;42.1;0.0
71;2021-07-02;2720;3919;0;299147;205988;0;62.4;42.9;0.0
71;2021-07-03;403;1089;0;299550;207077;0;62.4;43.2;0.0
71;2021-07-04;51;192;0;299601;207269;0;62.5;43.2;0.0
71;2021-07-05;2132;4172;0;301733;211441;0;62.9;44.1;0.0
71;2021-07-06;2134;4350;0;303867;215791;0;63.3;45.0;0.0
71;2021-07-07;2568;3575;0;306435;219366;0;63.9;45.7;0.0
71;2021-07-08;2445;3969;0;308880;223335;0;64.4;46.6;0.0
71;2021-07-09;2116;4760;0;310996;228095;0;64.8;47.6;0.0
71;2021-07-10;363;1000;0;311359;229095;0;64.9;47.8;0.0
71;2021-07-11;60;118;0;311419;229213;0;64.9;47.8;0.0
71;2021-07-12;1764;4968;0;313183;234181;0;65.3;48.8;0.0
71;2021-07-13;2416;5455;0;315599;239636;0;65.8;50.0;0.0
71;2021-07-14;1033;469;0;316632;240105;0;66.0;50.1;0.0
71;2021-07-15;2807;5359;0;319439;245464;0;66.6;51.2;0.0
71;2021-07-16;3394;5673;0;322833;251137;0;67.3;52.4;0.0
71;2021-07-17;980;1279;0;323813;252416;0;67.5;52.6;0.0
71;2021-07-18;162;176;0;323975;252592;0;67.5;52.7;0.0
71;2021-07-19;2864;5240;0;326839;257832;0;68.1;53.8;0.0
71;2021-07-20;3253;5559;0;330092;263391;0;68.8;54.9;0.0
71;2021-07-21;3522;5105;0;333614;268496;0;69.6;56.0;0.0
71;2021-07-22;3833;5024;0;337447;273520;0;70.4;57.0;0.0
71;2021-07-23;3269;5644;0;340716;279164;0;71.0;58.2;0.0
71;2021-07-24;1054;1072;0;341770;280236;0;71.3;58.4;0.0
71;2021-07-25;253;153;0;342023;280389;0;71.3;58.5;0.0
71;2021-07-26;3452;4466;0;345475;284855;0;72.0;59.4;0.0
71;2021-07-27;3942;4552;0;349417;289407;0;72.8;60.3;0.0
71;2021-07-28;4167;4402;0;353584;293809;0;73.7;61.3;0.0
71;2021-07-29;4111;4301;0;357695;298110;0;74.6;62.1;0.0
71;2021-07-30;4110;4470;0;361805;302580;0;75.4;63.1;0.0
71;2021-07-31;1043;893;0;362848;303473;0;75.6;63.3;0.0
71;2021-08-01;221;105;0;363069;303578;0;75.7;63.3;0.0
71;2021-08-02;3766;3390;0;366835;306968;0;76.5;64.0;0.0
71;2021-08-03;4074;3516;0;370909;310484;0;77.3;64.7;0.0
71;2021-08-04;4051;2822;0;374960;313306;0;78.2;65.3;0.0
71;2021-08-05;3924;3091;0;378884;316397;0;79.0;66.0;0.0
71;2021-08-06;3494;3832;0;382378;320229;0;79.7;66.8;0.0
71;2021-08-07;667;684;0;383045;320913;0;79.9;66.9;0.0
71;2021-08-08;108;119;0;383153;321032;0;79.9;66.9;0.0
71;2021-08-09;2615;3055;0;385768;324087;0;80.4;67.6;0.0
71;2021-08-10;2760;3140;0;388528;327227;0;81.0;68.2;0.0
71;2021-08-11;2892;3006;0;391420;330233;0;81.6;68.8;0.0
71;2021-08-12;2773;3038;0;394193;333271;0;82.2;69.5;0.0
71;2021-08-13;2475;3184;0;396668;336455;0;82.7;70.1;0.0
71;2021-08-14;367;778;0;397035;337233;0;82.8;70.3;0.0
71;2021-08-15;70;185;0;397105;337418;0;82.8;70.3;0.0
71;2021-08-16;1487;3217;0;398592;340635;0;83.1;71.0;0.0
71;2021-08-17;1575;3093;0;400167;343728;0;83.4;71.7;0.0
71;2021-08-18;1358;2978;0;401525;346706;0;83.7;72.3;0.0
71;2021-08-19;1224;2826;0;402749;349532;0;84.0;72.9;0.0
71;2021-08-20;1199;3587;0;403948;353119;0;84.2;73.6;0.0
71;2021-08-21;210;721;0;404158;353840;0;84.3;73.8;0.0
71;2021-08-22;61;147;0;404219;353987;0;84.3;73.8;0.0
71;2021-08-23;1245;4224;0;405464;358211;0;84.5;74.7;0.0
71;2021-08-24;1185;3531;0;406649;361742;0;84.8;75.4;0.0
71;2021-08-25;879;3583;0;407528;365325;0;85.0;76.2;0.0
71;2021-08-26;893;3246;0;408421;368571;0;85.1;76.8;0.0
71;2021-08-27;1043;4151;0;409464;372722;0;85.4;77.7;0.0
71;2021-08-28;235;640;0;409699;373362;0;85.4;77.8;0.0
71;2021-08-29;37;154;0;409736;373516;0;85.4;77.9;0.0
71;2021-08-30;1090;3502;52;410826;377018;52;85.6;78.6;0.0
71;2021-08-31;903;3111;159;411729;380129;211;85.8;79.2;0.0
71;2021-09-01;894;3121;314;412623;383250;525;86.0;79.9;0.1
71;2021-09-02;608;2660;294;413231;385910;819;86.1;80.5;0.2
71;2021-09-03;809;3468;377;414040;389378;1196;86.3;81.2;0.2
71;2021-09-04;301;689;66;414341;390067;1262;86.4;81.3;0.3
71;2021-09-05;30;104;8;414371;390171;1270;86.4;81.3;0.3
71;2021-09-06;598;2083;404;414969;392254;1674;86.5;81.8;0.3
71;2021-09-07;503;1573;538;415472;393827;2212;86.6;82.1;0.5
71;2021-09-08;654;2021;413;416126;395848;2625;86.8;82.5;0.5
71;2021-09-09;440;1251;562;416566;397099;3187;86.8;82.8;0.7
71;2021-09-10;748;1956;616;417314;399055;3803;87.0;83.2;0.8
71;2021-09-11;231;409;69;417545;399464;3872;87.0;83.3;0.8
71;2021-09-12;27;51;13;417572;399515;3885;87.1;83.3;0.8
71;2021-09-13;609;1211;348;418181;400726;4233;87.2;83.5;0.9
71;2021-09-14;480;978;506;418661;401704;4739;87.3;83.7;1.0
71;2021-09-15;573;1380;565;419234;403084;5304;87.4;84.0;1.1
71;2021-09-16;448;805;527;419682;403889;5831;87.5;84.2;1.2
71;2021-09-17;526;1303;595;420208;405192;6426;87.6;84.5;1.3
71;2021-09-18;159;320;119;420367;405512;6545;87.6;84.5;1.4
71;2021-09-19;16;34;9;420383;405546;6554;87.6;84.5;1.4
71;2021-09-20;433;816;531;420816;406362;7085;87.7;84.7;1.5
71;2021-09-21;274;643;705;421090;407005;7790;87.8;84.9;1.6
71;2021-09-22;310;1172;601;421400;408177;8391;87.9;85.1;1.7
71;2021-09-23;278;568;537;421678;408745;8928;87.9;85.2;1.9
71;2021-09-24;345;944;562;422023;409689;9490;88.0;85.4;2.0
71;2021-09-25;78;237;62;422101;409926;9552;88.0;85.5;2.0
71;2021-09-26;10;40;4;422111;409966;9556;88.0;85.5;2.0
71;2021-09-27;272;677;601;422383;410643;10157;88.1;85.6;2.1
71;2021-09-28;274;452;704;422657;411095;10861;88.1;85.7;2.3
71;2021-09-29;306;699;668;422963;411794;11529;88.2;85.8;2.4
71;2021-09-30;209;476;722;423172;412270;12251;88.2;85.9;2.6
71;2021-10-01;399;806;967;423571;413076;13218;88.3;86.1;2.8
71;2021-10-02;129;230;135;423700;413306;13353;88.3;86.2;2.8
71;2021-10-03;5;15;35;423705;413321;13388;88.3;86.2;2.8
71;2021-10-04;259;534;618;423964;413855;14006;88.4;86.3;2.9
71;2021-10-05;197;379;644;424161;414234;14650;88.4;86.4;3.1
71;2021-10-06;377;641;820;424538;414875;15470;88.5;86.5;3.2
71;2021-10-07;156;358;651;424694;415233;16121;88.5;86.6;3.4
71;2021-10-08;337;643;1086;425031;415876;17207;88.6;86.7;3.6
71;2021-10-09;79;193;165;425110;416069;17372;88.6;86.7;3.6
71;2021-10-10;9;21;23;425119;416090;17395;88.6;86.7;3.6
71;2021-10-11;266;509;740;425385;416599;18135;88.7;86.9;3.8
71;2021-10-12;183;360;743;425568;416959;18878;88.7;86.9;3.9
71;2021-10-13;296;445;927;425864;417404;19805;88.8;87.0;4.1
71;2021-10-14;159;283;759;426023;417687;20564;88.8;87.1;4.3
71;2021-10-15;280;527;1262;426303;418214;21826;88.9;87.2;4.6
71;2021-10-16;111;137;161;426414;418351;21987;88.9;87.2;4.6
71;2021-10-17;3;13;26;426417;418364;22013;88.9;87.2;4.6
71;2021-10-18;235;361;1093;426652;418725;23106;88.9;87.3;4.8
71;2021-10-19;168;279;1055;426820;419004;24161;89.0;87.4;5.0
71;2021-10-20;283;431;1505;427103;419435;25666;89.0;87.4;5.4
71;2021-10-21;129;188;961;427232;419623;26627;89.1;87.5;5.6
71;2021-10-22;233;334;1327;427465;419957;27954;89.1;87.6;5.8
71;2021-10-23;84;117;165;427549;420074;28119;89.1;87.6;5.9
71;2021-10-24;6;30;27;427555;420104;28146;89.1;87.6;5.9
71;2021-10-25;201;299;1067;427756;420403;29213;89.2;87.6;6.1
71;2021-10-26;136;201;939;427892;420604;30152;89.2;87.7;6.3
71;2021-10-27;185;322;1279;428077;420926;31431;89.2;87.8;6.6
71;2021-10-28;132;150;844;428209;421076;32275;89.3;87.8;6.7
71;2021-10-29;197;312;1294;428406;421388;33569;89.3;87.8;7.0
71;2021-10-30;69;121;192;428475;421509;33761;89.3;87.9;7.0
71;2021-10-31;9;14;48;428484;421523;33809;89.3;87.9;7.0
71;2021-11-01;15;9;2;428499;421532;33811;89.3;87.9;7.0
71;2021-11-02;173;242;1326;428672;421774;35137;89.4;87.9;7.3
71;2021-11-03;191;353;1389;428863;422127;36526;89.4;88.0;7.6
71;2021-11-04;132;161;1091;428995;422288;37617;89.4;88.0;7.8
71;2021-11-05;227;306;2100;429222;422594;39717;89.5;88.1;8.3
71;2021-11-06;75;100;292;429297;422694;40009;89.5;88.1;8.3
71;2021-11-07;1;4;22;429298;422698;40031;89.5;88.1;8.3
71;2021-11-08;155;245;1691;429453;422943;41722;89.5;88.2;8.7
71;2021-11-09;96;194;1773;429549;423137;43495;89.6;88.2;9.1
71;2021-11-10;218;296;2041;429767;423433;45536;89.6;88.3;9.5
71;2021-11-11;15;21;87;429782;423454;45623;89.6;88.3;9.5
71;2021-11-12;192;293;2143;429974;423747;47766;89.6;88.3;10.0
71;2021-11-13;61;78;338;430035;423825;48104;89.7;88.4;10.0
71;2021-11-14;4;9;8;430039;423834;48112;89.7;88.4;10.0
71;2021-11-15;138;200;1929;430177;424034;50041;89.7;88.4;10.4
71;2021-11-16;137;162;2078;430314;424196;52119;89.7;88.4;10.9
71;2021-11-17;184;236;2152;430498;424432;54271;89.7;88.5;11.3
71;2021-11-18;123;152;1734;430621;424584;56005;89.8;88.5;11.7
71;2021-11-19;219;277;2673;430840;424861;58678;89.8;88.6;12.2
71;2021-11-20;70;55;489;430910;424916;59167;89.8;88.6;12.3
71;2021-11-21;5;18;87;430915;424934;59254;89.8;88.6;12.4
71;2021-11-22;200;139;2458;431115;425073;61712;89.9;88.6;12.9
71;2021-11-23;138;179;2188;431253;425252;63900;89.9;88.7;13.3
71;2021-11-24;274;278;2696;431527;425530;66596;90.0;88.7;13.9
71;2021-11-25;149;144;2270;431676;425674;68866;90.0;88.7;14.4
71;2021-11-26;269;287;4014;431945;425961;72880;90.1;88.8;15.2
71;2021-11-27;88;98;737;432033;426059;73617;90.1;88.8;15.3
71;2021-11-28;12;18;126;432045;426077;73743;90.1;88.8;15.4
71;2021-11-29;175;166;3718;432220;426243;77461;90.1;88.9;16.1
71;2021-11-30;177;169;4378;432397;426412;81839;90.1;88.9;17.1
71;2021-12-01;180;246;4732;432577;426658;86571;90.2;88.9;18.0
71;2021-12-02;140;90;4482;432717;426748;91053;90.2;89.0;19.0
71;2021-12-03;160;253;5939;432877;427001;96992;90.2;89.0;20.2
71;2021-12-04;93;115;2046;432970;427116;99038;90.3;89.0;20.6
71;2021-12-05;8;16;197;432978;427132;99235;90.3;89.0;20.7
71;2021-12-06;132;210;5907;433110;427342;105142;90.3;89.1;21.9
71;2021-12-07;154;196;7281;433264;427538;112423;90.3;89.1;23.4
71;2021-12-08;159;196;6265;433423;427734;118688;90.4;89.2;24.7
71;2021-12-09;159;171;6854;433582;427905;125542;90.4;89.2;26.2
71;2021-12-10;175;228;7102;433757;428133;132644;90.4;89.3;27.7
71;2021-12-11;94;98;2473;433851;428231;135117;90.4;89.3;28.2
71;2021-12-12;14;10;367;433865;428241;135484;90.5;89.3;28.2
71;2021-12-13;144;187;6614;434009;428428;142098;90.5;89.3;29.6
71;2021-12-14;163;182;7862;434172;428610;149960;90.5;89.4;31.3
71;2021-12-15;152;280;6871;434324;428890;156831;90.5;89.4;32.7
71;2021-12-16;161;167;7390;434485;429057;164221;90.6;89.4;34.2
71;2021-12-17;198;310;7847;434683;429367;172068;90.6;89.5;35.9
71;2021-12-18;168;102;2740;434851;429469;174808;90.7;89.5;36.4
71;2021-12-19;16;19;259;434867;429488;175067;90.7;89.5;36.5
72;2020-12-27;0;0;0;0;0;0;0.0;0.0;0.0
72;2020-12-28;2;0;0;2;0;0;0.0;0.0;0.0
72;2020-12-29;0;0;0;2;0;0;0.0;0.0;0.0
72;2020-12-30;0;0;0;2;0;0;0.0;0.0;0.0
72;2020-12-31;0;0;0;2;0;0;0.0;0.0;0.0
72;2021-01-01;1;0;0;3;0;0;0.0;0.0;0.0
72;2021-01-02;0;0;0;3;0;0;0.0;0.0;0.0
72;2021-01-03;0;0;0;3;0;0;0.0;0.0;0.0
72;2021-01-04;1;0;0;4;0;0;0.0;0.0;0.0
72;2021-01-05;15;0;0;19;0;0;0.0;0.0;0.0
72;2021-01-06;42;0;0;61;0;0;0.0;0.0;0.0
72;2021-01-07;142;1;0;203;1;0;0.0;0.0;0.0
72;2021-01-08;255;1;0;458;2;0;0.1;0.0;0.0
72;2021-01-09;48;0;0;506;2;0;0.1;0.0;0.0
72;2021-01-10;14;0;0;520;2;0;0.1;0.0;0.0
72;2021-01-11;513;1;0;1033;3;0;0.2;0.0;0.0
72;2021-01-12;621;1;0;1654;4;0;0.3;0.0;0.0
72;2021-01-13;563;2;0;2217;6;0;0.5;0.0;0.0
72;2021-01-14;672;4;0;2889;10;0;0.6;0.0;0.0
72;2021-01-15;505;1;0;3394;11;0;0.7;0.0;0.0
72;2021-01-16;120;0;0;3514;11;0;0.7;0.0;0.0
72;2021-01-17;34;1;0;3548;12;0;0.7;0.0;0.0
72;2021-01-18;407;1;0;3955;13;0;0.8;0.0;0.0
72;2021-01-19;859;5;0;4814;18;0;1.0;0.0;0.0
72;2021-01-20;1506;6;0;6320;24;0;1.3;0.0;0.0
72;2021-01-21;1790;6;0;8110;30;0;1.7;0.0;0.0
72;2021-01-22;1139;6;0;9249;36;0;1.9;0.0;0.0
72;2021-01-23;73;1;0;9322;37;0;1.9;0.0;0.0
72;2021-01-24;12;0;0;9334;37;0;1.9;0.0;0.0
72;2021-01-25;570;6;0;9904;43;0;2.1;0.0;0.0
72;2021-01-26;1214;23;0;11118;66;0;2.3;0.0;0.0
72;2021-01-27;961;24;0;12079;90;0;2.5;0.0;0.0
72;2021-01-28;859;70;0;12938;160;0;2.7;0.0;0.0
72;2021-01-29;712;67;0;13650;227;0;2.8;0.0;0.0
72;2021-01-30;101;1;0;13751;228;0;2.9;0.0;0.0
72;2021-01-31;2;1;0;13753;229;0;2.9;0.0;0.0
72;2021-02-01;552;248;0;14305;477;0;3.0;0.1;0.0
72;2021-02-02;559;296;0;14864;773;0;3.1;0.2;0.0
72;2021-02-03;545;259;0;15409;1032;0;3.2;0.2;0.0
72;2021-02-04;546;367;0;15955;1399;0;3.3;0.3;0.0
72;2021-02-05;532;441;0;16487;1840;0;3.4;0.4;0.0
72;2021-02-06;108;37;0;16595;1877;0;3.4;0.4;0.0
72;2021-02-07;18;6;0;16613;1883;0;3.4;0.4;0.0
72;2021-02-08;350;441;0;16963;2324;0;3.5;0.5;0.0
72;2021-02-09;527;557;0;17490;2881;0;3.6;0.6;0.0
72;2021-02-10;594;925;0;18084;3806;0;3.8;0.8;0.0
72;2021-02-11;941;1352;0;19025;5158;0;3.9;1.1;0.0
72;2021-02-12;891;588;0;19916;5746;0;4.1;1.2;0.0
72;2021-02-13;131;71;0;20047;5817;0;4.2;1.2;0.0
72;2021-02-14;1;40;0;20048;5857;0;4.2;1.2;0.0
72;2021-02-15;266;598;0;20314;6455;0;4.2;1.3;0.0
72;2021-02-16;529;1051;0;20843;7506;0;4.3;1.6;0.0
72;2021-02-17;485;755;0;21328;8261;0;4.4;1.7;0.0
72;2021-02-18;639;721;0;21967;8982;0;4.6;1.9;0.0
72;2021-02-19;557;640;0;22524;9622;0;4.7;2.0;0.0
72;2021-02-20;87;88;0;22611;9710;0;4.7;2.0;0.0
72;2021-02-21;0;3;0;22611;9713;0;4.7;2.0;0.0
72;2021-02-22;345;647;0;22956;10360;0;4.8;2.1;0.0
72;2021-02-23;603;636;0;23559;10996;0;4.9;2.3;0.0
72;2021-02-24;505;603;0;24064;11599;0;5.0;2.4;0.0
72;2021-02-25;929;643;0;24993;12242;0;5.2;2.5;0.0
72;2021-02-26;665;592;0;25658;12834;0;5.3;2.7;0.0
72;2021-02-27;336;97;0;25994;12931;0;5.4;2.7;0.0
72;2021-02-28;15;19;0;26009;12950;0;5.4;2.7;0.0
72;2021-03-01;383;515;0;26392;13465;0;5.5;2.8;0.0
72;2021-03-02;522;665;0;26914;14130;0;5.6;2.9;0.0
72;2021-03-03;743;691;0;27657;14821;0;5.7;3.1;0.0
72;2021-03-04;764;839;0;28421;15660;0;5.9;3.2;0.0
72;2021-03-05;954;752;0;29375;16412;0;6.1;3.4;0.0
72;2021-03-06;815;164;0;30190;16576;0;6.3;3.4;0.0
72;2021-03-07;421;25;0;30611;16601;0;6.3;3.4;0.0
72;2021-03-08;568;487;0;31179;17088;0;6.5;3.5;0.0
72;2021-03-09;1095;645;0;32274;17733;0;6.7;3.7;0.0
72;2021-03-10;1221;651;0;33495;18384;0;6.9;3.8;0.0
72;2021-03-11;1670;523;0;35165;18907;0;7.3;3.9;0.0
72;2021-03-12;1505;519;0;36670;19426;0;7.6;4.0;0.0
72;2021-03-13;1068;133;0;37738;19559;0;7.8;4.1;0.0
72;2021-03-14;25;8;0;37763;19567;0;7.8;4.1;0.0
72;2021-03-15;1210;215;0;38973;19782;0;8.1;4.1;0.0
72;2021-03-16;1115;196;0;40088;19978;0;8.3;4.1;0.0
72;2021-03-17;1105;270;0;41193;20248;0;8.5;4.2;0.0
72;2021-03-18;1175;385;0;42368;20633;0;8.8;4.3;0.0
72;2021-03-19;1385;297;0;43753;20930;0;9.1;4.3;0.0
72;2021-03-20;515;81;0;44268;21011;0;9.2;4.4;0.0
72;2021-03-21;26;4;0;44294;21015;0;9.2;4.4;0.0
72;2021-03-22;1428;346;0;45722;21361;0;9.5;4.4;0.0
72;2021-03-23;1837;507;0;47559;21868;0;9.9;4.5;0.0
72;2021-03-24;1967;306;0;49526;22174;0;10.3;4.6;0.0
72;2021-03-25;2584;481;0;52110;22655;0;10.8;4.7;0.0
72;2021-03-26;2494;371;0;54604;23026;0;11.3;4.8;0.0
72;2021-03-27;710;35;0;55314;23061;0;11.5;4.8;0.0
72;2021-03-28;49;1;0;55363;23062;0;11.5;4.8;0.0
72;2021-03-29;1718;381;0;57081;23443;0;11.8;4.9;0.0
72;2021-03-30;2614;406;0;59695;23849;0;12.4;4.9;0.0
72;2021-03-31;2341;385;0;62036;24234;0;12.9;5.0;0.0
72;2021-04-01;3047;383;0;65083;24617;0;13.5;5.1;0.0
72;2021-04-02;2439;440;0;67522;25057;0;14.0;5.2;0.0
72;2021-04-03;374;65;0;67896;25122;0;14.1;5.2;0.0
72;2021-04-04;26;6;0;67922;25128;0;14.1;5.2;0.0
72;2021-04-05;122;52;0;68044;25180;0;14.1;5.2;0.0
72;2021-04-06;1881;522;0;69925;25702;0;14.5;5.3;0.0
72;2021-04-07;2723;683;0;72648;26385;0;15.1;5.5;0.0
72;2021-04-08;2877;851;0;75525;27236;0;15.7;5.6;0.0
72;2021-04-09;4069;651;0;79594;27887;0;16.5;5.8;0.0
72;2021-04-10;1280;96;0;80874;27983;0;16.8;5.8;0.0
72;2021-04-11;31;8;0;80905;27991;0;16.8;5.8;0.0
72;2021-04-12;2017;968;0;82922;28959;0;17.2;6.0;0.0
72;2021-04-13;2615;1179;0;85537;30138;0;17.7;6.3;0.0
72;2021-04-14;2458;1177;0;87995;31315;0;18.2;6.5;0.0
72;2021-04-15;2704;1199;0;90699;32514;0;18.8;6.7;0.0
72;2021-04-16;2848;1090;0;93547;33604;0;19.4;7.0;0.0
72;2021-04-17;984;184;0;94531;33788;0;19.6;7.0;0.0
72;2021-04-18;90;5;0;94621;33793;0;19.6;7.0;0.0
72;2021-04-19;1620;1203;0;96241;34996;0;20.0;7.3;0.0
72;2021-04-20;3234;1387;0;99475;36383;0;20.6;7.5;0.0
72;2021-04-21;2687;1666;0;102162;38049;0;21.2;7.9;0.0
72;2021-04-22;3012;1909;0;105174;39958;0;21.8;8.3;0.0
72;2021-04-23;3428;1593;0;108602;41551;0;22.5;8.6;0.0
72;2021-04-24;1670;347;0;110272;41898;0;22.9;8.7;0.0
72;2021-04-25;873;26;0;111145;41924;0;23.1;8.7;0.0
72;2021-04-26;3664;1627;0;114809;43551;0;23.8;9.0;0.0
72;2021-04-27;4261;2048;0;119070;45599;0;24.7;9.5;0.0
72;2021-04-28;4070;2073;0;123140;47672;0;25.5;9.9;0.0
72;2021-04-29;4418;1962;0;127558;49634;0;26.5;10.3;0.0
72;2021-04-30;3895;1862;0;131453;51496;0;27.3;10.7;0.0
72;2021-05-01;1660;236;0;133113;51732;0;27.6;10.7;0.0
72;2021-05-02;1496;172;0;134609;51904;0;27.9;10.8;0.0
72;2021-05-03;3606;1280;0;138215;53184;0;28.7;11.0;0.0
72;2021-05-04;4133;2015;0;142348;55199;0;29.5;11.4;0.0
72;2021-05-05;3982;2345;0;146330;57544;0;30.3;11.9;0.0
72;2021-05-06;3819;2181;0;150149;59725;0;31.1;12.4;0.0
72;2021-05-07;3661;2386;0;153810;62111;0;31.9;12.9;0.0
72;2021-05-08;1977;225;0;155787;62336;0;32.3;12.9;0.0
72;2021-05-09;1949;220;0;157736;62556;0;32.7;13.0;0.0
72;2021-05-10;3823;1840;0;161559;64396;0;33.5;13.4;0.0
72;2021-05-11;4635;2313;0;166194;66709;0;34.5;13.8;0.0
72;2021-05-12;4166;2090;0;170360;68799;0;35.3;14.3;0.0
72;2021-05-13;2931;351;0;173291;69150;0;35.9;14.3;0.0
72;2021-05-14;3796;1534;0;177087;70684;0;36.7;14.7;0.0
72;2021-05-15;3144;518;0;180231;71202;0;37.4;14.8;0.0
72;2021-05-16;2390;157;0;182621;71359;0;37.9;14.8;0.0
72;2021-05-17;3860;1477;0;186481;72836;0;38.7;15.1;0.0
72;2021-05-18;4502;1841;0;190983;74677;0;39.6;15.5;0.0
72;2021-05-19;4184;1695;0;195167;76372;0;40.5;15.8;0.0
72;2021-05-20;4486;1553;0;199653;77925;0;41.4;16.2;0.0
72;2021-05-21;4000;1519;0;203653;79444;0;42.2;16.5;0.0
72;2021-05-22;2649;602;0;206302;80046;0;42.8;16.6;0.0
72;2021-05-23;1325;160;0;207627;80206;0;43.1;16.6;0.0
72;2021-05-24;2409;304;0;210036;80510;0;43.6;16.7;0.0
72;2021-05-25;4166;1472;0;214202;81982;0;44.4;17.0;0.0
72;2021-05-26;4195;1532;0;218397;83514;0;45.3;17.3;0.0
72;2021-05-27;4482;2123;0;222879;85637;0;46.2;17.8;0.0
72;2021-05-28;4205;2098;0;227084;87735;0;47.1;18.2;0.0
72;2021-05-29;2709;898;0;229793;88633;0;47.7;18.4;0.0
72;2021-05-30;1086;853;0;230879;89486;0;47.9;18.6;0.0
72;2021-05-31;3183;2451;0;234062;91937;0;48.5;19.1;0.0
72;2021-06-01;3637;2817;0;237699;94754;0;49.3;19.7;0.0
72;2021-06-02;3768;2901;0;241467;97655;0;50.1;20.3;0.0
72;2021-06-03;4496;3035;0;245963;100690;0;51.0;20.9;0.0
72;2021-06-04;4060;2877;0;250023;103567;0;51.9;21.5;0.0
72;2021-06-05;1577;2665;0;251600;106232;0;52.2;22.0;0.0
72;2021-06-06;859;1495;0;252459;107727;0;52.4;22.3;0.0
72;2021-06-07;2004;3612;0;254463;111339;0;52.8;23.1;0.0
72;2021-06-08;3153;4013;0;257616;115352;0;53.4;23.9;0.0
72;2021-06-09;2851;3478;0;260467;118830;0;54.0;24.6;0.0
72;2021-06-10;3066;3404;0;263533;122234;0;54.7;25.3;0.0
72;2021-06-11;3013;3931;0;266546;126165;0;55.3;26.2;0.0
72;2021-06-12;1501;2693;0;268047;128858;0;55.6;26.7;0.0
72;2021-06-13;410;1799;0;268457;130657;0;55.7;27.1;0.0
72;2021-06-14;1492;4315;0;269949;134972;0;56.0;28.0;0.0
72;2021-06-15;2866;3676;0;272815;138648;0;56.6;28.8;0.0
72;2021-06-16;2547;3725;0;275362;142373;0;57.1;29.5;0.0
72;2021-06-17;2452;3945;0;277814;146318;0;57.6;30.3;0.0
72;2021-06-18;2449;4471;0;280263;150789;0;58.1;31.3;0.0
72;2021-06-19;1242;2817;0;281505;153606;0;58.4;31.9;0.0
72;2021-06-20;336;1943;0;281841;155549;0;58.5;32.3;0.0
72;2021-06-21;1592;4146;0;283433;159695;0;58.8;33.1;0.0
72;2021-06-22;1840;5091;0;285273;164786;0;59.2;34.2;0.0
72;2021-06-23;2067;4423;0;287340;169209;0;59.6;35.1;0.0
72;2021-06-24;2315;4029;0;289655;173238;0;60.1;35.9;0.0
72;2021-06-25;1864;5044;0;291519;178282;0;60.5;37.0;0.0
72;2021-06-26;1235;2971;0;292754;181253;0;60.7;37.6;0.0
72;2021-06-27;400;1997;0;293154;183250;0;60.8;38.0;0.0
72;2021-06-28;1432;4521;0;294586;187771;0;61.1;38.9;0.0
72;2021-06-29;1770;5056;0;296356;192827;0;61.5;40.0;0.0
72;2021-06-30;2038;4495;0;298394;197322;0;61.9;40.9;0.0
72;2021-07-01;2043;4478;0;300437;201800;0;62.3;41.9;0.0
72;2021-07-02;1897;4928;1;302334;206728;1;62.7;42.9;0.0
72;2021-07-03;1308;3303;1;303642;210031;2;63.0;43.6;0.0
72;2021-07-04;571;1887;0;304213;211918;2;63.1;43.9;0.0
72;2021-07-05;1206;4284;0;305419;216202;2;63.3;44.8;0.0
72;2021-07-06;1519;5338;1;306938;221540;3;63.7;45.9;0.0
72;2021-07-07;1643;4766;0;308581;226306;3;64.0;46.9;0.0
72;2021-07-08;1737;4515;0;310318;230821;3;64.4;47.9;0.0
72;2021-07-09;2166;4793;0;312484;235614;3;64.8;48.9;0.0
72;2021-07-10;1616;2800;0;314100;238414;3;65.1;49.4;0.0
72;2021-07-11;908;1519;0;315008;239933;3;65.3;49.8;0.0
72;2021-07-12;1559;4003;0;316567;243936;3;65.7;50.6;0.0
72;2021-07-13;2092;5062;0;318659;248998;3;66.1;51.6;0.0
72;2021-07-14;1311;2327;0;319970;251325;3;66.4;52.1;0.0
72;2021-07-15;3437;3833;0;323407;255158;3;67.1;52.9;0.0
72;2021-07-16;3299;4502;0;326706;259660;3;67.8;53.9;0.0
72;2021-07-17;2515;1972;0;329221;261632;3;68.3;54.3;0.0
72;2021-07-18;1669;829;0;330890;262461;3;68.6;54.4;0.0
72;2021-07-19;2731;3833;1;333621;266294;4;69.2;55.2;0.0
72;2021-07-20;2989;4630;0;336610;270924;4;69.8;56.2;0.0
72;2021-07-21;2952;3832;1;339562;274756;5;70.4;57.0;0.0
72;2021-07-22;3791;3174;0;343353;277930;5;71.2;57.6;0.0
72;2021-07-23;3531;4037;0;346884;281967;5;71.9;58.5;0.0
72;2021-07-24;2777;1681;0;349661;283648;5;72.5;58.8;0.0
72;2021-07-25;1375;1043;0;351036;284691;5;72.8;59.0;0.0
72;2021-07-26;2850;3197;0;353886;287888;5;73.4;59.7;0.0
72;2021-07-27;3944;3982;0;357830;291870;5;74.2;60.5;0.0
72;2021-07-28;3718;3268;0;361548;295138;5;75.0;61.2;0.0
72;2021-07-29;3903;2857;0;365451;297995;5;75.8;61.8;0.0
72;2021-07-30;3838;3585;0;369289;301580;5;76.6;62.5;0.0
72;2021-07-31;2396;1910;0;371685;303490;5;77.1;62.9;0.0
72;2021-08-01;1734;439;0;373419;303929;5;77.4;63.0;0.0
72;2021-08-02;3143;2404;0;376562;306333;5;78.1;63.5;0.0
72;2021-08-03;3331;3325;0;379893;309658;5;78.8;64.2;0.0
72;2021-08-04;3695;2602;0;383588;312260;5;79.6;64.8;0.0
72;2021-08-05;3876;2556;0;387464;314816;5;80.4;65.3;0.0
72;2021-08-06;3364;2789;0;390828;317605;5;81.1;65.9;0.0
72;2021-08-07;2257;1681;0;393085;319286;5;81.5;66.2;0.0
72;2021-08-08;1470;704;0;394555;319990;5;81.8;66.4;0.0
72;2021-08-09;2566;2801;0;397121;322791;5;82.4;66.9;0.0
72;2021-08-10;2779;2858;0;399900;325649;5;82.9;67.5;0.0
72;2021-08-11;2284;2353;0;402184;328002;5;83.4;68.0;0.0
72;2021-08-12;2236;2627;0;404420;330629;5;83.9;68.6;0.0
72;2021-08-13;2054;2384;0;406474;333013;5;84.3;69.1;0.0
72;2021-08-14;1092;1585;0;407566;334598;5;84.5;69.4;0.0
72;2021-08-15;562;591;0;408128;335189;5;84.6;69.5;0.0
72;2021-08-16;1615;2554;0;409743;337743;5;85.0;70.0;0.0
72;2021-08-17;1690;3059;0;411433;340802;5;85.3;70.7;0.0
72;2021-08-18;1676;3033;0;413109;343835;5;85.7;71.3;0.0
72;2021-08-19;1221;3100;0;414330;346935;5;85.9;72.0;0.0
72;2021-08-20;1554;3367;0;415884;350302;5;86.2;72.6;0.0
72;2021-08-21;686;2024;0;416570;352326;5;86.4;73.1;0.0
72;2021-08-22;241;1105;0;416811;353431;5;86.4;73.3;0.0
72;2021-08-23;1657;3475;0;418468;356906;5;86.8;74.0;0.0
72;2021-08-24;1461;4158;0;419929;361064;5;87.1;74.9;0.0
72;2021-08-25;1533;3522;0;421462;364586;5;87.4;75.6;0.0
72;2021-08-26;1199;4375;0;422661;368961;5;87.7;76.5;0.0
72;2021-08-27;1162;4159;1;423823;373120;6;87.9;77.4;0.0
72;2021-08-28;844;2607;0;424667;375727;6;88.1;77.9;0.0
72;2021-08-29;337;1565;0;425004;377292;6;88.1;78.2;0.0
72;2021-08-30;1084;3302;61;426088;380594;67;88.4;78.9;0.0
72;2021-08-31;1152;3798;107;427240;384392;174;88.6;79.7;0.0
72;2021-09-01;1075;3126;163;428315;387518;337;88.8;80.4;0.1
72;2021-09-02;909;3120;230;429224;390638;567;89.0;81.0;0.1
72;2021-09-03;909;2995;244;430133;393633;811;89.2;81.6;0.2
72;2021-09-04;696;2506;114;430829;396139;925;89.3;82.2;0.2
72;2021-09-05;222;1370;56;431051;397509;981;89.4;82.4;0.2
72;2021-09-06;575;2424;302;431626;399933;1283;89.5;82.9;0.3
72;2021-09-07;494;2517;381;432120;402450;1664;89.6;83.5;0.3
72;2021-09-08;620;2899;308;432740;405349;1972;89.7;84.1;0.4
72;2021-09-09;408;1704;327;433148;407053;2299;89.8;84.4;0.5
72;2021-09-10;629;2273;353;433777;409326;2652;90.0;84.9;0.5
72;2021-09-11;403;2441;91;434180;411767;2743;90.0;85.4;0.6
72;2021-09-12;147;862;31;434327;412629;2774;90.1;85.6;0.6
72;2021-09-13;367;1248;336;434694;413877;3110;90.2;85.8;0.6
72;2021-09-14;474;1198;518;435168;415075;3628;90.2;86.1;0.8
72;2021-09-15;595;1887;410;435763;416962;4038;90.4;86.5;0.8
72;2021-09-16;347;778;466;436110;417740;4504;90.4;86.6;0.9
72;2021-09-17;446;1393;578;436556;419133;5082;90.5;86.9;1.1
72;2021-09-18;350;1437;127;436906;420570;5209;90.6;87.2;1.1
72;2021-09-19;82;344;33;436988;420914;5242;90.6;87.3;1.1
72;2021-09-20;350;796;348;437338;421710;5590;90.7;87.5;1.2
72;2021-09-21;318;777;645;437656;422487;6235;90.8;87.6;1.3
72;2021-09-22;411;1483;445;438067;423970;6680;90.8;87.9;1.4
72;2021-09-23;375;606;426;438442;424576;7106;90.9;88.1;1.5
72;2021-09-24;567;1018;389;439009;425594;7495;91.0;88.3;1.6
72;2021-09-25;252;976;149;439261;426570;7644;91.1;88.5;1.6
72;2021-09-26;74;194;26;439335;426764;7670;91.1;88.5;1.6
72;2021-09-27;214;612;503;439549;427376;8173;91.2;88.6;1.7
72;2021-09-28;201;418;687;439750;427794;8860;91.2;88.7;1.8
72;2021-09-29;337;946;730;440087;428740;9590;91.3;88.9;2.0
72;2021-09-30;169;341;411;440256;429081;10001;91.3;89.0;2.1
72;2021-10-01;323;717;522;440579;429798;10523;91.4;89.1;2.2
72;2021-10-02;291;561;208;440870;430359;10731;91.4;89.3;2.2
72;2021-10-03;82;142;20;440952;430501;10751;91.4;89.3;2.2
72;2021-10-04;199;418;448;441151;430919;11199;91.5;89.4;2.3
72;2021-10-05;256;349;480;441407;431268;11679;91.5;89.4;2.4
72;2021-10-06;262;535;583;441669;431803;12262;91.6;89.6;2.5
72;2021-10-07;211;342;487;441880;432145;12749;91.6;89.6;2.6
72;2021-10-08;326;644;685;442206;432789;13434;91.7;89.8;2.8
72;2021-10-09;226;436;172;442432;433225;13606;91.8;89.8;2.8
72;2021-10-10;76;111;47;442508;433336;13653;91.8;89.9;2.8
72;2021-10-11;180;290;535;442688;433626;14188;91.8;89.9;2.9
72;2021-10-12;216;344;699;442904;433970;14887;91.9;90.0;3.1
72;2021-10-13;272;474;691;443176;434444;15578;91.9;90.1;3.2
72;2021-10-14;135;287;489;443311;434731;16067;91.9;90.2;3.3
72;2021-10-15;310;428;712;443621;435159;16779;92.0;90.2;3.5
72;2021-10-16;189;263;223;443810;435422;17002;92.0;90.3;3.5
72;2021-10-17;44;91;46;443854;435513;17048;92.0;90.3;3.5
72;2021-10-18;192;342;506;444046;435855;17554;92.1;90.4;3.6
72;2021-10-19;182;250;701;444228;436105;18255;92.1;90.4;3.8
72;2021-10-20;199;390;906;444427;436495;19161;92.2;90.5;4.0
72;2021-10-21;129;331;681;444556;436826;19842;92.2;90.6;4.1
72;2021-10-22;244;519;1035;444800;437345;20877;92.2;90.7;4.3
72;2021-10-23;173;307;385;444973;437652;21262;92.3;90.8;4.4
72;2021-10-24;39;84;42;445012;437736;21304;92.3;90.8;4.4
72;2021-10-25;196;242;767;445208;437978;22071;92.3;90.8;4.6
72;2021-10-26;157;197;960;445365;438175;23031;92.4;90.9;4.8
72;2021-10-27;177;267;1036;445542;438442;24067;92.4;90.9;5.0
72;2021-10-28;131;153;671;445673;438595;24738;92.4;91.0;5.1
72;2021-10-29;226;321;1161;445899;438916;25899;92.5;91.0;5.4
72;2021-10-30;115;197;267;446014;439113;26166;92.5;91.1;5.4
72;2021-10-31;24;74;40;446038;439187;26206;92.5;91.1;5.4
72;2021-11-01;33;23;68;446071;439210;26274;92.5;91.1;5.4
72;2021-11-02;171;245;860;446242;439455;27134;92.5;91.1;5.6
72;2021-11-03;143;280;974;446385;439735;28108;92.6;91.2;5.8
72;2021-11-04;140;170;926;446525;439905;29034;92.6;91.2;6.0
72;2021-11-05;238;302;1509;446763;440207;30543;92.7;91.3;6.3
72;2021-11-06;128;193;545;446891;440400;31088;92.7;91.3;6.4
72;2021-11-07;26;30;74;446917;440430;31162;92.7;91.3;6.5
72;2021-11-08;123;223;1607;447040;440653;32769;92.7;91.4;6.8
72;2021-11-09;163;206;1833;447203;440859;34602;92.7;91.4;7.2
72;2021-11-10;208;235;1868;447411;441094;36470;92.8;91.5;7.6
72;2021-11-11;68;53;215;447479;441147;36685;92.8;91.5;7.6
72;2021-11-12;164;237;1408;447643;441384;38093;92.8;91.5;7.9
72;2021-11-13;106;131;483;447749;441515;38576;92.9;91.6;8.0
72;2021-11-14;45;51;112;447794;441566;38688;92.9;91.6;8.0
72;2021-11-15;106;208;1641;447900;441774;40329;92.9;91.6;8.4
72;2021-11-16;152;177;2110;448052;441951;42439;92.9;91.7;8.8
72;2021-11-17;186;229;1840;448238;442180;44279;93.0;91.7;9.2
72;2021-11-18;150;129;1763;448388;442309;46042;93.0;91.7;9.5
72;2021-11-19;248;258;2356;448636;442567;48398;93.0;91.8;10.0
72;2021-11-20;181;175;538;448817;442742;48936;93.1;91.8;10.1
72;2021-11-21;52;53;107;448869;442795;49043;93.1;91.8;10.2
72;2021-11-22;120;138;1899;448989;442933;50942;93.1;91.9;10.6
72;2021-11-23;141;146;1806;449130;443079;52748;93.1;91.9;10.9
72;2021-11-24;234;212;1981;449364;443291;54729;93.2;91.9;11.4
72;2021-11-25;166;133;2076;449530;443424;56805;93.2;92.0;11.8
72;2021-11-26;249;257;2963;449779;443681;59768;93.3;92.0;12.4
72;2021-11-27;170;177;1614;449949;443858;61382;93.3;92.1;12.7
72;2021-11-28;45;40;1178;449994;443898;62560;93.3;92.1;13.0
72;2021-11-29;109;132;3511;450103;444030;66071;93.3;92.1;13.7
72;2021-11-30;134;137;3898;450237;444167;69969;93.4;92.1;14.5
72;2021-12-01;174;184;4419;450411;444351;74388;93.4;92.2;15.4
72;2021-12-02;117;131;4477;450528;444482;78865;93.4;92.2;16.4
72;2021-12-03;121;184;4886;450649;444666;83751;93.5;92.2;17.4
72;2021-12-04;86;168;2668;450735;444834;86419;93.5;92.3;17.9
72;2021-12-05;35;40;1324;450770;444874;87743;93.5;92.3;18.2
72;2021-12-06;121;131;5122;450891;445005;92865;93.5;92.3;19.3
72;2021-12-07;111;131;6280;451002;445136;99145;93.5;92.3;20.6
72;2021-12-08;125;210;5357;451127;445346;104502;93.6;92.4;21.7
72;2021-12-09;122;134;6206;451249;445480;110708;93.6;92.4;23.0
72;2021-12-10;122;224;6110;451371;445704;116818;93.6;92.4;24.2
72;2021-12-11;90;206;3371;451461;445910;120189;93.6;92.5;24.9
72;2021-12-12;48;56;1776;451509;445966;121965;93.6;92.5;25.3
72;2021-12-13;111;128;5493;451620;446094;127458;93.7;92.5;26.4
72;2021-12-14;127;190;7243;451747;446284;134701;93.7;92.6;27.9
72;2021-12-15;139;211;6435;451886;446495;141136;93.7;92.6;29.3
72;2021-12-16;147;190;7244;452033;446685;148380;93.7;92.6;30.8
72;2021-12-17;131;259;6877;452164;446944;155257;93.8;92.7;32.2
72;2021-12-18;95;150;3927;452259;447094;159184;93.8;92.7;33.0
72;2021-12-19;67;78;2117;452326;447172;161301;93.8;92.7;33.5
73;2020-12-27;0;0;0;0;0;0;0.0;0.0;0.0
73;2020-12-28;0;0;0;0;0;0;0.0;0.0;0.0
73;2020-12-29;0;0;0;0;0;0;0.0;0.0;0.0
73;2020-12-30;0;0;0;0;0;0;0.0;0.0;0.0
73;2020-12-31;0;0;0;0;0;0;0.0;0.0;0.0
73;2021-01-01;1;0;0;1;0;0;0.0;0.0;0.0
73;2021-01-02;0;0;0;1;0;0;0.0;0.0;0.0
73;2021-01-03;0;0;0;1;0;0;0.0;0.0;0.0
73;2021-01-04;7;0;0;8;0;0;0.0;0.0;0.0
73;2021-01-05;3;0;0;11;0;0;0.0;0.0;0.0
73;2021-01-06;11;0;0;22;0;0;0.0;0.0;0.0
73;2021-01-07;43;0;0;65;0;0;0.0;0.0;0.0
73;2021-01-08;90;0;0;155;0;0;0.0;0.0;0.0
73;2021-01-09;0;0;0;155;0;0;0.0;0.0;0.0
73;2021-01-10;1;0;0;156;0;0;0.0;0.0;0.0
73;2021-01-11;112;0;0;268;0;0;0.1;0.0;0.0
73;2021-01-12;321;0;0;589;0;0;0.2;0.0;0.0
73;2021-01-13;373;0;0;962;0;0;0.3;0.0;0.0
73;2021-01-14;529;2;0;1491;2;0;0.4;0.0;0.0
73;2021-01-15;591;1;0;2082;3;0;0.6;0.0;0.0
73;2021-01-16;135;2;0;2217;5;0;0.6;0.0;0.0
73;2021-01-17;10;0;0;2227;5;0;0.6;0.0;0.0
73;2021-01-18;556;0;0;2783;5;0;0.7;0.0;0.0
73;2021-01-19;1171;4;0;3954;9;0;1.1;0.0;0.0
73;2021-01-20;894;3;0;4848;12;0;1.3;0.0;0.0
73;2021-01-21;982;4;0;5830;16;0;1.6;0.0;0.0
73;2021-01-22;868;1;0;6698;17;0;1.8;0.0;0.0
73;2021-01-23;365;0;0;7063;17;0;1.9;0.0;0.0
73;2021-01-24;0;0;0;7063;17;0;1.9;0.0;0.0
73;2021-01-25;611;10;0;7674;27;0;2.0;0.0;0.0
73;2021-01-26;715;7;0;8389;34;0;2.2;0.0;0.0
73;2021-01-27;963;13;0;9352;47;0;2.5;0.0;0.0
73;2021-01-28;862;12;0;10214;59;0;2.7;0.0;0.0
73;2021-01-29;616;17;0;10830;76;0;2.9;0.0;0.0
73;2021-01-30;291;3;0;11121;79;0;3.0;0.0;0.0
73;2021-01-31;0;1;0;11121;80;0;3.0;0.0;0.0
73;2021-02-01;571;42;0;11692;122;0;3.1;0.0;0.0
73;2021-02-02;702;315;0;12394;437;0;3.3;0.1;0.0
73;2021-02-03;609;346;0;13003;783;0;3.5;0.2;0.0
73;2021-02-04;606;226;0;13609;1009;0;3.6;0.3;0.0
73;2021-02-05;600;392;0;14209;1401;0;3.8;0.4;0.0
73;2021-02-06;216;39;0;14425;1440;0;3.8;0.4;0.0
73;2021-02-07;1;1;0;14426;1441;0;3.8;0.4;0.0
73;2021-02-08;497;251;0;14923;1692;0;4.0;0.5;0.0
73;2021-02-09;750;456;0;15673;2148;0;4.2;0.6;0.0
73;2021-02-10;778;394;0;16451;2542;0;4.4;0.7;0.0
73;2021-02-11;946;690;0;17397;3232;0;4.6;0.9;0.0
73;2021-02-12;768;512;0;18165;3744;0;4.8;1.0;0.0
73;2021-02-13;265;66;0;18430;3810;0;4.9;1.0;0.0
73;2021-02-14;8;6;0;18438;3816;0;4.9;1.0;0.0
73;2021-02-15;341;518;0;18779;4334;0;5.0;1.2;0.0
73;2021-02-16;462;737;0;19241;5071;0;5.1;1.4;0.0
73;2021-02-17;450;883;0;19691;5954;0;5.3;1.6;0.0
73;2021-02-18;442;503;0;20133;6457;0;5.4;1.7;0.0
73;2021-02-19;397;605;0;20530;7062;0;5.5;1.9;0.0
73;2021-02-20;85;236;0;20615;7298;0;5.5;1.9;0.0
73;2021-02-21;1;0;0;20616;7298;0;5.5;1.9;0.0
73;2021-02-22;247;383;0;20863;7681;0;5.6;2.0;0.0
73;2021-02-23;323;479;0;21186;8160;0;5.6;2.2;0.0
73;2021-02-24;467;666;0;21653;8826;0;5.8;2.4;0.0
73;2021-02-25;528;520;0;22181;9346;0;5.9;2.5;0.0
73;2021-02-26;725;553;0;22906;9899;0;6.1;2.6;0.0
73;2021-02-27;304;168;0;23210;10067;0;6.2;2.7;0.0
73;2021-02-28;4;3;0;23214;10070;0;6.2;2.7;0.0
73;2021-03-01;569;471;0;23783;10541;0;6.3;2.8;0.0
73;2021-03-02;687;851;0;24470;11392;0;6.5;3.0;0.0
73;2021-03-03;629;1102;0;25099;12494;0;6.7;3.3;0.0
73;2021-03-04;1026;871;0;26125;13365;0;7.0;3.6;0.0
73;2021-03-05;1234;583;0;27359;13948;0;7.3;3.7;0.0
73;2021-03-06;1055;332;0;28414;14280;0;7.6;3.8;0.0
73;2021-03-07;419;83;0;28833;14363;0;7.7;3.8;0.0
73;2021-03-08;609;424;0;29442;14787;0;7.9;3.9;0.0
73;2021-03-09;979;522;0;30421;15309;0;8.1;4.1;0.0
73;2021-03-10;1036;833;0;31457;16142;0;8.4;4.3;0.0
73;2021-03-11;1547;642;0;33004;16784;0;8.8;4.5;0.0
73;2021-03-12;1954;525;0;34958;17309;0;9.3;4.6;0.0
73;2021-03-13;1169;215;0;36127;17524;0;9.6;4.7;0.0
73;2021-03-14;69;2;0;36196;17526;0;9.7;4.7;0.0
73;2021-03-15;1183;399;0;37379;17925;0;10.0;4.8;0.0
73;2021-03-16;798;406;0;38177;18331;0;10.2;4.9;0.0
73;2021-03-17;867;478;0;39044;18809;0;10.4;5.0;0.0
73;2021-03-18;1334;258;0;40378;19067;0;10.8;5.1;0.0
73;2021-03-19;1711;340;0;42089;19407;0;11.2;5.2;0.0
73;2021-03-20;899;137;0;42988;19544;0;11.5;5.2;0.0
73;2021-03-21;121;3;0;43109;19547;0;11.5;5.2;0.0
73;2021-03-22;1206;394;0;44315;19941;0;11.8;5.3;0.0
73;2021-03-23;1509;261;0;45824;20202;0;12.2;5.4;0.0
73;2021-03-24;1647;362;0;47471;20564;0;12.7;5.5;0.0
73;2021-03-25;2092;391;0;49563;20955;0;13.2;5.6;0.0
73;2021-03-26;2469;361;0;52032;21316;0;13.9;5.7;0.0
73;2021-03-27;923;161;0;52955;21477;0;14.1;5.7;0.0
73;2021-03-28;287;17;0;53242;21494;0;14.2;5.7;0.0
73;2021-03-29;1572;271;0;54814;21765;0;14.6;5.8;0.0
73;2021-03-30;2137;503;0;56951;22268;0;15.2;5.9;0.0
73;2021-03-31;2104;417;0;59055;22685;0;15.7;6.0;0.0
73;2021-04-01;2203;374;0;61258;23059;0;16.3;6.1;0.0
73;2021-04-02;2404;256;0;63662;23315;0;17.0;6.2;0.0
73;2021-04-03;864;167;0;64526;23482;0;17.2;6.3;0.0
73;2021-04-04;185;16;0;64711;23498;0;17.3;6.3;0.0
73;2021-04-05;327;38;0;65038;23536;0;17.3;6.3;0.0
73;2021-04-06;1656;542;0;66694;24078;0;17.8;6.4;0.0
73;2021-04-07;2086;677;0;68780;24755;0;18.3;6.6;0.0
73;2021-04-08;2585;855;0;71365;25610;0;19.0;6.8;0.0
73;2021-04-09;3098;592;0;74463;26202;0;19.9;7.0;0.0
73;2021-04-10;1278;366;0;75741;26568;0;20.2;7.1;0.0
73;2021-04-11;150;13;0;75891;26581;0;20.2;7.1;0.0
73;2021-04-12;1750;957;0;77641;27538;0;20.7;7.3;0.0
73;2021-04-13;2003;1135;0;79644;28673;0;21.2;7.6;0.0
73;2021-04-14;2095;1086;0;81739;29759;0;21.8;7.9;0.0
73;2021-04-15;2496;1190;0;84235;30949;0;22.5;8.3;0.0
73;2021-04-16;1953;970;0;86188;31919;0;23.0;8.5;0.0
73;2021-04-17;1246;585;0;87434;32504;0;23.3;8.7;0.0
73;2021-04-18;153;74;0;87587;32578;0;23.4;8.7;0.0
73;2021-04-19;1418;1119;0;89005;33697;0;23.7;9.0;0.0
73;2021-04-20;1871;1386;0;90876;35083;0;24.2;9.4;0.0
73;2021-04-21;1665;1330;0;92541;36413;0;24.7;9.7;0.0
73;2021-04-22;1952;1276;0;94493;37689;0;25.2;10.0;0.0
73;2021-04-23;1984;1285;0;96477;38974;0;25.7;10.4;0.0
73;2021-04-24;1070;720;0;97547;39694;0;26.0;10.6;0.0
73;2021-04-25;95;103;0;97642;39797;0;26.0;10.6;0.0
73;2021-04-26;1251;1370;0;98893;41167;0;26.4;11.0;0.0
73;2021-04-27;1600;1563;0;100493;42730;0;26.8;11.4;0.0
73;2021-04-28;1854;1550;0;102347;44280;0;27.3;11.8;0.0
73;2021-04-29;2563;1581;0;104910;45861;0;28.0;12.2;0.0
73;2021-04-30;2520;1482;0;107430;47343;0;28.6;12.6;0.0
73;2021-05-01;1076;319;0;108506;47662;0;28.9;12.7;0.0
73;2021-05-02;49;160;0;108555;47822;0;28.9;12.8;0.0
73;2021-05-03;1499;1730;0;110054;49552;0;29.3;13.2;0.0
73;2021-05-04;1843;2069;0;111897;51621;0;29.8;13.8;0.0
73;2021-05-05;2060;1910;0;113957;53531;0;30.4;14.3;0.0
73;2021-05-06;2522;1845;0;116479;55376;0;31.1;14.8;0.0
73;2021-05-07;2341;1987;0;118820;57363;0;31.7;15.3;0.0
73;2021-05-08;1750;392;0;120570;57755;0;32.1;15.4;0.0
73;2021-05-09;229;154;0;120799;57909;0;32.2;15.4;0.0
73;2021-05-10;1668;2004;0;122467;59913;0;32.7;16.0;0.0
73;2021-05-11;2483;2522;0;124950;62435;0;33.3;16.6;0.0
73;2021-05-12;3562;2165;0;128512;64600;0;34.3;17.2;0.0
73;2021-05-13;1778;333;0;130290;64933;0;34.7;17.3;0.0
73;2021-05-14;1914;1575;0;132204;66508;0;35.3;17.7;0.0
73;2021-05-15;1722;1028;0;133926;67536;0;35.7;18.0;0.0
73;2021-05-16;420;105;0;134346;67641;0;35.8;18.0;0.0
73;2021-05-17;2016;1942;0;136362;69583;0;36.4;18.6;0.0
73;2021-05-18;2840;1807;0;139202;71390;0;37.1;19.0;0.0
73;2021-05-19;2794;1597;0;141996;72987;0;37.9;19.5;0.0
73;2021-05-20;3479;1567;0;145475;74554;0;38.8;19.9;0.0
73;2021-05-21;2735;1844;0;148210;76398;0;39.5;20.4;0.0
73;2021-05-22;2113;907;0;150323;77305;0;40.1;20.6;0.0
73;2021-05-23;386;29;0;150709;77334;0;40.2;20.6;0.0
73;2021-05-24;2533;354;0;153242;77688;0;40.9;20.7;0.0
73;2021-05-25;2410;1779;0;155652;79467;0;41.5;21.2;0.0
73;2021-05-26;2415;1990;0;158067;81457;0;42.1;21.7;0.0
73;2021-05-27;3246;1789;0;161313;83246;0;43.0;22.2;0.0
73;2021-05-28;3029;2346;0;164342;85592;0;43.8;22.8;0.0
73;2021-05-29;2268;1318;0;166610;86910;0;44.4;23.2;0.0
73;2021-05-30;257;38;0;166867;86948;0;44.5;23.2;0.0
73;2021-05-31;2404;1764;0;169271;88712;0;45.1;23.7;0.0
73;2021-06-01;3155;1942;0;172426;90654;0;46.0;24.2;0.0
73;2021-06-02;2978;1510;0;175404;92164;0;46.8;24.6;0.0
73;2021-06-03;4240;1810;0;179644;93974;0;47.9;25.1;0.0
73;2021-06-04;4142;2325;0;183786;96299;0;49.0;25.7;0.0
73;2021-06-05;2923;1354;0;186709;97653;0;49.8;26.0;0.0
73;2021-06-06;1620;282;0;188329;97935;0;50.2;26.1;0.0
73;2021-06-07;2569;2218;0;190898;100153;0;50.9;26.7;0.0
73;2021-06-08;2572;1993;0;193470;102146;0;51.6;27.2;0.0
73;2021-06-09;2247;1870;0;195717;104016;0;52.2;27.7;0.0
73;2021-06-10;1942;1741;0;197659;105757;0;52.7;28.2;0.0
73;2021-06-11;2114;2516;0;199773;108273;0;53.3;28.9;0.0
73;2021-06-12;2054;1348;0;201827;109621;0;53.8;29.2;0.0
73;2021-06-13;71;98;0;201898;109719;0;53.8;29.3;0.0
73;2021-06-14;1277;3004;0;203175;112723;0;54.2;30.1;0.0
73;2021-06-15;1607;2785;0;204782;115508;0;54.6;30.8;0.0
73;2021-06-16;1476;2599;0;206258;118107;0;55.0;31.5;0.0
73;2021-06-17;1014;1792;0;207272;119899;0;55.3;32.0;0.0
73;2021-06-18;1863;2906;0;209135;122805;0;55.8;32.7;0.0
73;2021-06-19;1254;1970;0;210389;124775;0;56.1;33.3;0.0
73;2021-06-20;373;294;0;210762;125069;0;56.2;33.3;0.0
73;2021-06-21;1088;3054;0;211850;128123;0;56.5;34.2;0.0
73;2021-06-22;1075;2975;0;212925;131098;0;56.8;35.0;0.0
73;2021-06-23;1058;3176;0;213983;134274;0;57.1;35.8;0.0
73;2021-06-24;915;1968;0;214898;136242;0;57.3;36.3;0.0
73;2021-06-25;1228;2938;0;216126;139180;0;57.6;37.1;0.0
73;2021-06-26;842;2492;0;216968;141672;0;57.9;37.8;0.0
73;2021-06-27;279;576;0;217247;142248;0;57.9;37.9;0.0
73;2021-06-28;911;3694;0;218158;145942;0;58.2;38.9;0.0
73;2021-06-29;1037;3531;0;219195;149473;0;58.4;39.9;0.0
73;2021-06-30;1160;3155;0;220355;152628;0;58.8;40.7;0.0
73;2021-07-01;1205;2547;0;221560;155175;0;59.1;41.4;0.0
73;2021-07-02;1253;3733;0;222813;158908;0;59.4;42.4;0.0
73;2021-07-03;926;2810;0;223739;161718;0;59.7;43.1;0.0
73;2021-07-04;280;613;0;224019;162331;0;59.7;43.3;0.0
73;2021-07-05;1137;3669;0;225156;166000;0;60.0;44.3;0.0
73;2021-07-06;1262;3022;0;226418;169022;0;60.4;45.1;0.0
73;2021-07-07;1387;2950;0;227805;171972;0;60.7;45.9;0.0
73;2021-07-08;1318;2326;0;229123;174298;0;61.1;46.5;0.0
73;2021-07-09;1398;3944;0;230521;178242;0;61.5;47.5;0.0
73;2021-07-10;805;2917;0;231326;181159;0;61.7;48.3;0.0
73;2021-07-11;499;1283;0;231825;182442;0;61.8;48.6;0.0
73;2021-07-12;983;4025;0;232808;186467;0;62.1;49.7;0.0
73;2021-07-13;1746;4134;0;234554;190601;0;62.5;50.8;0.0
73;2021-07-14;1587;1705;0;236141;192306;0;63.0;51.3;0.0
73;2021-07-15;2533;3534;0;238674;195840;0;63.6;52.2;0.0
73;2021-07-16;2363;3857;0;241037;199697;0;64.3;53.2;0.0
73;2021-07-17;1501;2488;0;242538;202185;0;64.7;53.9;0.0
73;2021-07-18;929;1042;0;243467;203227;0;64.9;54.2;0.0
73;2021-07-19;2189;3093;0;245656;206320;0;65.5;55.0;0.0
73;2021-07-20;3154;2750;0;248810;209070;0;66.3;55.7;0.0
73;2021-07-21;3044;2573;0;251854;211643;0;67.2;56.4;0.0
73;2021-07-22;2662;2130;0;254516;213773;0;67.9;57.0;0.0
73;2021-07-23;3291;2861;0;257807;216634;0;68.7;57.8;0.0
73;2021-07-24;1944;2162;0;259751;218796;0;69.3;58.3;0.0
73;2021-07-25;537;652;0;260288;219448;0;69.4;58.5;0.0
73;2021-07-26;2497;2360;0;262785;221808;0;70.1;59.1;0.0
73;2021-07-27;3482;2145;0;266267;223953;0;71.0;59.7;0.0
73;2021-07-28;3275;1932;0;269542;225885;0;71.9;60.2;0.0
73;2021-07-29;3529;1821;0;273071;227706;0;72.8;60.7;0.0
73;2021-07-30;3332;2348;0;276403;230054;0;73.7;61.3;0.0
73;2021-07-31;2232;1386;0;278635;231440;0;74.3;61.7;0.0
73;2021-08-01;703;528;0;279338;231968;0;74.5;61.9;0.0
73;2021-08-02;2927;1924;0;282265;233892;0;75.3;62.4;0.0
73;2021-08-03;3159;1793;0;285424;235685;0;76.1;62.8;0.0
73;2021-08-04;2935;1830;0;288359;237515;0;76.9;63.3;0.0
73;2021-08-05;2519;1905;0;290878;239420;0;77.6;63.8;0.0
73;2021-08-06;2202;2262;0;293080;241682;0;78.1;64.4;0.0
73;2021-08-07;1250;1418;0;294330;243100;0;78.5;64.8;0.0
73;2021-08-08;377;494;0;294707;243594;0;78.6;65.0;0.0
73;2021-08-09;1610;2142;0;296317;245736;0;79.0;65.5;0.0
73;2021-08-10;1699;2300;0;298016;248036;0;79.5;66.1;0.0
73;2021-08-11;1590;2291;0;299606;250327;0;79.9;66.7;0.0
73;2021-08-12;1489;2236;0;301095;252563;0;80.3;67.3;0.0
73;2021-08-13;1373;2663;0;302468;255226;0;80.7;68.1;0.0
73;2021-08-14;926;1505;0;303394;256731;0;80.9;68.5;0.0
73;2021-08-15;89;165;0;303483;256896;0;80.9;68.5;0.0
73;2021-08-16;916;1551;0;304399;258447;0;81.2;68.9;0.0
73;2021-08-17;920;1909;0;305319;260356;0;81.4;69.4;0.0
73;2021-08-18;905;2632;0;306224;262988;0;81.7;70.1;0.0
73;2021-08-19;904;2739;0;307128;265727;0;81.9;70.9;0.0
73;2021-08-20;829;2981;0;307957;268708;0;82.1;71.7;0.0
73;2021-08-21;422;1821;0;308379;270529;0;82.2;72.1;0.0
73;2021-08-22;212;799;0;308591;271328;0;82.3;72.3;0.0
73;2021-08-23;701;2814;0;309292;274142;0;82.5;73.1;0.0
73;2021-08-24;859;2976;0;310151;277118;0;82.7;73.9;0.0
73;2021-08-25;721;2725;0;310872;279843;0;82.9;74.6;0.0
73;2021-08-26;682;2260;0;311554;282103;0;83.1;75.2;0.0
73;2021-08-27;761;2589;0;312315;284692;0;83.3;75.9;0.0
73;2021-08-28;430;1682;0;312745;286374;0;83.4;76.4;0.0
73;2021-08-29;250;835;0;312995;287209;0;83.5;76.6;0.0
73;2021-08-30;820;2477;20;313815;289686;20;83.7;77.2;0.0
73;2021-08-31;774;2284;31;314589;291970;51;83.9;77.9;0.0
73;2021-09-01;831;1950;155;315420;293920;206;84.1;78.4;0.1
73;2021-09-02;631;1665;280;316051;295585;486;84.3;78.8;0.1
73;2021-09-03;692;1884;210;316743;297469;696;84.5;79.3;0.2
73;2021-09-04;523;1232;92;317266;298701;788;84.6;79.6;0.2
73;2021-09-05;197;598;40;317463;299299;828;84.7;79.8;0.2
73;2021-09-06;377;1044;242;317840;300343;1070;84.8;80.1;0.3
73;2021-09-07;394;863;249;318234;301206;1319;84.9;80.3;0.4
73;2021-09-08;477;924;188;318711;302130;1507;85.0;80.6;0.4
73;2021-09-09;456;891;275;319167;303021;1782;85.1;80.8;0.5
73;2021-09-10;602;1174;284;319769;304195;2066;85.3;81.1;0.6
73;2021-09-11;363;896;88;320132;305091;2154;85.4;81.4;0.6
73;2021-09-12;68;140;9;320200;305231;2163;85.4;81.4;0.6
73;2021-09-13;342;702;345;320542;305933;2508;85.5;81.6;0.7
73;2021-09-14;397;630;375;320939;306563;2883;85.6;81.7;0.8
73;2021-09-15;415;880;312;321354;307443;3195;85.7;82.0;0.9
73;2021-09-16;323;590;307;321677;308033;3502;85.8;82.1;0.9
73;2021-09-17;390;874;429;322067;308907;3931;85.9;82.4;1.0
73;2021-09-18;256;617;135;322323;309524;4066;85.9;82.5;1.1
73;2021-09-19;45;176;9;322368;309700;4075;86.0;82.6;1.1
73;2021-09-20;182;647;378;322550;310347;4453;86.0;82.8;1.2
73;2021-09-21;283;534;534;322833;310881;4987;86.1;82.9;1.3
73;2021-09-22;270;789;328;323103;311670;5315;86.2;83.1;1.4
73;2021-09-23;244;479;421;323347;312149;5736;86.2;83.2;1.5
73;2021-09-24;283;826;475;323630;312975;6211;86.3;83.5;1.7
73;2021-09-25;187;720;99;323817;313695;6310;86.3;83.6;1.7
73;2021-09-26;60;181;14;323877;313876;6324;86.4;83.7;1.7
73;2021-09-27;238;482;527;324115;314358;6851;86.4;83.8;1.8
73;2021-09-28;190;347;435;324305;314705;7286;86.5;83.9;1.9
73;2021-09-29;232;656;335;324537;315361;7621;86.5;84.1;2.0
73;2021-09-30;200;379;326;324737;315740;7947;86.6;84.2;2.1
73;2021-10-01;273;585;339;325010;316325;8286;86.7;84.3;2.2
73;2021-10-02;191;492;150;325201;316817;8436;86.7;84.5;2.2
73;2021-10-03;8;31;3;325209;316848;8439;86.7;84.5;2.3
73;2021-10-04;249;365;434;325458;317213;8873;86.8;84.6;2.4
73;2021-10-05;179;319;521;325637;317532;9394;86.8;84.7;2.5
73;2021-10-06;310;496;395;325947;318028;9789;86.9;84.8;2.6
73;2021-10-07;170;304;423;326117;318332;10212;87.0;84.9;2.7
73;2021-10-08;324;561;588;326441;318893;10800;87.0;85.0;2.9
73;2021-10-09;170;358;121;326611;319251;10921;87.1;85.1;2.9
73;2021-10-10;6;15;4;326617;319266;10925;87.1;85.1;2.9
73;2021-10-11;208;329;401;326825;319595;11326;87.1;85.2;3.0
73;2021-10-12;150;193;292;326975;319788;11618;87.2;85.3;3.1
73;2021-10-13;233;364;459;327208;320152;12077;87.2;85.4;3.2
73;2021-10-14;175;301;551;327383;320453;12628;87.3;85.4;3.4
73;2021-10-15;225;350;464;327608;320803;13092;87.4;85.5;3.5
73;2021-10-16;122;198;160;327730;321001;13252;87.4;85.6;3.5
73;2021-10-17;4;7;25;327734;321008;13277;87.4;85.6;3.5
73;2021-10-18;178;338;433;327912;321346;13710;87.4;85.7;3.7
73;2021-10-19;102;255;804;328014;321601;14514;87.5;85.8;3.9
73;2021-10-20;107;201;501;328121;321802;15015;87.5;85.8;4.0
73;2021-10-21;79;189;662;328200;321991;15677;87.5;85.9;4.2
73;2021-10-22;115;215;528;328315;322206;16205;87.5;85.9;4.3
73;2021-10-23;66;151;121;328381;322357;16326;87.6;86.0;4.4
73;2021-10-24;2;12;1;328383;322369;16327;87.6;86.0;4.4
73;2021-10-25;106;136;576;328489;322505;16903;87.6;86.0;4.5
73;2021-10-26;128;202;917;328617;322707;17820;87.6;86.0;4.8
73;2021-10-27;94;249;706;328711;322956;18526;87.6;86.1;4.9
73;2021-10-28;88;144;841;328799;323100;19367;87.7;86.2;5.2
73;2021-10-29;124;258;826;328923;323358;20193;87.7;86.2;5.4
73;2021-10-30;61;143;255;328984;323501;20448;87.7;86.3;5.5
73;2021-10-31;6;25;33;328990;323526;20481;87.7;86.3;5.5
73;2021-11-01;22;6;39;329012;323532;20520;87.7;86.3;5.5
73;2021-11-02;116;194;902;329128;323726;21422;87.8;86.3;5.7
73;2021-11-03;89;183;850;329217;323909;22272;87.8;86.4;5.9
73;2021-11-04;85;166;873;329302;324075;23145;87.8;86.4;6.2
73;2021-11-05;105;206;1061;329407;324281;24206;87.8;86.5;6.5
73;2021-11-06;76;142;503;329483;324423;24709;87.9;86.5;6.6
73;2021-11-07;1;5;6;329484;324428;24715;87.9;86.5;6.6
73;2021-11-08;87;154;1197;329571;324582;25912;87.9;86.5;6.9
73;2021-11-09;87;153;1384;329658;324735;27296;87.9;86.6;7.3
73;2021-11-10;135;181;1334;329793;324916;28630;87.9;86.6;7.6
73;2021-11-11;8;22;99;329801;324938;28729;87.9;86.6;7.7
73;2021-11-12;94;157;1245;329895;325095;29974;88.0;86.7;8.0
73;2021-11-13;70;98;483;329965;325193;30457;88.0;86.7;8.1
73;2021-11-14;2;6;5;329967;325199;30462;88.0;86.7;8.1
73;2021-11-15;79;145;1650;330046;325344;32112;88.0;86.8;8.6
73;2021-11-16;90;126;1835;330136;325470;33947;88.0;86.8;9.1
73;2021-11-17;107;146;1492;330243;325616;35439;88.1;86.8;9.4
73;2021-11-18;69;84;1510;330312;325700;36949;88.1;86.8;9.9
73;2021-11-19;155;192;1744;330467;325892;38693;88.1;86.9;10.3
73;2021-11-20;114;114;723;330581;326006;39416;88.1;86.9;10.5
73;2021-11-21;2;14;86;330583;326020;39502;88.1;86.9;10.5
73;2021-11-22;86;84;1789;330669;326104;41291;88.2;87.0;11.0
73;2021-11-23;116;129;2000;330785;326233;43291;88.2;87.0;11.5
73;2021-11-24;150;139;1611;330935;326372;44902;88.2;87.0;12.0
73;2021-11-25;93;82;2067;331028;326454;46969;88.3;87.0;12.5
73;2021-11-26;142;165;2500;331170;326619;49469;88.3;87.1;13.2
73;2021-11-27;104;110;1057;331274;326729;50526;88.3;87.1;13.5
73;2021-11-28;5;26;50;331279;326755;50576;88.3;87.1;13.5
73;2021-11-29;71;99;2677;331350;326854;53253;88.4;87.2;14.2
73;2021-11-30;134;165;3871;331484;327019;57124;88.4;87.2;15.2
73;2021-12-01;107;142;3279;331591;327161;60403;88.4;87.2;16.1
73;2021-12-02;106;107;3941;331697;327268;64344;88.4;87.3;17.2
73;2021-12-03;90;146;4083;331787;327414;68427;88.5;87.3;18.2
73;2021-12-04;73;90;2005;331860;327504;70432;88.5;87.3;18.8
73;2021-12-05;17;23;762;331877;327527;71194;88.5;87.3;19.0
73;2021-12-06;93;133;3455;331970;327660;74649;88.5;87.4;19.9
73;2021-12-07;86;108;4023;332056;327768;78672;88.5;87.4;21.0
73;2021-12-08;118;152;4051;332174;327920;82723;88.6;87.4;22.1
73;2021-12-09;90;136;4804;332264;328056;87527;88.6;87.5;23.3
73;2021-12-10;102;141;4905;332366;328197;92432;88.6;87.5;24.6
73;2021-12-11;81;121;2624;332447;328318;95056;88.6;87.5;25.3
73;2021-12-12;12;13;1283;332459;328331;96339;88.6;87.5;25.7
73;2021-12-13;79;99;4571;332538;328430;100910;88.7;87.6;26.9
73;2021-12-14;104;151;5471;332642;328581;106381;88.7;87.6;28.4
73;2021-12-15;120;181;5125;332762;328762;111506;88.7;87.7;29.7
73;2021-12-16;116;125;6161;332878;328887;117667;88.8;87.7;31.4
73;2021-12-17;129;174;6058;333007;329061;123725;88.8;87.7;33.0
73;2021-12-18;71;120;2271;333078;329181;125996;88.8;87.8;33.6
73;2021-12-19;25;25;926;333103;329206;126922;88.8;87.8;33.8
74;2020-12-27;2;0;0;2;0;0;0.0;0.0;0.0
74;2020-12-28;2;1;0;4;1;0;0.0;0.0;0.0
74;2020-12-29;0;0;0;4;1;0;0.0;0.0;0.0
74;2020-12-30;0;0;0;4;1;0;0.0;0.0;0.0
74;2020-12-31;0;0;0;4;1;0;0.0;0.0;0.0
74;2021-01-01;0;0;0;4;1;0;0.0;0.0;0.0
74;2021-01-02;1;1;0;5;2;0;0.0;0.0;0.0
74;2021-01-03;1;0;0;6;2;0;0.0;0.0;0.0
74;2021-01-04;1;0;0;7;2;0;0.0;0.0;0.0
74;2021-01-05;3;0;0;10;2;0;0.0;0.0;0.0
74;2021-01-06;46;0;0;56;2;0;0.0;0.0;0.0
74;2021-01-07;220;1;0;276;3;0;0.0;0.0;0.0
74;2021-01-08;288;2;0;564;5;0;0.1;0.0;0.0
74;2021-01-09;79;0;0;643;5;0;0.1;0.0;0.0
74;2021-01-10;74;0;0;717;5;0;0.1;0.0;0.0
74;2021-01-11;373;1;0;1090;6;0;0.2;0.0;0.0
74;2021-01-12;409;3;0;1499;9;0;0.2;0.0;0.0
74;2021-01-13;402;0;0;1901;9;0;0.3;0.0;0.0
74;2021-01-14;467;2;0;2368;11;0;0.3;0.0;0.0
74;2021-01-15;629;4;0;2997;15;0;0.4;0.0;0.0
74;2021-01-16;241;1;0;3238;16;0;0.5;0.0;0.0
74;2021-01-17;113;1;0;3351;17;0;0.5;0.0;0.0
74;2021-01-18;513;0;0;3864;17;0;0.6;0.0;0.0
74;2021-01-19;792;3;0;4656;20;0;0.7;0.0;0.0
74;2021-01-20;1282;3;0;5938;23;0;0.8;0.0;0.0
74;2021-01-21;1496;4;0;7434;27;0;1.1;0.0;0.0
74;2021-01-22;1181;6;0;8615;33;0;1.2;0.0;0.0
74;2021-01-23;317;1;0;8932;34;0;1.3;0.0;0.0
74;2021-01-24;81;1;0;9013;35;0;1.3;0.0;0.0
74;2021-01-25;774;3;0;9787;38;0;1.4;0.0;0.0
74;2021-01-26;1301;25;0;11088;63;0;1.6;0.0;0.0
74;2021-01-27;1058;16;0;12146;79;0;1.7;0.0;0.0
74;2021-01-28;993;48;0;13139;127;0;1.9;0.0;0.0
74;2021-01-29;826;47;0;13965;174;0;2.0;0.0;0.0
74;2021-01-30;331;2;0;14296;176;0;2.0;0.0;0.0
74;2021-01-31;89;2;0;14385;178;0;2.0;0.0;0.0
74;2021-02-01;580;46;0;14965;224;0;2.1;0.0;0.0
74;2021-02-02;609;160;0;15574;384;0;2.2;0.1;0.0
74;2021-02-03;586;138;0;16160;522;0;2.3;0.1;0.0
74;2021-02-04;588;139;0;16748;661;0;2.4;0.1;0.0
74;2021-02-05;524;230;0;17272;891;0;2.5;0.1;0.0
74;2021-02-06;288;132;0;17560;1023;0;2.5;0.1;0.0
74;2021-02-07;85;122;0;17645;1145;0;2.5;0.2;0.0
74;2021-02-08;587;338;0;18232;1483;0;2.6;0.2;0.0
74;2021-02-09;530;514;0;18762;1997;0;2.7;0.3;0.0
74;2021-02-10;749;556;0;19511;2553;0;2.8;0.4;0.0
74;2021-02-11;1025;1007;0;20536;3560;0;2.9;0.5;0.0
74;2021-02-12;882;607;0;21418;4167;0;3.1;0.6;0.0
74;2021-02-13;380;228;0;21798;4395;0;3.1;0.6;0.0
74;2021-02-14;286;99;0;22084;4494;0;3.1;0.6;0.0
74;2021-02-15;274;813;0;22358;5307;0;3.2;0.8;0.0
74;2021-02-16;466;1018;0;22824;6325;0;3.3;0.9;0.0
74;2021-02-17;524;1096;0;23348;7421;0;3.3;1.1;0.0
74;2021-02-18;482;957;0;23830;8378;0;3.4;1.2;0.0
74;2021-02-19;616;646;0;24446;9024;0;3.5;1.3;0.0
74;2021-02-20;118;188;0;24564;9212;0;3.5;1.3;0.0
74;2021-02-21;45;58;0;24609;9270;0;3.5;1.3;0.0
74;2021-02-22;299;803;0;24908;10073;0;3.5;1.4;0.0
74;2021-02-23;304;809;0;25212;10882;0;3.6;1.6;0.0
74;2021-02-24;265;719;0;25477;11601;0;3.6;1.7;0.0
74;2021-02-25;518;733;0;25995;12334;0;3.7;1.8;0.0
74;2021-02-26;930;682;0;26925;13016;0;3.8;1.9;0.0
74;2021-02-27;277;242;0;27202;13258;0;3.9;1.9;0.0
74;2021-02-28;117;68;0;27319;13326;0;3.9;1.9;0.0
74;2021-03-01;723;589;0;28042;13915;0;4.0;2.0;0.0
74;2021-03-02;1064;653;0;29106;14568;0;4.1;2.1;0.0
74;2021-03-03;1024;676;0;30130;15244;0;4.3;2.2;0.0
74;2021-03-04;1564;985;0;31694;16229;0;4.5;2.3;0.0
74;2021-03-05;2027;880;0;33721;17109;0;4.8;2.4;0.0
74;2021-03-06;1738;337;0;35459;17446;0;5.1;2.5;0.0
74;2021-03-07;1343;106;0;36802;17552;0;5.2;2.5;0.0
74;2021-03-08;1163;904;0;37965;18456;0;5.4;2.6;0.0
74;2021-03-09;1893;658;0;39858;19114;0;5.7;2.7;0.0
74;2021-03-10;1724;893;0;41582;20007;0;5.9;2.9;0.0
74;2021-03-11;2411;711;0;43993;20718;0;6.3;3.0;0.0
74;2021-03-12;3158;992;0;47151;21710;0;6.7;3.1;0.0
74;2021-03-13;1925;270;0;49076;21980;0;7.0;3.1;0.0
74;2021-03-14;576;98;0;49652;22078;0;7.1;3.1;0.0
74;2021-03-15;2087;556;0;51739;22634;0;7.4;3.2;0.0
74;2021-03-16;1920;425;0;53659;23059;0;7.6;3.3;0.0
74;2021-03-17;1924;337;0;55583;23396;0;7.9;3.3;0.0
74;2021-03-18;2091;298;0;57674;23694;0;8.2;3.4;0.0
74;2021-03-19;2573;319;0;60247;24013;0;8.6;3.4;0.0
74;2021-03-20;1330;102;0;61577;24115;0;8.8;3.4;0.0
74;2021-03-21;268;33;0;61845;24148;0;8.8;3.4;0.0
74;2021-03-22;1995;321;0;63840;24469;0;9.1;3.5;0.0
74;2021-03-23;2657;345;0;66497;24814;0;9.5;3.5;0.0
74;2021-03-24;2857;341;0;69354;25155;0;9.9;3.6;0.0
74;2021-03-25;3736;321;0;73090;25476;0;10.4;3.6;0.0
74;2021-03-26;3998;419;0;77088;25895;0;11.0;3.7;0.0
74;2021-03-27;1853;268;0;78941;26163;0;11.2;3.7;0.0
74;2021-03-28;429;73;0;79370;26236;0;11.3;3.7;0.0
74;2021-03-29;2868;709;0;82238;26945;0;11.7;3.8;0.0
74;2021-03-30;3417;777;0;85655;27722;0;12.2;4.0;0.0
74;2021-03-31;3055;735;0;88710;28457;0;12.6;4.1;0.0
74;2021-04-01;4001;882;0;92711;29339;0;13.2;4.2;0.0
74;2021-04-02;3516;784;0;96227;30123;0;13.7;4.3;0.0
74;2021-04-03;1574;522;0;97801;30645;0;13.9;4.4;0.0
74;2021-04-04;231;117;0;98032;30762;0;14.0;4.4;0.0
74;2021-04-05;447;18;0;98479;30780;0;14.0;4.4;0.0
74;2021-04-06;2526;1201;0;101005;31981;0;14.4;4.6;0.0
74;2021-04-07;2989;1246;0;103994;33227;0;14.8;4.7;0.0
74;2021-04-08;3694;1209;0;107688;34436;0;15.3;4.9;0.0
74;2021-04-09;3939;1185;0;111627;35621;0;15.9;5.1;0.0
74;2021-04-10;1815;955;0;113442;36576;0;16.2;5.2;0.0
74;2021-04-11;240;171;0;113682;36747;0;16.2;5.2;0.0
74;2021-04-12;2632;1759;0;116314;38506;0;16.6;5.5;0.0
74;2021-04-13;3033;2125;0;119347;40631;0;17.0;5.8;0.0
74;2021-04-14;2828;1956;0;122175;42587;0;17.4;6.1;0.0
74;2021-04-15;3325;1880;0;125500;44467;0;17.9;6.3;0.0
74;2021-04-16;3225;1728;0;128725;46195;0;18.3;6.6;0.0
74;2021-04-17;1827;1016;0;130552;47211;0;18.6;6.7;0.0
74;2021-04-18;203;196;0;130755;47407;0;18.6;6.8;0.0
74;2021-04-19;2052;2035;0;132807;49442;0;18.9;7.0;0.0
74;2021-04-20;2966;2381;0;135773;51823;0;19.3;7.4;0.0
74;2021-04-21;2385;2326;0;138158;54149;0;19.7;7.7;0.0
74;2021-04-22;2484;2303;0;140642;56452;0;20.0;8.0;0.0
74;2021-04-23;2509;2200;0;143151;58652;0;20.4;8.4;0.0
74;2021-04-24;1402;1493;0;144553;60145;0;20.6;8.6;0.0
74;2021-04-25;230;147;0;144783;60292;0;20.6;8.6;0.0
74;2021-04-26;2255;2376;0;147038;62668;0;21.0;8.9;0.0
74;2021-04-27;3082;2798;0;150120;65466;0;21.4;9.3;0.0
74;2021-04-28;3319;2556;0;153439;68022;0;21.9;9.7;0.0
74;2021-04-29;3708;2622;0;157147;70644;0;22.4;10.1;0.0
74;2021-04-30;3902;2173;0;161049;72817;0;22.9;10.4;0.0
74;2021-05-01;1999;386;0;163048;73203;0;23.2;10.4;0.0
74;2021-05-02;202;221;0;163250;73424;0;23.3;10.5;0.0
74;2021-05-03;2497;2901;0;165747;76325;0;23.6;10.9;0.0
74;2021-05-04;3042;2931;0;168789;79256;0;24.1;11.3;0.0
74;2021-05-05;3159;2865;0;171948;82121;0;24.5;11.7;0.0
74;2021-05-06;3664;2583;0;175612;84704;0;25.0;12.1;0.0
74;2021-05-07;3455;3470;0;179067;88174;0;25.5;12.6;0.0
74;2021-05-08;1164;795;0;180231;88969;0;25.7;12.7;0.0
74;2021-05-09;236;246;0;180467;89215;0;25.7;12.7;0.0
74;2021-05-10;3263;3029;0;183730;92244;0;26.2;13.1;0.0
74;2021-05-11;4105;3303;0;187835;95547;0;26.8;13.6;0.0
74;2021-05-12;4860;2867;0;192695;98414;0;27.5;14.0;0.0
74;2021-05-13;2235;921;0;194930;99335;0;27.8;14.2;0.0
74;2021-05-14;5254;2271;0;200184;101606;0;28.5;14.5;0.0
74;2021-05-15;4044;1737;0;204228;103343;0;29.1;14.7;0.0
74;2021-05-16;2321;308;0;206549;103651;0;29.4;14.8;0.0
74;2021-05-17;4860;2773;0;211409;106424;0;30.1;15.2;0.0
74;2021-05-18;6118;2689;0;217527;109113;0;31.0;15.5;0.0
74;2021-05-19;5633;2232;0;223160;111345;0;31.8;15.9;0.0
74;2021-05-20;5945;2411;0;229105;113756;0;32.6;16.2;0.0
74;2021-05-21;5904;2872;0;235009;116628;0;33.5;16.6;0.0
74;2021-05-22;4614;1465;0;239623;118093;0;34.1;16.8;0.0
74;2021-05-23;1686;261;0;241309;118354;0;34.4;16.9;0.0
74;2021-05-24;2307;643;0;243616;118997;0;34.7;17.0;0.0
74;2021-05-25;4689;3182;0;248305;122179;0;35.4;17.4;0.0
74;2021-05-26;4820;2477;0;253125;124656;0;36.1;17.8;0.0
74;2021-05-27;5463;2857;0;258588;127513;0;36.8;18.2;0.0
74;2021-05-28;5091;3483;0;263679;130996;0;37.6;18.7;0.0
74;2021-05-29;3431;2034;0;267110;133030;0;38.1;19.0;0.0
74;2021-05-30;518;301;0;267628;133331;0;38.1;19.0;0.0
74;2021-05-31;4537;3428;0;272165;136759;0;38.8;19.5;0.0
74;2021-06-01;4585;3600;0;276750;140359;0;39.4;20.0;0.0
74;2021-06-02;4806;3060;0;281556;143419;0;40.1;20.4;0.0
74;2021-06-03;6255;3101;0;287811;146520;0;41.0;20.9;0.0
74;2021-06-04;6365;4227;0;294176;150747;0;41.9;21.5;0.0
74;2021-06-05;4008;2539;0;298184;153286;0;42.5;21.8;0.0
74;2021-06-06;217;133;0;298401;153419;0;42.5;21.9;0.0
74;2021-06-07;4575;3936;0;302976;157355;0;43.2;22.4;0.0
74;2021-06-08;4570;3739;0;307546;161094;0;43.8;23.0;0.0
74;2021-06-09;4562;3304;0;312108;164398;0;44.5;23.4;0.0
74;2021-06-10;4651;2733;0;316759;167131;0;45.1;23.8;0.0
74;2021-06-11;4690;3574;0;321449;170705;0;45.8;24.3;0.0
74;2021-06-12;3156;2240;0;324605;172945;0;46.3;24.6;0.0
74;2021-06-13;189;104;0;324794;173049;0;46.3;24.7;0.0
74;2021-06-14;3219;4178;0;328013;177227;0;46.7;25.3;0.0
74;2021-06-15;3281;3676;0;331294;180903;0;47.2;25.8;0.0
74;2021-06-16;4253;2942;0;335547;183845;0;47.8;26.2;0.0
74;2021-06-17;3375;2777;0;338922;186622;0;48.3;26.6;0.0
74;2021-06-18;3795;4406;0;342717;191028;0;48.8;27.2;0.0
74;2021-06-19;2572;2776;0;345289;193804;0;49.2;27.6;0.0
74;2021-06-20;147;132;0;345436;193936;0;49.2;27.6;0.0
74;2021-06-21;2174;5011;0;347610;198947;0;49.5;28.3;0.0
74;2021-06-22;2291;4933;0;349901;203880;0;49.9;29.1;0.0
74;2021-06-23;2755;4355;0;352656;208235;0;50.3;29.7;0.0
74;2021-06-24;2622;4124;0;355278;212359;0;50.6;30.3;0.0
74;2021-06-25;2668;6204;0;357946;218563;0;51.0;31.1;0.0
74;2021-06-26;1485;4805;0;359431;223368;0;51.2;31.8;0.0
74;2021-06-27;84;1366;0;359515;224734;0;51.2;32.0;0.0
74;2021-06-28;1725;6543;0;361240;231277;0;51.5;33.0;0.0
74;2021-06-29;2042;6679;0;363282;237956;0;51.8;33.9;0.0
74;2021-06-30;2531;6011;0;365813;243967;0;52.1;34.8;0.0
74;2021-07-01;3039;4855;0;368852;248822;0;52.6;35.5;0.0
74;2021-07-02;2936;6069;0;371788;254891;0;53.0;36.3;0.0
74;2021-07-03;1460;4560;0;373248;259451;0;53.2;37.0;0.0
74;2021-07-04;113;894;0;373361;260345;0;53.2;37.1;0.0
74;2021-07-05;1910;6263;0;375271;266608;0;53.5;38.0;0.0
74;2021-07-06;2381;5911;0;377652;272519;0;53.8;38.8;0.0
74;2021-07-07;2718;4974;0;380370;277493;0;54.2;39.5;0.0
74;2021-07-08;3415;4461;0;383785;281954;0;54.7;40.2;0.0
74;2021-07-09;2540;6354;0;386325;288308;0;55.0;41.1;0.0
74;2021-07-10;1481;4577;0;387806;292885;0;55.3;41.7;0.0
74;2021-07-11;117;225;0;387923;293110;0;55.3;41.8;0.0
74;2021-07-12;1988;7109;0;389911;300219;0;55.6;42.8;0.0
74;2021-07-13;3655;6836;0;393566;307055;0;56.1;43.8;0.0
74;2021-07-14;2005;2132;0;395571;309187;0;56.4;44.1;0.0
74;2021-07-15;3549;6307;0;399120;315494;0;56.9;45.0;0.0
74;2021-07-16;4010;7108;0;403130;322602;0;57.4;46.0;0.0
74;2021-07-17;2702;4793;0;405832;327395;0;57.8;46.7;0.0
74;2021-07-18;278;273;0;406110;327668;0;57.9;46.7;0.0
74;2021-07-19;3985;6610;0;410095;334278;0;58.4;47.6;0.0
74;2021-07-20;5359;5923;0;415454;340201;0;59.2;48.5;0.0
74;2021-07-21;5187;6017;0;420641;346218;0;59.9;49.3;0.0
74;2021-07-22;4458;4817;0;425099;351035;0;60.6;50.0;0.0
74;2021-07-23;5739;6417;0;430838;357452;0;61.4;50.9;0.0
74;2021-07-24;2964;3903;0;433802;361355;0;61.8;51.5;0.0
74;2021-07-25;250;223;0;434052;361578;0;61.9;51.5;0.0
74;2021-07-26;5012;5560;0;439064;367138;0;62.6;52.3;0.0
74;2021-07-27;6096;4644;0;445160;371782;0;63.4;53.0;0.0
74;2021-07-28;6058;4616;0;451218;376398;0;64.3;53.6;0.0
74;2021-07-29;4815;3614;0;456033;380012;0;65.0;54.1;0.0
74;2021-07-30;6187;4997;0;462220;385009;0;65.9;54.9;0.0
74;2021-07-31;4059;2898;0;466279;387907;0;66.4;55.3;0.0
74;2021-08-01;294;201;0;466573;388108;0;66.5;55.3;0.0
74;2021-08-02;5721;3993;0;472294;392101;0;67.3;55.9;0.0
74;2021-08-03;5321;3487;0;477615;395588;0;68.1;56.4;0.0
74;2021-08-04;5626;3159;0;483241;398747;0;68.9;56.8;0.0
74;2021-08-05;4490;3078;0;487731;401825;0;69.5;57.3;0.0
74;2021-08-06;4559;3857;0;492290;405682;0;70.1;57.8;0.0
74;2021-08-07;2941;2636;0;495231;408318;0;70.6;58.2;0.0
74;2021-08-08;200;208;0;495431;408526;0;70.6;58.2;0.0
74;2021-08-09;4297;4230;0;499728;412756;0;71.2;58.8;0.0
74;2021-08-10;4302;4219;0;504030;416975;0;71.8;59.4;0.0
74;2021-08-11;3863;4273;0;507893;421248;0;72.4;60.0;0.0
74;2021-08-12;3163;3368;0;511056;424616;0;72.8;60.5;0.0
74;2021-08-13;3254;4134;0;514310;428750;0;73.3;61.1;0.0
74;2021-08-14;2030;3046;0;516340;431796;0;73.6;61.5;0.0
74;2021-08-15;97;161;0;516437;431957;0;73.6;61.6;0.0
74;2021-08-16;2917;5264;0;519354;437221;0;74.0;62.3;0.0
74;2021-08-17;2680;4910;0;522034;442131;0;74.4;63.0;0.0
74;2021-08-18;2621;4800;0;524655;446931;0;74.8;63.7;0.0
74;2021-08-19;2117;3614;0;526772;450545;0;75.1;64.2;0.0
74;2021-08-20;2342;5084;0;529114;455629;0;75.4;64.9;0.0
74;2021-08-21;1066;3742;0;530180;459371;0;75.5;65.5;0.0
74;2021-08-22;60;191;0;530240;459562;0;75.6;65.5;0.0
74;2021-08-23;1798;5780;0;532038;465342;0;75.8;66.3;0.0
74;2021-08-24;1895;5095;0;533933;470437;0;76.1;67.0;0.0
74;2021-08-25;1749;5374;0;535682;475811;0;76.3;67.8;0.0
74;2021-08-26;1421;3505;0;537103;479316;0;76.5;68.3;0.0
74;2021-08-27;1686;4989;0;538789;484305;0;76.8;69.0;0.0
74;2021-08-28;878;3610;0;539667;487915;0;76.9;69.5;0.0
74;2021-08-29;78;238;0;539745;488153;0;76.9;69.6;0.0
74;2021-08-30;1613;4950;114;541358;493103;114;77.1;70.3;0.0
74;2021-08-31;1498;4470;146;542856;497573;260;77.4;70.9;0.0
74;2021-09-01;1852;3643;257;544708;501216;517;77.6;71.4;0.1
74;2021-09-02;1158;2640;198;545866;503856;715;77.8;71.8;0.1
74;2021-09-03;1454;3502;331;547320;507358;1046;78.0;72.3;0.1
74;2021-09-04;1128;2521;87;548448;509879;1133;78.2;72.7;0.2
74;2021-09-05;53;136;2;548501;510015;1135;78.2;72.7;0.2
74;2021-09-06;1155;2662;342;549656;512677;1477;78.3;73.1;0.2
74;2021-09-07;952;2326;294;550608;515003;1771;78.5;73.4;0.3
74;2021-09-08;1248;2611;301;551856;517614;2072;78.6;73.8;0.3
74;2021-09-09;1133;1845;314;552989;519459;2386;78.8;74.0;0.3
74;2021-09-10;1099;2543;358;554088;522002;2744;79.0;74.4;0.4
74;2021-09-11;707;2028;114;554795;524030;2858;79.1;74.7;0.4
74;2021-09-12;49;93;8;554844;524123;2866;79.1;74.7;0.4
74;2021-09-13;916;1871;610;555760;525994;3476;79.2;75.0;0.5
74;2021-09-14;990;1663;667;556750;527657;4143;79.3;75.2;0.6
74;2021-09-15;1029;2101;485;557779;529758;4628;79.5;75.5;0.7
74;2021-09-16;733;1015;360;558512;530773;4988;79.6;75.6;0.7
74;2021-09-17;807;1652;474;559319;532425;5462;79.7;75.9;0.8
74;2021-09-18;542;1448;121;559861;533873;5583;79.8;76.1;0.8
74;2021-09-19;11;54;21;559872;533927;5604;79.8;76.1;0.8
74;2021-09-20;724;1541;569;560596;535468;6173;79.9;76.3;0.9
74;2021-09-21;578;1138;459;561174;536606;6632;80.0;76.5;0.9
74;2021-09-22;577;1751;439;561751;538357;7071;80.0;76.7;1.0
74;2021-09-23;598;924;418;562349;539281;7489;80.1;76.8;1.1
74;2021-09-24;654;1627;452;563003;540908;7941;80.2;77.1;1.1
74;2021-09-25;424;1374;130;563427;542282;8071;80.3;77.3;1.2
74;2021-09-26;9;26;0;563436;542308;8071;80.3;77.3;1.2
74;2021-09-27;518;1168;479;563954;543476;8550;80.4;77.4;1.2
74;2021-09-28;370;821;575;564324;544297;9125;80.4;77.6;1.3
74;2021-09-29;507;1331;462;564831;545628;9587;80.5;77.7;1.4
74;2021-09-30;388;1021;432;565219;546649;10019;80.5;77.9;1.4
74;2021-10-01;726;1091;406;565945;547740;10425;80.6;78.1;1.5
74;2021-10-02;419;718;113;566364;548458;10538;80.7;78.2;1.5
74;2021-10-03;9;25;5;566373;548483;10543;80.7;78.2;1.5
74;2021-10-04;576;957;620;566949;549440;11163;80.8;78.3;1.6
74;2021-10-05;355;805;582;567304;550245;11745;80.8;78.4;1.7
74;2021-10-06;426;983;455;567730;551228;12200;80.9;78.5;1.7
74;2021-10-07;270;645;439;568000;551873;12639;80.9;78.6;1.8
74;2021-10-08;612;1124;708;568612;552997;13347;81.0;78.8;1.9
74;2021-10-09;393;729;184;569005;553726;13531;81.1;78.9;1.9
74;2021-10-10;6;25;3;569011;553751;13534;81.1;78.9;1.9
74;2021-10-11;376;805;801;569387;554556;14335;81.1;79.0;2.0
74;2021-10-12;358;652;919;569745;555208;15254;81.2;79.1;2.2
74;2021-10-13;403;790;668;570148;555998;15922;81.2;79.2;2.3
74;2021-10-14;301;541;571;570449;556539;16493;81.3;79.3;2.4
74;2021-10-15;553;903;997;571002;557442;17490;81.4;79.4;2.5
74;2021-10-16;278;534;283;571280;557976;17773;81.4;79.5;2.5
74;2021-10-17;6;28;3;571286;558004;17776;81.4;79.5;2.5
74;2021-10-18;361;645;741;571647;558649;18517;81.5;79.6;2.6
74;2021-10-19;168;516;1084;571815;559165;19601;81.5;79.7;2.8
74;2021-10-20;235;585;1074;572050;559750;20675;81.5;79.8;2.9
74;2021-10-21;105;281;596;572155;560031;21271;81.5;79.8;3.0
74;2021-10-22;264;631;1183;572419;560662;22454;81.6;79.9;3.2
74;2021-10-23;144;372;279;572563;561034;22733;81.6;79.9;3.2
74;2021-10-24;7;19;3;572570;561053;22736;81.6;79.9;3.2
74;2021-10-25;192;418;1060;572762;561471;23796;81.6;80.0;3.4
74;2021-10-26;184;369;1535;572946;561840;25331;81.6;80.1;3.6
74;2021-10-27;212;476;1324;573158;562316;26655;81.7;80.1;3.8
74;2021-10-28;86;221;701;573244;562537;27356;81.7;80.2;3.9
74;2021-10-29;211;507;1415;573455;563044;28771;81.7;80.2;4.1
74;2021-10-30;103;323;504;573558;563367;29275;81.7;80.3;4.2
74;2021-10-31;2;7;0;573560;563374;29275;81.7;80.3;4.2
74;2021-11-01;46;49;37;573606;563423;29312;81.7;80.3;4.2
74;2021-11-02;203;443;1358;573809;563866;30670;81.8;80.3;4.4
74;2021-11-03;176;370;1510;573985;564236;32180;81.8;80.4;4.6
74;2021-11-04;94;247;955;574079;564483;33135;81.8;80.4;4.7
74;2021-11-05;219;419;1763;574298;564902;34898;81.8;80.5;5.0
74;2021-11-06;101;252;513;574399;565154;35411;81.8;80.5;5.0
74;2021-11-07;3;21;3;574402;565175;35414;81.8;80.5;5.0
74;2021-11-08;135;402;1971;574537;565577;37385;81.9;80.6;5.3
74;2021-11-09;153;252;2075;574690;565829;39460;81.9;80.6;5.6
74;2021-11-10;228;382;2490;574918;566211;41950;81.9;80.7;6.0
74;2021-11-11;5;31;20;574923;566242;41970;81.9;80.7;6.0
74;2021-11-12;185;333;2137;575108;566575;44107;82.0;80.7;6.3
74;2021-11-13;142;173;752;575250;566748;44859;82.0;80.8;6.4
74;2021-11-14;3;13;16;575253;566761;44875;82.0;80.8;6.4
74;2021-11-15;118;236;2192;575371;566997;47067;82.0;80.8;6.7
74;2021-11-16;143;206;2654;575514;567203;49721;82.0;80.8;7.1
74;2021-11-17;244;350;2629;575758;567553;52350;82.0;80.9;7.5
74;2021-11-18;93;148;1689;575851;567701;54039;82.1;80.9;7.7
74;2021-11-19;209;314;3114;576060;568015;57153;82.1;80.9;8.1
74;2021-11-20;222;193;970;576282;568208;58123;82.1;81.0;8.3
74;2021-11-21;14;16;33;576296;568224;58156;82.1;81.0;8.3
74;2021-11-22;169;167;2490;576465;568391;60646;82.1;81.0;8.6
74;2021-11-23;193;202;2686;576658;568593;63332;82.2;81.0;9.0
74;2021-11-24;247;299;2617;576905;568892;65949;82.2;81.1;9.4
74;2021-11-25;138;141;2176;577043;569033;68125;82.2;81.1;9.7
74;2021-11-26;249;327;4294;577292;569360;72419;82.3;81.1;10.3
74;2021-11-27;172;219;1920;577464;569579;74339;82.3;81.2;10.6
74;2021-11-28;5;16;84;577469;569595;74423;82.3;81.2;10.6
74;2021-11-29;130;185;3644;577599;569780;78067;82.3;81.2;11.1
74;2021-11-30;168;262;4802;577767;570042;82869;82.3;81.2;11.8
74;2021-12-01;185;254;4817;577952;570296;87686;82.4;81.3;12.5
74;2021-12-02;151;154;4675;578103;570450;92361;82.4;81.3;13.2
74;2021-12-03;189;248;6076;578292;570698;98437;82.4;81.3;14.0
74;2021-12-04;120;194;2792;578412;570892;101229;82.4;81.3;14.4
74;2021-12-05;5;21;265;578417;570913;101494;82.4;81.4;14.5
74;2021-12-06;187;205;5569;578604;571118;107063;82.4;81.4;15.3
74;2021-12-07;188;242;6975;578792;571360;114038;82.5;81.4;16.2
74;2021-12-08;201;294;5783;578993;571654;119821;82.5;81.5;17.1
74;2021-12-09;171;213;6739;579164;571867;126560;82.5;81.5;18.0
74;2021-12-10;151;250;6156;579315;572117;132716;82.5;81.5;18.9
74;2021-12-11;121;228;3836;579436;572345;136552;82.6;81.6;19.5
74;2021-12-12;13;38;370;579449;572383;136922;82.6;81.6;19.5
74;2021-12-13;143;241;6963;579592;572624;143885;82.6;81.6;20.5
74;2021-12-14;232;291;9017;579824;572915;152902;82.6;81.6;21.8
74;2021-12-15;235;361;7810;580059;573276;160712;82.7;81.7;22.9
74;2021-12-16;207;266;8116;580266;573542;168828;82.7;81.7;24.1
74;2021-12-17;195;365;8135;580461;573907;176963;82.7;81.8;25.2
74;2021-12-18;146;233;4601;580607;574140;181564;82.7;81.8;25.9
74;2021-12-19;16;37;660;580623;574177;182224;82.7;81.8;26.0
75;2020-12-27;28;0;0;28;0;0;0.0;0.0;0.0
75;2020-12-28;27;0;0;55;0;0;0.0;0.0;0.0
75;2020-12-29;21;1;0;76;1;0;0.0;0.0;0.0
75;2020-12-30;67;0;0;143;1;0;0.0;0.0;0.0
75;2020-12-31;45;0;0;188;1;0;0.0;0.0;0.0
75;2021-01-01;43;2;0;231;3;0;0.0;0.0;0.0
75;2021-01-02;40;1;0;271;4;0;0.0;0.0;0.0
75;2021-01-03;71;3;0;342;7;0;0.0;0.0;0.0
75;2021-01-04;231;4;0;573;11;0;0.0;0.0;0.0
75;2021-01-05;656;7;0;1229;18;0;0.1;0.0;0.0
75;2021-01-06;995;3;0;2224;21;0;0.1;0.0;0.0
75;2021-01-07;1482;10;0;3706;31;0;0.2;0.0;0.0
75;2021-01-08;2218;19;0;5924;50;0;0.3;0.0;0.0
75;2021-01-09;788;5;0;6712;55;0;0.4;0.0;0.0
75;2021-01-10;783;2;0;7495;57;0;0.4;0.0;0.0
75;2021-01-11;2183;31;0;9678;88;0;0.5;0.0;0.0
75;2021-01-12;2546;48;0;12224;136;0;0.6;0.0;0.0
75;2021-01-13;2705;43;0;14929;179;0;0.8;0.0;0.0
75;2021-01-14;2765;50;0;17694;229;0;0.9;0.0;0.0
75;2021-01-15;2492;34;0;20186;263;0;1.1;0.0;0.0
75;2021-01-16;890;16;0;21076;279;0;1.1;0.0;0.0
75;2021-01-17;505;10;0;21581;289;0;1.1;0.0;0.0
75;2021-01-18;3050;52;0;24631;341;0;1.3;0.0;0.0
75;2021-01-19;3995;54;0;28626;395;0;1.5;0.0;0.0
75;2021-01-20;4431;49;0;33057;444;0;1.7;0.0;0.0
75;2021-01-21;5220;62;0;38277;506;0;2.0;0.0;0.0
75;2021-01-22;4428;69;0;42705;575;0;2.2;0.0;0.0
75;2021-01-23;1684;12;0;44389;587;0;2.3;0.0;0.0
75;2021-01-24;604;5;0;44993;592;0;2.4;0.0;0.0
75;2021-01-25;1879;25;0;46872;617;0;2.5;0.0;0.0
75;2021-01-26;2752;77;0;49624;694;0;2.6;0.0;0.0
75;2021-01-27;3613;184;0;53237;878;0;2.8;0.0;0.0
75;2021-01-28;4932;278;0;58169;1156;0;3.0;0.1;0.0
75;2021-01-29;3776;290;0;61945;1446;0;3.2;0.1;0.0
75;2021-01-30;1328;49;0;63273;1495;0;3.3;0.1;0.0
75;2021-01-31;197;7;0;63470;1502;0;3.3;0.1;0.0
75;2021-02-01;1782;386;0;65252;1888;0;3.4;0.1;0.0
75;2021-02-02;2212;603;0;67464;2491;0;3.5;0.1;0.0
75;2021-02-03;2110;729;0;69574;3220;0;3.6;0.2;0.0
75;2021-02-04;2329;1022;0;71903;4242;0;3.8;0.2;0.0
75;2021-02-05;2279;858;0;74182;5100;0;3.9;0.3;0.0
75;2021-02-06;1087;154;0;75269;5254;0;3.9;0.3;0.0
75;2021-02-07;176;66;0;75445;5320;0;3.9;0.3;0.0
75;2021-02-08;1347;1281;0;76792;6601;0;4.0;0.3;0.0
75;2021-02-09;1944;1923;0;78736;8524;0;4.1;0.4;0.0
75;2021-02-10;2380;2227;0;81116;10751;0;4.2;0.6;0.0
75;2021-02-11;2797;5019;0;83913;15770;0;4.4;0.8;0.0
75;2021-02-12;3043;2263;0;86956;18033;0;4.5;0.9;0.0
75;2021-02-13;797;896;0;87753;18929;0;4.6;1.0;0.0
75;2021-02-14;144;110;0;87897;19039;0;4.6;1.0;0.0
75;2021-02-15;994;2668;0;88891;21707;0;4.7;1.1;0.0
75;2021-02-16;1281;5722;0;90172;27429;0;4.7;1.4;0.0
75;2021-02-17;1197;3637;0;91369;31066;0;4.8;1.6;0.0
75;2021-02-18;1693;5692;0;93062;36758;0;4.9;1.9;0.0
75;2021-02-19;1988;3919;0;95050;40677;0;5.0;2.1;0.0
75;2021-02-20;463;1440;0;95513;42117;0;5.0;2.2;0.0
75;2021-02-21;167;193;0;95680;42310;0;5.0;2.2;0.0
75;2021-02-22;1051;2335;0;96731;44645;0;5.1;2.3;0.0
75;2021-02-23;1267;2781;0;97998;47426;0;5.1;2.5;0.0
75;2021-02-24;1450;2523;0;99448;49949;0;5.2;2.6;0.0
75;2021-02-25;2283;4366;0;101731;54315;0;5.3;2.8;0.0
75;2021-02-26;2776;2512;0;104507;56827;0;5.5;3.0;0.0
75;2021-02-27;1269;930;0;105776;57757;0;5.5;3.0;0.0
75;2021-02-28;301;171;0;106077;57928;0;5.5;3.0;0.0
75;2021-03-01;2204;1895;0;108281;59823;0;5.7;3.1;0.0
75;2021-03-02;3567;2460;0;111848;62283;0;5.9;3.3;0.0
75;2021-03-03;4577;2553;0;116425;64836;0;6.1;3.4;0.0
75;2021-03-04;6481;2700;0;122906;67536;0;6.4;3.5;0.0
75;2021-03-05;8276;2761;0;131182;70297;0;6.9;3.7;0.0
75;2021-03-06;9939;1126;0;141121;71423;0;7.4;3.7;0.0
75;2021-03-07;8340;1016;0;149461;72439;0;7.8;3.8;0.0
75;2021-03-08;4616;1778;0;154077;74217;0;8.1;3.9;0.0
75;2021-03-09;6273;2212;0;160350;76429;0;8.4;4.0;0.0
75;2021-03-10;6011;2261;0;166361;78690;0;8.7;4.1;0.0
75;2021-03-11;8331;2480;0;174692;81170;0;9.1;4.2;0.0
75;2021-03-12;10119;2547;0;184811;83717;0;9.7;4.4;0.0
75;2021-03-13;7777;816;0;192588;84533;0;10.1;4.4;0.0
75;2021-03-14;3439;270;0;196027;84803;0;10.3;4.4;0.0
75;2021-03-15;6531;1095;0;202558;85898;0;10.6;4.5;0.0
75;2021-03-16;4800;836;0;207358;86734;0;10.8;4.5;0.0
75;2021-03-17;4972;944;0;212330;87678;0;11.1;4.6;0.0
75;2021-03-18;6043;1001;0;218373;88679;0;11.4;4.6;0.0
75;2021-03-19;8672;1138;0;227045;89817;0;11.9;4.7;0.0
75;2021-03-20;5468;547;0;232513;90364;0;12.2;4.7;0.0
75;2021-03-21;1490;435;0;234003;90799;0;12.2;4.8;0.0
75;2021-03-22;7597;1184;0;241600;91983;0;12.6;4.8;0.0
75;2021-03-23;9642;1332;0;251242;93315;0;13.1;4.9;0.0
75;2021-03-24;9481;1308;0;260723;94623;0;13.6;5.0;0.0
75;2021-03-25;12224;1516;0;272947;96139;0;14.3;5.0;0.0
75;2021-03-26;12161;1649;0;285108;97788;0;14.9;5.1;0.0
75;2021-03-27;6558;738;0;291666;98526;0;15.3;5.2;0.0
75;2021-03-28;1671;157;0;293337;98683;0;15.3;5.2;0.0
75;2021-03-29;6713;2097;0;300050;100780;0;15.7;5.3;0.0
75;2021-03-30;9221;2997;0;309271;103777;0;16.2;5.4;0.0
75;2021-03-31;7928;3478;0;317199;107255;0;16.6;5.6;0.0
75;2021-04-01;8676;4837;0;325875;112092;0;17.0;5.9;0.0
75;2021-04-02;7365;5291;0;333240;117383;0;17.4;6.1;0.0
75;2021-04-03;3545;4789;0;336785;122172;0;17.6;6.4;0.0
75;2021-04-04;1138;1499;0;337923;123671;0;17.7;6.5;0.0
75;2021-04-05;1951;1141;0;339874;124812;0;17.8;6.5;0.0
75;2021-04-06;6062;4318;0;345936;129130;0;18.1;6.8;0.0
75;2021-04-07;7347;4187;0;353283;133317;0;18.5;7.0;0.0
75;2021-04-08;9836;4088;0;363119;137405;0;19.0;7.2;0.0
75;2021-04-09;10868;4566;0;373987;141971;0;19.6;7.4;0.0
75;2021-04-10;5600;3868;0;379587;145839;0;19.9;7.6;0.0
75;2021-04-11;1598;1535;0;381185;147374;0;19.9;7.7;0.0
75;2021-04-12;6831;3963;0;388016;151337;0;20.3;7.9;0.0
75;2021-04-13;7663;6111;0;395679;157448;0;20.7;8.2;0.0
75;2021-04-14;7307;5061;0;402986;162509;0;21.1;8.5;0.0
75;2021-04-15;8010;5714;0;410996;168223;0;21.5;8.8;0.0
75;2021-04-16;8436;5731;0;419432;173954;0;21.9;9.1;0.0
75;2021-04-17;4571;3423;0;424003;177377;0;22.2;9.3;0.0
75;2021-04-18;1339;950;0;425342;178327;0;22.3;9.3;0.0
75;2021-04-19;5415;4848;0;430757;183175;0;22.5;9.6;0.0
75;2021-04-20;6263;5517;0;437020;188692;0;22.9;9.9;0.0
75;2021-04-21;6404;5347;0;443424;194039;0;23.2;10.2;0.0
75;2021-04-22;7336;5851;0;450760;199890;0;23.6;10.5;0.0
75;2021-04-23;7998;6131;0;458758;206021;0;24.0;10.8;0.0
75;2021-04-24;6264;3605;0;465022;209626;0;24.3;11.0;0.0
75;2021-04-25;2614;1009;0;467636;210635;0;24.5;11.0;0.0
75;2021-04-26;6538;4875;0;474174;215510;0;24.8;11.3;0.0
75;2021-04-27;9264;6049;0;483438;221559;0;25.3;11.6;0.0
75;2021-04-28;10520;5720;0;493958;227279;0;25.8;11.9;0.0
75;2021-04-29;12206;5871;0;506164;233150;0;26.5;12.2;0.0
75;2021-04-30;12578;5850;0;518742;239000;0;27.1;12.5;0.0
75;2021-05-01;4848;1338;0;523590;240338;0;27.4;12.6;0.0
75;2021-05-02;2339;926;0;525929;241264;0;27.5;12.6;0.0
75;2021-05-03;10135;9367;0;536064;250631;0;28.0;13.1;0.0
75;2021-05-04;10837;7209;0;546901;257840;0;28.6;13.5;0.0
75;2021-05-05;12256;6557;0;559157;264397;0;29.3;13.8;0.0
75;2021-05-06;13249;7671;0;572406;272068;0;29.9;14.2;0.0
75;2021-05-07;12607;8332;0;585013;280400;0;30.6;14.7;0.0
75;2021-05-08;10016;3682;0;595029;284082;0;31.1;14.9;0.0
75;2021-05-09;5037;2339;0;600066;286421;0;31.4;15.0;0.0
75;2021-05-10;12962;6443;0;613028;292864;0;32.1;15.3;0.0
75;2021-05-11;16130;7983;0;629158;300847;0;32.9;15.7;0.0
75;2021-05-12;17992;7306;0;647150;308153;0;33.9;16.1;0.0
75;2021-05-13;15273;2592;0;662423;310745;0;34.7;16.3;0.0
75;2021-05-14;18893;5284;0;681316;316029;0;35.6;16.5;0.0
75;2021-05-15;14295;3020;0;695611;319049;0;36.4;16.7;0.0
75;2021-05-16;6266;985;0;701877;320034;0;36.7;16.7;0.0
75;2021-05-17;17418;4542;0;719295;324576;0;37.6;17.0;0.0
75;2021-05-18;20799;5131;0;740094;329707;0;38.7;17.2;0.0
75;2021-05-19;20638;7549;0;760732;337256;0;39.8;17.6;0.0
75;2021-05-20;22171;7021;0;782903;344277;0;41.0;18.0;0.0
75;2021-05-21;21171;6114;0;804074;350391;0;42.1;18.3;0.0
75;2021-05-22;16443;3234;0;820517;353625;0;42.9;18.5;0.0
75;2021-05-23;7267;1309;0;827784;354934;0;43.3;18.6;0.0
75;2021-05-24;15224;2583;0;843008;357517;0;44.1;18.7;0.0
75;2021-05-25;18494;8019;0;861502;365536;0;45.1;19.1;0.0
75;2021-05-26;18117;7222;0;879619;372758;0;46.0;19.5;0.0
75;2021-05-27;19441;8527;0;899060;381285;0;47.0;19.9;0.0
75;2021-05-28;18585;9754;0;917645;391039;0;48.0;20.5;0.0
75;2021-05-29;15333;5554;0;932978;396593;0;48.8;20.7;0.0
75;2021-05-30;7831;2019;0;940809;398612;0;49.2;20.9;0.0
75;2021-05-31;17651;8957;0;958460;407569;0;50.1;21.3;0.0
75;2021-06-01;18478;11244;0;976938;418813;0;51.1;21.9;0.0
75;2021-06-02;17717;9540;0;994655;428353;0;52.0;22.4;0.0
75;2021-06-03;19254;11119;0;1013909;439472;0;53.0;23.0;0.0
75;2021-06-04;17694;12291;0;1031603;451763;0;54.0;23.6;0.0
75;2021-06-05;12150;9614;0;1043753;461377;0;54.6;24.1;0.0
75;2021-06-06;8068;3130;0;1051821;464507;0;55.0;24.3;0.0
75;2021-06-07;14177;11405;0;1065998;475912;0;55.8;24.9;0.0
75;2021-06-08;14867;13579;0;1080865;489491;0;56.5;25.6;0.0
75;2021-06-09;15393;13830;0;1096258;503321;0;57.4;26.3;0.0
75;2021-06-10;16564;18947;0;1112822;522268;0;58.2;27.3;0.0
75;2021-06-11;13266;15313;0;1126088;537581;0;58.9;28.1;0.0
75;2021-06-12;11872;9486;0;1137960;547067;0;59.5;28.6;0.0
75;2021-06-13;6384;3905;0;1144344;550972;0;59.9;28.8;0.0
75;2021-06-14;10338;15186;0;1154682;566158;0;60.4;29.6;0.0
75;2021-06-15;11202;17620;0;1165884;583778;0;61.0;30.5;0.0
75;2021-06-16;10843;16156;0;1176727;599934;0;61.6;31.4;0.0
75;2021-06-17;10806;16795;0;1187533;616729;0;62.1;32.3;0.0
75;2021-06-18;9197;20728;0;1196730;637457;0;62.6;33.3;0.0
75;2021-06-19;6779;12471;0;1203509;649928;0;63.0;34.0;0.0
75;2021-06-20;2801;6293;0;1206310;656221;0;63.1;34.3;0.0
75;2021-06-21;6989;16765;0;1213299;672986;0;63.5;35.2;0.0
75;2021-06-22;7248;21454;0;1220547;694440;0;63.9;36.3;0.0
75;2021-06-23;7956;20385;0;1228503;714825;0;64.3;37.4;0.0
75;2021-06-24;8762;20391;0;1237265;735216;0;64.7;38.5;0.0
75;2021-06-25;7478;23417;0;1244743;758633;0;65.1;39.7;0.0
75;2021-06-26;6251;16419;0;1250994;775052;0;65.4;40.5;0.0
75;2021-06-27;2281;7482;0;1253275;782534;0;65.6;40.9;0.0
75;2021-06-28;6439;20405;0;1259714;802939;0;65.9;42.0;0.0
75;2021-06-29;7128;23234;0;1266842;826173;0;66.3;43.2;0.0
75;2021-06-30;7318;22165;0;1274160;848338;0;66.7;44.4;0.0
75;2021-07-01;8621;21885;0;1282781;870223;0;67.1;45.5;0.0
75;2021-07-02;7991;22685;0;1290772;892908;0;67.5;46.7;0.0
75;2021-07-03;5747;18442;0;1296519;911350;0;67.8;47.7;0.0
75;2021-07-04;2629;9028;0;1299148;920378;0;68.0;48.1;0.0
75;2021-07-05;6704;20010;0;1305852;940388;0;68.3;49.2;0.0
75;2021-07-06;7421;21829;1;1313273;962217;1;68.7;50.3;0.0
75;2021-07-07;7212;21199;0;1320485;983416;1;69.1;51.4;0.0
75;2021-07-08;7918;20965;0;1328403;1004381;1;69.5;52.5;0.0
75;2021-07-09;7856;21519;0;1336259;1025900;1;69.9;53.7;0.0
75;2021-07-10;5754;16582;0;1342013;1042482;1;70.2;54.5;0.0
75;2021-07-11;2939;8104;0;1344952;1050586;1;70.4;55.0;0.0
75;2021-07-12;6910;20866;0;1351862;1071452;1;70.7;56.1;0.0
75;2021-07-13;10134;21971;0;1361996;1093423;1;71.3;57.2;0.0
75;2021-07-14;6421;8657;0;1368417;1102080;1;71.6;57.7;0.0
75;2021-07-15;10709;22219;0;1379126;1124299;1;72.1;58.8;0.0
75;2021-07-16;11109;19431;0;1390235;1143730;1;72.7;59.8;0.0
75;2021-07-17;7949;14507;0;1398184;1158237;1;73.1;60.6;0.0
75;2021-07-18;4031;6515;0;1402215;1164752;1;73.4;60.9;0.0
75;2021-07-19;9524;18619;0;1411739;1183371;1;73.9;61.9;0.0
75;2021-07-20;11102;19224;0;1422841;1202595;1;74.4;62.9;0.0
75;2021-07-21;10788;17459;0;1433629;1220054;1;75.0;63.8;0.0
75;2021-07-22;11686;16685;0;1445315;1236739;1;75.6;64.7;0.0
75;2021-07-23;11631;15691;0;1456946;1252430;1;76.2;65.5;0.0
75;2021-07-24;7573;11198;0;1464519;1263628;1;76.6;66.1;0.0
75;2021-07-25;3426;4021;0;1467945;1267649;1;76.8;66.3;0.0
75;2021-07-26;10387;13537;1;1478332;1281186;2;77.3;67.0;0.0
75;2021-07-27;12371;12911;0;1490703;1294097;2;78.0;67.7;0.0
75;2021-07-28;11866;11929;0;1502569;1306026;2;78.6;68.3;0.0
75;2021-07-29;11830;11829;0;1514399;1317855;2;79.2;68.9;0.0
75;2021-07-30;11262;11395;0;1525661;1329250;2;79.8;69.5;0.0
75;2021-07-31;6620;7565;0;1532281;1336815;2;80.2;69.9;0.0
75;2021-08-01;2767;2460;0;1535048;1339275;2;80.3;70.1;0.0
75;2021-08-02;7972;9412;0;1543020;1348687;2;80.7;70.6;0.0
75;2021-08-03;8049;8834;0;1551069;1357521;2;81.1;71.0;0.0
75;2021-08-04;7299;7639;0;1558368;1365160;2;81.5;71.4;0.0
75;2021-08-05;6539;7720;0;1564907;1372880;2;81.9;71.8;0.0
75;2021-08-06;6350;8098;0;1571257;1380978;2;82.2;72.2;0.0
75;2021-08-07;3960;5354;0;1575217;1386332;2;82.4;72.5;0.0
75;2021-08-08;1339;2260;0;1576556;1388592;2;82.5;72.6;0.0
75;2021-08-09;5742;8549;0;1582298;1397141;2;82.8;73.1;0.0
75;2021-08-10;6171;8753;0;1588469;1405894;2;83.1;73.5;0.0
75;2021-08-11;5346;7809;0;1593815;1413703;2;83.4;74.0;0.0
75;2021-08-12;4760;8053;0;1598575;1421756;2;83.6;74.4;0.0
75;2021-08-13;4338;6974;0;1602913;1428730;2;83.9;74.7;0.0
75;2021-08-14;2671;5183;0;1605584;1433913;2;84.0;75.0;0.0
75;2021-08-15;666;1216;0;1606250;1435129;2;84.0;75.1;0.0
75;2021-08-16;4242;9800;0;1610492;1444929;2;84.3;75.6;0.0
75;2021-08-17;3954;9555;0;1614446;1454484;2;84.5;76.1;0.0
75;2021-08-18;3510;8697;0;1617956;1463181;2;84.6;76.5;0.0
75;2021-08-19;3475;8734;0;1621431;1471915;2;84.8;77.0;0.0
75;2021-08-20;3167;8462;0;1624598;1480377;2;85.0;77.4;0.0
75;2021-08-21;2151;6208;0;1626749;1486585;2;85.1;77.8;0.0
75;2021-08-22;632;2311;0;1627381;1488896;2;85.1;77.9;0.0
75;2021-08-23;3280;10161;0;1630661;1499057;2;85.3;78.4;0.0
75;2021-08-24;3340;9696;0;1634001;1508753;2;85.5;78.9;0.0
75;2021-08-25;3101;8488;0;1637102;1517241;2;85.6;79.4;0.0
75;2021-08-26;2814;7417;4;1639916;1524658;6;85.8;79.8;0.0
75;2021-08-27;3204;8589;2;1643120;1533247;8;86.0;80.2;0.0
75;2021-08-28;2256;5928;0;1645376;1539175;8;86.1;80.5;0.0
75;2021-08-29;615;1538;0;1645991;1540713;8;86.1;80.6;0.0
75;2021-08-30;3255;9454;562;1649246;1550167;570;86.3;81.1;0.0
75;2021-08-31;3116;8525;1043;1652362;1558692;1613;86.4;81.5;0.1
75;2021-09-01;3374;6861;1765;1655736;1565553;3378;86.6;81.9;0.2
75;2021-09-02;2526;5161;1947;1658262;1570714;5325;86.8;82.2;0.3
75;2021-09-03;2612;5882;1942;1660874;1576596;7267;86.9;82.5;0.4
75;2021-09-04;2759;5530;1050;1663633;1582126;8317;87.0;82.8;0.4
75;2021-09-05;468;917;396;1664101;1583043;8713;87.1;82.8;0.5
75;2021-09-06;1750;4033;1706;1665851;1587076;10419;87.1;83.0;0.5
75;2021-09-07;1580;3560;1601;1667431;1590636;12020;87.2;83.2;0.6
75;2021-09-08;1862;3964;1520;1669293;1594600;13540;87.3;83.4;0.7
75;2021-09-09;1658;3209;1720;1670951;1597809;15260;87.4;83.6;0.8
75;2021-09-10;1969;3769;2040;1672920;1601578;17300;87.5;83.8;0.9
75;2021-09-11;1665;4035;826;1674585;1605613;18126;87.6;84.0;0.9
75;2021-09-12;311;630;178;1674896;1606243;18304;87.6;84.0;1.0
75;2021-09-13;1646;2898;1872;1676542;1609141;20176;87.7;84.2;1.1
75;2021-09-14;1527;2550;1970;1678069;1611691;22146;87.8;84.3;1.2
75;2021-09-15;1748;3092;1834;1679817;1614783;23980;87.9;84.5;1.3
75;2021-09-16;1373;2241;1778;1681190;1617024;25758;88.0;84.6;1.3
75;2021-09-17;1840;3253;2209;1683030;1620277;27967;88.0;84.8;1.5
75;2021-09-18;1160;3450;714;1684190;1623727;28681;88.1;84.9;1.5
75;2021-09-19;214;538;117;1684404;1624265;28798;88.1;85.0;1.5
75;2021-09-20;1285;2421;1849;1685689;1626686;30647;88.2;85.1;1.6
75;2021-09-21;1154;2073;1670;1686843;1628759;32317;88.2;85.2;1.7
75;2021-09-22;1248;2962;1692;1688091;1631721;34009;88.3;85.4;1.8
75;2021-09-23;989;1786;1830;1689080;1633507;35839;88.4;85.5;1.9
75;2021-09-24;1255;2797;2030;1690335;1636304;37869;88.4;85.6;2.0
75;2021-09-25;905;3201;625;1691240;1639505;38494;88.5;85.8;2.0
75;2021-09-26;188;411;120;1691428;1639916;38614;88.5;85.8;2.0
75;2021-09-27;955;1998;1609;1692383;1641914;40223;88.5;85.9;2.1
75;2021-09-28;1014;1601;1682;1693397;1643515;41905;88.6;86.0;2.2
75;2021-09-29;1054;2086;1772;1694451;1645601;43677;88.6;86.1;2.3
75;2021-09-30;901;1741;1942;1695352;1647342;45619;88.7;86.2;2.4
75;2021-10-01;1652;1951;2191;1697004;1649293;47810;88.8;86.3;2.5
75;2021-10-02;1130;2022;896;1698134;1651315;48706;88.8;86.4;2.5
75;2021-10-03;158;282;120;1698292;1651597;48826;88.8;86.4;2.6
75;2021-10-04;1111;1629;2753;1699403;1653226;51579;88.9;86.5;2.7
75;2021-10-05;890;1422;2624;1700293;1654648;54203;89.0;86.6;2.8
75;2021-10-06;1029;1755;2522;1701322;1656403;56725;89.0;86.7;3.0
75;2021-10-07;841;1324;2456;1702163;1657727;59181;89.0;86.7;3.1
75;2021-10-08;1193;2108;3272;1703356;1659835;62453;89.1;86.8;3.3
75;2021-10-09;961;1536;1379;1704317;1661371;63832;89.2;86.9;3.3
75;2021-10-10;183;302;164;1704500;1661673;63996;89.2;86.9;3.3
75;2021-10-11;947;1402;2589;1705447;1663075;66585;89.2;87.0;3.5
75;2021-10-12;890;1397;2869;1706337;1664472;69454;89.3;87.1;3.6
75;2021-10-13;1004;1556;2788;1707341;1666028;72242;89.3;87.2;3.8
75;2021-10-14;836;1285;2842;1708177;1667313;75084;89.4;87.2;3.9
75;2021-10-15;1130;1609;3529;1709307;1668922;78613;89.4;87.3;4.1
75;2021-10-16;970;1364;1466;1710277;1670286;80079;89.5;87.4;4.2
75;2021-10-17;164;233;245;1710441;1670519;80324;89.5;87.4;4.2
75;2021-10-18;826;1173;2941;1711267;1671692;83265;89.5;87.5;4.4
75;2021-10-19;755;1169;3503;1712022;1672861;86768;89.6;87.5;4.5
75;2021-10-20;850;1250;3470;1712872;1674111;90238;89.6;87.6;4.7
75;2021-10-21;614;1109;3053;1713486;1675220;93291;89.6;87.6;4.9
75;2021-10-22;910;1385;3861;1714396;1676605;97152;89.7;87.7;5.1
75;2021-10-23;727;1111;1886;1715123;1677716;99038;89.7;87.8;5.2
75;2021-10-24;109;148;179;1715232;1677864;99217;89.7;87.8;5.2
75;2021-10-25;668;1028;3470;1715900;1678892;102687;89.8;87.8;5.4
75;2021-10-26;668;954;3809;1716568;1679846;106496;89.8;87.9;5.6
75;2021-10-27;644;983;3866;1717212;1680829;110362;89.8;87.9;5.8
75;2021-10-28;587;860;3606;1717799;1681689;113968;89.9;88.0;6.0
75;2021-10-29;679;1050;4218;1718478;1682739;118186;89.9;88.0;6.2
75;2021-10-30;526;804;2022;1719004;1683543;120208;89.9;88.1;6.3
75;2021-10-31;77;137;217;1719081;1683680;120425;89.9;88.1;6.3
75;2021-11-01;183;149;234;1719264;1683829;120659;89.9;88.1;6.3
75;2021-11-02;708;1038;3268;1719972;1684867;123927;90.0;88.1;6.5
75;2021-11-03;604;964;3515;1720576;1685831;127442;90.0;88.2;6.7
75;2021-11-04;537;836;3429;1721113;1686667;130871;90.0;88.2;6.8
75;2021-11-05;634;1010;4357;1721747;1687677;135228;90.1;88.3;7.1
75;2021-11-06;529;850;2115;1722276;1688527;137343;90.1;88.3;7.2
75;2021-11-07;102;159;299;1722378;1688686;137642;90.1;88.3;7.2
75;2021-11-08;483;828;4552;1722861;1689514;142194;90.1;88.4;7.4
75;2021-11-09;562;885;5424;1723423;1690399;147618;90.2;88.4;7.7
75;2021-11-10;723;1116;6097;1724146;1691515;153715;90.2;88.5;8.0
75;2021-11-11;200;317;1107;1724346;1691832;154822;90.2;88.5;8.1
75;2021-11-12;603;985;6278;1724949;1692817;161100;90.2;88.6;8.4
75;2021-11-13;547;806;3025;1725496;1693623;164125;90.3;88.6;8.6
75;2021-11-14;97;151;446;1725593;1693774;164571;90.3;88.6;8.6
75;2021-11-15;500;848;5789;1726093;1694622;170360;90.3;88.7;8.9
75;2021-11-16;577;824;6307;1726670;1695446;176667;90.3;88.7;9.2
75;2021-11-17;676;922;5973;1727346;1696368;182640;90.4;88.7;9.6
75;2021-11-18;516;814;5947;1727862;1697182;188587;90.4;88.8;9.9
75;2021-11-19;671;900;7163;1728533;1698082;195750;90.4;88.8;10.2
75;2021-11-20;613;860;3670;1729146;1698942;199420;90.5;88.9;10.4
75;2021-11-21;80;156;564;1729226;1699098;199984;90.5;88.9;10.5
75;2021-11-22;552;635;6360;1729778;1699733;206344;90.5;88.9;10.8
75;2021-11-23;619;791;7472;1730397;1700524;213816;90.5;89.0;11.2
75;2021-11-24;634;894;7227;1731031;1701418;221043;90.6;89.0;11.6
75;2021-11-25;598;769;9712;1731629;1702187;230755;90.6;89.1;12.1
75;2021-11-26;555;862;13963;1732184;1703049;244718;90.6;89.1;12.8
75;2021-11-27;485;754;10607;1732669;1703803;255325;90.6;89.1;13.4
75;2021-11-28;142;208;4678;1732811;1704011;260003;90.7;89.1;13.6
75;2021-11-29;462;732;15219;1733273;1704743;275222;90.7;89.2;14.4
75;2021-11-30;507;849;18730;1733780;1705592;293952;90.7;89.2;15.4
75;2021-12-01;486;883;19243;1734266;1706475;313195;90.7;89.3;16.4
75;2021-12-02;449;704;20619;1734715;1707179;333814;90.8;89.3;17.5
75;2021-12-03;504;928;22655;1735219;1708107;356469;90.8;89.4;18.6
75;2021-12-04;373;749;15509;1735592;1708856;371978;90.8;89.4;19.5
75;2021-12-05;176;297;8044;1735768;1709153;380022;90.8;89.4;19.9
75;2021-12-06;423;789;20842;1736191;1709942;400864;90.8;89.5;21.0
75;2021-12-07;497;916;24717;1736688;1710858;425581;90.9;89.5;22.3
75;2021-12-08;504;918;22643;1737192;1711776;448224;90.9;89.6;23.4
75;2021-12-09;444;863;24581;1737636;1712639;472805;90.9;89.6;24.7
75;2021-12-10;465;884;26109;1738101;1713523;498914;90.9;89.6;26.1
75;2021-12-11;504;882;20149;1738605;1714405;519063;91.0;89.7;27.2
75;2021-12-12;235;327;12965;1738840;1714732;532028;91.0;89.7;27.8
75;2021-12-13;497;870;25194;1739337;1715602;557222;91.0;89.8;29.2
75;2021-12-14;587;947;29678;1739924;1716549;586900;91.0;89.8;30.7
75;2021-12-15;598;975;27873;1740522;1717524;614773;91.1;89.9;32.2
75;2021-12-16;610;969;29601;1741132;1718493;644374;91.1;89.9;33.7
75;2021-12-17;570;1027;29603;1741702;1719520;673977;91.1;90.0;35.3
75;2021-12-18;515;853;20107;1742217;1720373;694084;91.1;90.0;36.3
75;2021-12-19;318;407;14551;1742535;1720780;708635;91.2;90.0;37.1
76;2020-12-27;0;0;0;0;0;0;0.0;0.0;0.0
76;2020-12-28;0;0;0;0;0;0;0.0;0.0;0.0
76;2020-12-29;0;0;0;0;0;0;0.0;0.0;0.0
76;2020-12-30;0;0;0;0;0;0;0.0;0.0;0.0
76;2020-12-31;0;0;0;0;0;0;0.0;0.0;0.0
76;2021-01-01;1;0;0;1;0;0;0.0;0.0;0.0
76;2021-01-02;0;0;0;1;0;0;0.0;0.0;0.0
76;2021-01-03;0;0;0;1;0;0;0.0;0.0;0.0
76;2021-01-04;17;0;0;18;0;0;0.0;0.0;0.0
76;2021-01-05;124;0;0;142;0;0;0.0;0.0;0.0
76;2021-01-06;622;2;0;764;2;0;0.1;0.0;0.0
76;2021-01-07;1233;9;0;1997;11;0;0.2;0.0;0.0
76;2021-01-08;1369;2;0;3366;13;0;0.3;0.0;0.0
76;2021-01-09;665;1;0;4031;14;0;0.4;0.0;0.0
76;2021-01-10;472;2;0;4503;16;0;0.4;0.0;0.0
76;2021-01-11;1286;4;0;5789;20;0;0.5;0.0;0.0
76;2021-01-12;1252;1;0;7041;21;0;0.7;0.0;0.0
76;2021-01-13;1144;5;0;8185;26;0;0.8;0.0;0.0
76;2021-01-14;2070;23;0;10255;49;0;1.0;0.0;0.0
76;2021-01-15;1819;8;0;12074;57;0;1.1;0.0;0.0
76;2021-01-16;953;7;0;13027;64;0;1.2;0.0;0.0
76;2021-01-17;2707;20;0;15734;84;0;1.5;0.0;0.0
76;2021-01-18;4175;18;0;19909;102;0;1.9;0.0;0.0
76;2021-01-19;2840;11;0;22749;113;0;2.1;0.0;0.0
76;2021-01-20;1952;11;0;24701;124;0;2.3;0.0;0.0
76;2021-01-21;1704;5;0;26405;129;0;2.5;0.0;0.0
76;2021-01-22;1610;2;0;28015;131;0;2.6;0.0;0.0
76;2021-01-23;451;4;0;28466;135;0;2.7;0.0;0.0
76;2021-01-24;100;0;0;28566;135;0;2.7;0.0;0.0
76;2021-01-25;1370;131;0;29936;266;0;2.8;0.0;0.0
76;2021-01-26;1323;314;0;31259;580;0;2.9;0.1;0.0
76;2021-01-27;1269;392;0;32528;972;0;3.0;0.1;0.0
76;2021-01-28;1237;320;0;33765;1292;0;3.2;0.1;0.0
76;2021-01-29;1108;367;0;34873;1659;0;3.3;0.2;0.0
76;2021-01-30;259;259;0;35132;1918;0;3.3;0.2;0.0
76;2021-01-31;4;96;0;35136;2014;0;3.3;0.2;0.0
76;2021-02-01;790;741;0;35926;2755;0;3.4;0.3;0.0
76;2021-02-02;962;904;0;36888;3659;0;3.5;0.3;0.0
76;2021-02-03;847;966;0;37735;4625;0;3.5;0.4;0.0
76;2021-02-04;927;1389;0;38662;6014;0;3.6;0.6;0.0
76;2021-02-05;942;1078;0;39604;7092;0;3.7;0.7;0.0
76;2021-02-06;262;841;0;39866;7933;0;3.7;0.7;0.0
76;2021-02-07;438;1521;0;40304;9454;0;3.8;0.9;0.0
76;2021-02-08;1799;3524;0;42103;12978;0;3.9;1.2;0.0
76;2021-02-09;1690;2868;0;43793;15846;0;4.1;1.5;0.0
76;2021-02-10;1413;1747;0;45206;17593;0;4.2;1.6;0.0
76;2021-02-11;1599;1449;0;46805;19042;0;4.4;1.8;0.0
76;2021-02-12;1602;1547;0;48407;20589;0;4.5;1.9;0.0
76;2021-02-13;243;336;0;48650;20925;0;4.6;2.0;0.0
76;2021-02-14;7;75;0;48657;21000;0;4.6;2.0;0.0
76;2021-02-15;530;1569;0;49187;22569;0;4.6;2.1;0.0
76;2021-02-16;699;1529;0;49886;24098;0;4.7;2.3;0.0
76;2021-02-17;605;1384;0;50491;25482;0;4.7;2.4;0.0
76;2021-02-18;774;1307;0;51265;26789;0;4.8;2.5;0.0
76;2021-02-19;838;1235;0;52103;28024;0;4.9;2.6;0.0
76;2021-02-20;260;288;0;52363;28312;0;4.9;2.7;0.0
76;2021-02-21;2;5;0;52365;28317;0;4.9;2.7;0.0
76;2021-02-22;318;1212;0;52683;29529;0;4.9;2.8;0.0
76;2021-02-23;566;1150;0;53249;30679;0;5.0;2.9;0.0
76;2021-02-24;591;1133;0;53840;31812;0;5.0;3.0;0.0
76;2021-02-25;1606;1214;0;55446;33026;0;5.2;3.1;0.0
76;2021-02-26;2146;992;0;57592;34018;0;5.4;3.2;0.0
76;2021-02-27;1091;271;0;58683;34289;0;5.5;3.2;0.0
76;2021-02-28;30;193;0;58713;34482;0;5.5;3.2;0.0
76;2021-03-01;839;1976;0;59552;36458;0;5.6;3.4;0.0
76;2021-03-02;1353;1612;0;60905;38070;0;5.7;3.6;0.0
76;2021-03-03;1857;1323;0;62762;39393;0;5.9;3.7;0.0
76;2021-03-04;2753;1059;0;65515;40452;0;6.1;3.8;0.0
76;2021-03-05;4036;777;0;69551;41229;0;6.5;3.9;0.0
76;2021-03-06;3311;175;0;72862;41404;0;6.8;3.9;0.0
76;2021-03-07;1288;40;0;74150;41444;0;7.0;3.9;0.0
76;2021-03-08;2040;1204;0;76190;42648;0;7.1;4.0;0.0
76;2021-03-09;3518;1125;0;79708;43773;0;7.5;4.1;0.0
76;2021-03-10;3548;1036;0;83256;44809;0;7.8;4.2;0.0
76;2021-03-11;5489;925;0;88745;45734;0;8.3;4.3;0.0
76;2021-03-12;6587;608;0;95332;46342;0;8.9;4.3;0.0
76;2021-03-13;4667;185;0;99999;46527;0;9.4;4.4;0.0
76;2021-03-14;1065;27;0;101064;46554;0;9.5;4.4;0.0
76;2021-03-15;2833;235;0;103897;46789;0;9.7;4.4;0.0
76;2021-03-16;2498;387;0;106395;47176;0;10.0;4.4;0.0
76;2021-03-17;2697;316;0;109092;47492;0;10.2;4.5;0.0
76;2021-03-18;2977;341;0;112069;47833;0;10.5;4.5;0.0
76;2021-03-19;4268;425;0;116337;48258;0;10.9;4.5;0.0
76;2021-03-20;3929;295;0;120266;48553;0;11.3;4.6;0.0
76;2021-03-21;819;15;0;121085;48568;0;11.4;4.6;0.0
76;2021-03-22;3774;355;0;124859;48923;0;11.7;4.6;0.0
76;2021-03-23;5443;371;0;130302;49294;0;12.2;4.6;0.0
76;2021-03-24;5489;411;0;135791;49705;0;12.7;4.7;0.0
76;2021-03-25;7292;576;0;143083;50281;0;13.4;4.7;0.0
76;2021-03-26;8343;616;0;151426;50897;0;14.2;4.8;0.0
76;2021-03-27;4670;385;0;156096;51282;0;14.6;4.8;0.0
76;2021-03-28;1058;39;0;157154;51321;0;14.7;4.8;0.0
76;2021-03-29;5051;839;0;162205;52160;0;15.2;4.9;0.0
76;2021-03-30;6257;1062;0;168462;53222;0;15.8;5.0;0.0
76;2021-03-31;6066;1262;0;174528;54484;0;16.4;5.1;0.0
76;2021-04-01;6285;1993;0;180813;56477;0;16.9;5.3;0.0
76;2021-04-02;6280;2561;0;187093;59038;0;17.5;5.5;0.0
76;2021-04-03;2424;1122;0;189517;60160;0;17.8;5.6;0.0
76;2021-04-04;267;26;0;189784;60186;0;17.8;5.6;0.0
76;2021-04-05;798;356;0;190582;60542;0;17.9;5.7;0.0
76;2021-04-06;3346;2766;0;193928;63308;0;18.2;5.9;0.0
76;2021-04-07;4141;2423;0;198069;65731;0;18.6;6.2;0.0
76;2021-04-08;5524;2717;0;203593;68448;0;19.1;6.4;0.0
76;2021-04-09;8464;2981;0;212057;71429;0;19.9;6.7;0.0
76;2021-04-10;4684;1477;0;216741;72906;0;20.3;6.8;0.0
76;2021-04-11;810;535;0;217551;73441;0;20.4;6.9;0.0
76;2021-04-12;4441;2768;0;221992;76209;0;20.8;7.1;0.0
76;2021-04-13;5642;2803;0;227634;79012;0;21.3;7.4;0.0
76;2021-04-14;4569;3110;0;232203;82122;0;21.8;7.7;0.0
76;2021-04-15;5332;3302;0;237535;85424;0;22.3;8.0;0.0
76;2021-04-16;7051;3242;0;244586;88666;0;22.9;8.3;0.0
76;2021-04-17;4207;1436;0;248793;90102;0;23.3;8.4;0.0
76;2021-04-18;351;156;0;249144;90258;0;23.4;8.5;0.0
76;2021-04-19;3292;3533;0;252436;93791;0;23.7;8.8;0.0
76;2021-04-20;4176;4104;0;256612;97895;0;24.1;9.2;0.0
76;2021-04-21;4056;4445;0;260668;102340;0;24.4;9.6;0.0
76;2021-04-22;4444;5169;0;265112;107509;0;24.9;10.1;0.0
76;2021-04-23;5265;5652;0;270377;113161;0;25.3;10.6;0.0
76;2021-04-24;4059;2093;0;274436;115254;0;25.7;10.8;0.0
76;2021-04-25;971;340;0;275407;115594;0;25.8;10.8;0.0
76;2021-04-26;4362;4161;0;279769;119755;0;26.2;11.2;0.0
76;2021-04-27;4836;4663;0;284605;124418;0;26.7;11.7;0.0
76;2021-04-28;5168;3886;0;289773;128304;0;27.2;12.0;0.0
76;2021-04-29;6750;3850;0;296523;132154;0;27.8;12.4;0.0
76;2021-04-30;7901;4452;0;304424;136606;0;28.5;12.8;0.0
76;2021-05-01;4530;997;0;308954;137603;0;29.0;12.9;0.0
76;2021-05-02;1903;285;0;310857;137888;0;29.1;12.9;0.0
76;2021-05-03;4662;3121;0;315519;141009;0;29.6;13.2;0.0
76;2021-05-04;4717;4312;0;320236;145321;0;30.0;13.6;0.0
76;2021-05-05;4739;4853;0;324975;150174;0;30.5;14.1;0.0
76;2021-05-06;5851;5260;0;330826;155434;0;31.0;14.6;0.0
76;2021-05-07;6124;6428;0;336950;161862;0;31.6;15.2;0.0
76;2021-05-08;4875;906;0;341825;162768;0;32.0;15.3;0.0
76;2021-05-09;2635;274;0;344460;163042;0;32.3;15.3;0.0
76;2021-05-10;4920;4765;0;349380;167807;0;32.7;15.7;0.0
76;2021-05-11;6370;5365;0;355750;173172;0;33.3;16.2;0.0
76;2021-05-12;6321;4844;0;362071;178016;0;33.9;16.7;0.0
76;2021-05-13;8178;1203;0;370249;179219;0;34.7;16.8;0.0
76;2021-05-14;9869;4394;0;380118;183613;0;35.6;17.2;0.0
76;2021-05-15;8787;2405;0;388905;186018;0;36.5;17.4;0.0
76;2021-05-16;6105;475;0;395010;186493;0;37.0;17.5;0.0
76;2021-05-17;7148;3108;0;402158;189601;0;37.7;17.8;0.0
76;2021-05-18;8167;2678;0;410325;192279;0;38.5;18.0;0.0
76;2021-05-19;8252;3073;0;418577;195352;0;39.2;18.3;0.0
76;2021-05-20;9283;3336;0;427860;198688;0;40.1;18.6;0.0
76;2021-05-21;8043;4024;0;435903;202712;0;40.9;19.0;0.0
76;2021-05-22;7022;2268;0;442925;204980;0;41.5;19.2;0.0
76;2021-05-23;5988;404;0;448913;205384;0;42.1;19.3;0.0
76;2021-05-24;6206;1455;0;455119;206839;0;42.7;19.4;0.0
76;2021-05-25;7556;3944;0;462675;210783;0;43.4;19.8;0.0
76;2021-05-26;7170;3548;0;469845;214331;0;44.0;20.1;0.0
76;2021-05-27;8229;4544;0;478074;218875;0;44.8;20.5;0.0
76;2021-05-28;8171;6385;0;486245;225260;0;45.6;21.1;0.0
76;2021-05-29;6264;3465;0;492509;228725;0;46.2;21.4;0.0
76;2021-05-30;3106;405;0;495615;229130;0;46.5;21.5;0.0
76;2021-05-31;7781;3814;0;503396;232944;0;47.2;21.8;0.0
76;2021-06-01;8757;4868;0;512153;237812;0;48.0;22.3;0.0
76;2021-06-02;7439;4436;0;519592;242248;0;48.7;22.7;0.0
76;2021-06-03;9265;5311;0;528857;247559;0;49.6;23.2;0.0
76;2021-06-04;8701;6573;0;537558;254132;0;50.4;23.8;0.0
76;2021-06-05;6217;3833;0;543775;257965;0;51.0;24.2;0.0
76;2021-06-06;2690;713;0;546465;258678;0;51.2;24.2;0.0
76;2021-06-07;6620;5295;0;553085;263973;0;51.8;24.7;0.0
76;2021-06-08;8239;6108;0;561324;270081;0;52.6;25.3;0.0
76;2021-06-09;6907;5960;0;568231;276041;0;53.3;25.9;0.0
76;2021-06-10;7450;6414;0;575681;282455;0;54.0;26.5;0.0
76;2021-06-11;7223;8033;0;582904;290488;0;54.6;27.2;0.0
76;2021-06-12;6698;5795;0;589602;296283;0;55.3;27.8;0.0
76;2021-06-13;2859;1407;0;592461;297690;0;55.5;27.9;0.0
76;2021-06-14;5624;6608;0;598085;304298;0;56.1;28.5;0.0
76;2021-06-15;5887;7306;0;603972;311604;0;56.6;29.2;0.0
76;2021-06-16;6219;7338;0;610191;318942;0;57.2;29.9;0.0
76;2021-06-17;6555;7592;0;616746;326534;0;57.8;30.6;0.0
76;2021-06-18;7001;9107;0;623747;335641;0;58.5;31.5;0.0
76;2021-06-19;5550;6175;0;629297;341816;0;59.0;32.0;0.0
76;2021-06-20;2681;1752;0;631978;343568;0;59.2;32.2;0.0
76;2021-06-21;4654;7814;0;636632;351382;0;59.7;32.9;0.0
76;2021-06-22;4523;9387;0;641155;360769;0;60.1;33.8;0.0
76;2021-06-23;4368;9251;0;645523;370020;0;60.5;34.7;0.0
76;2021-06-24;4465;9669;0;649988;379689;0;60.9;35.6;0.0
76;2021-06-25;4616;11258;0;654604;390947;0;61.4;36.6;0.0
76;2021-06-26;3248;7801;0;657852;398748;0;61.7;37.4;0.0
76;2021-06-27;1351;4866;0;659203;403614;0;61.8;37.8;0.0
76;2021-06-28;3263;9603;0;662466;413217;0;62.1;38.7;0.0
76;2021-06-29;3701;9959;0;666167;423176;0;62.4;39.7;0.0
76;2021-06-30;4030;9551;0;670197;432727;0;62.8;40.6;0.0
76;2021-07-01;4357;9708;0;674554;442435;0;63.2;41.5;0.0
76;2021-07-02;4173;11751;0;678727;454186;0;63.6;42.6;0.0
76;2021-07-03;3353;8318;0;682080;462504;0;63.9;43.4;0.0
76;2021-07-04;1452;5073;0;683532;467577;0;64.1;43.8;0.0
76;2021-07-05;3655;8941;0;687187;476518;0;64.4;44.7;0.0
76;2021-07-06;3749;9854;0;690936;486372;0;64.8;45.6;0.0
76;2021-07-07;3747;9095;0;694683;495467;0;65.1;46.4;0.0
76;2021-07-08;4220;9308;0;698903;504775;0;65.5;47.3;0.0
76;2021-07-09;4191;12082;0;703094;516857;0;65.9;48.4;0.0
76;2021-07-10;2952;8269;0;706046;525126;0;66.2;49.2;0.0
76;2021-07-11;1660;2751;0;707706;527877;0;66.3;49.5;0.0
76;2021-07-12;2992;10707;0;710698;538584;0;66.6;50.5;0.0
76;2021-07-13;4739;11857;0;715437;550441;0;67.1;51.6;0.0
76;2021-07-14;4282;5046;0;719719;555487;0;67.5;52.1;0.0
76;2021-07-15;5635;11688;0;725354;567175;0;68.0;53.2;0.0
76;2021-07-16;6560;11880;0;731914;579055;0;68.6;54.3;0.0
76;2021-07-17;4878;8480;0;736792;587535;0;69.1;55.1;0.0
76;2021-07-18;2195;3376;0;738987;590911;0;69.3;55.4;0.0
76;2021-07-19;5076;10165;0;744063;601076;0;69.7;56.3;0.0
76;2021-07-20;6284;10567;0;750347;611643;0;70.3;57.3;0.0
76;2021-07-21;6298;9587;0;756645;621230;0;70.9;58.2;0.0
76;2021-07-22;8037;8681;0;764682;629911;0;71.7;59.0;0.0
76;2021-07-23;7482;10587;0;772164;640498;0;72.4;60.0;0.0
76;2021-07-24;4891;6794;0;777055;647292;0;72.8;60.7;0.0
76;2021-07-25;2884;2471;0;779939;649763;0;73.1;60.9;0.0
76;2021-07-26;5299;8893;0;785238;658656;0;73.6;61.7;0.0
76;2021-07-27;8093;8402;0;793331;667058;0;74.4;62.5;0.0
76;2021-07-28;8045;7515;0;801376;674573;0;75.1;63.2;0.0
76;2021-07-29;9046;6638;0;810422;681211;0;76.0;63.9;0.0
76;2021-07-30;7763;7549;0;818185;688760;0;76.7;64.6;0.0
76;2021-07-31;6265;5016;0;824450;693776;0;77.3;65.0;0.0
76;2021-08-01;3645;1962;0;828095;695738;0;77.6;65.2;0.0
76;2021-08-02;6271;6660;0;834366;702398;0;78.2;65.8;0.0
76;2021-08-03;7504;6158;0;841870;708556;0;78.9;66.4;0.0
76;2021-08-04;6854;5593;0;848724;714149;0;79.6;66.9;0.0
76;2021-08-05;7518;5418;0;856242;719567;0;80.3;67.5;0.0
76;2021-08-06;6350;6523;0;862592;726090;0;80.9;68.1;0.0
76;2021-08-07;4337;4166;0;866929;730256;0;81.3;68.5;0.0
76;2021-08-08;2229;1775;0;869158;732031;0;81.5;68.6;0.0
76;2021-08-09;5074;6270;0;874232;738301;0;81.9;69.2;0.0
76;2021-08-10;5773;6359;0;880005;744660;0;82.5;69.8;0.0
76;2021-08-11;5853;5337;0;885858;749997;0;83.0;70.3;0.0
76;2021-08-12;5490;5814;0;891348;755811;0;83.6;70.8;0.0
76;2021-08-13;4572;5951;0;895920;761762;0;84.0;71.4;0.0
76;2021-08-14;3466;4441;0;899386;766203;0;84.3;71.8;0.0
76;2021-08-15;1409;2205;0;900795;768408;0;84.4;72.0;0.0
76;2021-08-16;3332;6327;0;904127;774735;0;84.8;72.6;0.0
76;2021-08-17;3534;6703;0;907661;781438;0;85.1;73.2;0.0
76;2021-08-18;3308;6408;0;910969;787846;0;85.4;73.9;0.0
76;2021-08-19;3059;6809;0;914028;794655;0;85.7;74.5;0.0
76;2021-08-20;3199;7390;0;917227;802045;0;86.0;75.2;0.0
76;2021-08-21;1676;3990;0;918903;806035;0;86.1;75.6;0.0
76;2021-08-22;802;3052;0;919705;809087;0;86.2;75.8;0.0
76;2021-08-23;2362;7201;1;922067;816288;1;86.4;76.5;0.0
76;2021-08-24;2569;7203;1;924636;823491;2;86.7;77.2;0.0
76;2021-08-25;2443;6659;1;927079;830150;3;86.9;77.8;0.0
76;2021-08-26;1907;5530;1;928986;835680;4;87.1;78.3;0.0
76;2021-08-27;2502;7390;0;931488;843070;4;87.3;79.0;0.0
76;2021-08-28;1903;5772;0;933391;848842;4;87.5;79.6;0.0
76;2021-08-29;657;2770;0;934048;851612;4;87.6;79.8;0.0
76;2021-08-30;1945;6668;98;935993;858280;102;87.7;80.5;0.0
76;2021-08-31;1809;6516;193;937802;864796;295;87.9;81.1;0.0
76;2021-09-01;1698;5936;488;939500;870732;783;88.1;81.6;0.1
76;2021-09-02;1239;4176;492;940739;874908;1275;88.2;82.0;0.1
76;2021-09-03;1496;6119;621;942235;881027;1896;88.3;82.6;0.2
76;2021-09-04;1484;5487;346;943719;886514;2242;88.5;83.1;0.2
76;2021-09-05;588;1657;133;944307;888171;2375;88.5;83.3;0.2
76;2021-09-06;1153;3903;717;945460;892074;3092;88.6;83.6;0.3
76;2021-09-07;1075;3428;772;946535;895502;3864;88.7;83.9;0.4
76;2021-09-08;1185;3930;683;947720;899432;4547;88.8;84.3;0.4
76;2021-09-09;983;2695;709;948703;902127;5256;88.9;84.6;0.5
76;2021-09-10;1607;3780;839;950310;905907;6095;89.1;84.9;0.6
76;2021-09-11;1084;2963;405;951394;908870;6500;89.2;85.2;0.6
76;2021-09-12;244;751;66;951638;909621;6566;89.2;85.3;0.6
76;2021-09-13;785;2032;1137;952423;911653;7703;89.3;85.5;0.7
76;2021-09-14;1302;2430;1254;953725;914083;8957;89.4;85.7;0.8
76;2021-09-15;1119;3021;1251;954844;917104;10208;89.5;86.0;1.0
76;2021-09-16;1136;1842;961;955980;918946;11169;89.6;86.1;1.0
76;2021-09-17;1273;2565;1299;957253;921511;12468;89.7;86.4;1.2
76;2021-09-18;666;2294;422;957919;923805;12890;89.8;86.6;1.2
76;2021-09-19;168;704;78;958087;924509;12968;89.8;86.7;1.2
76;2021-09-20;790;1585;857;958877;926094;13825;89.9;86.8;1.3
76;2021-09-21;729;1526;1178;959606;927620;15003;90.0;87.0;1.4
76;2021-09-22;624;2121;984;960230;929741;15987;90.0;87.2;1.5
76;2021-09-23;685;1100;1115;960915;930841;17102;90.1;87.3;1.6
76;2021-09-24;950;1844;1230;961865;932685;18332;90.2;87.4;1.7
76;2021-09-25;556;1953;394;962421;934638;18726;90.2;87.6;1.8
76;2021-09-26;94;378;58;962515;935016;18784;90.2;87.6;1.8
76;2021-09-27;516;1130;883;963031;936146;19667;90.3;87.8;1.8
76;2021-09-28;459;1046;1063;963490;937192;20730;90.3;87.8;1.9
76;2021-09-29;707;1447;955;964197;938639;21685;90.4;88.0;2.0
76;2021-09-30;379;781;704;964576;939420;22389;90.4;88.1;2.1
76;2021-10-01;855;1604;1515;965431;941024;23904;90.5;88.2;2.2
76;2021-10-02;542;1217;379;965973;942241;24283;90.5;88.3;2.3
76;2021-10-03;106;339;119;966079;942580;24402;90.6;88.4;2.3
76;2021-10-04;614;1007;1232;966693;943587;25634;90.6;88.4;2.4
76;2021-10-05;457;960;1185;967150;944547;26819;90.7;88.5;2.5
76;2021-10-06;425;822;963;967575;945369;27782;90.7;88.6;2.6
76;2021-10-07;349;785;1356;967924;946154;29138;90.7;88.7;2.7
76;2021-10-08;840;1717;1875;968764;947871;31013;90.8;88.9;2.9
76;2021-10-09;498;895;740;969262;948766;31753;90.9;88.9;3.0
76;2021-10-10;54;87;74;969316;948853;31827;90.9;88.9;3.0
76;2021-10-11;483;992;1234;969799;949845;33061;90.9;89.0;3.1
76;2021-10-12;446;849;1484;970245;950694;34545;90.9;89.1;3.2
76;2021-10-13;555;975;1454;970800;951669;35999;91.0;89.2;3.4
76;2021-10-14;382;640;1323;971182;952309;37322;91.0;89.3;3.5
76;2021-10-15;737;1243;2479;971919;953552;39801;91.1;89.4;3.7
76;2021-10-16;378;536;573;972297;954088;40374;91.1;89.4;3.8
76;2021-10-17;88;192;218;972385;954280;40592;91.1;89.5;3.8
76;2021-10-18;373;746;1430;972758;955026;42022;91.2;89.5;3.9
76;2021-10-19;450;730;1676;973208;955756;43698;91.2;89.6;4.1
76;2021-10-20;418;622;2172;973626;956378;45870;91.3;89.6;4.3
76;2021-10-21;270;522;1955;973896;956900;47825;91.3;89.7;4.5
76;2021-10-22;592;938;2277;974488;957838;50102;91.3;89.8;4.7
76;2021-10-23;317;503;730;974805;958341;50832;91.4;89.8;4.8
76;2021-10-24;7;30;20;974812;958371;50852;91.4;89.8;4.8
76;2021-10-25;467;675;2406;975279;959046;53258;91.4;89.9;5.0
76;2021-10-26;365;448;2014;975644;959494;55272;91.5;89.9;5.2
76;2021-10-27;343;477;2053;975987;959971;57325;91.5;90.0;5.4
76;2021-10-28;339;414;1887;976326;960385;59212;91.5;90.0;5.6
76;2021-10-29;447;840;3279;976773;961225;62491;91.6;90.1;5.9
76;2021-10-30;316;490;1094;977089;961715;63585;91.6;90.1;6.0
76;2021-10-31;32;32;38;977121;961747;63623;91.6;90.2;6.0
76;2021-11-01;23;19;11;977144;961766;63634;91.6;90.2;6.0
76;2021-11-02;412;575;2165;977556;962341;65799;91.6;90.2;6.2
76;2021-11-03;399;544;2226;977955;962885;68025;91.7;90.3;6.4
76;2021-11-04;345;479;2248;978300;963364;70273;91.7;90.3;6.6
76;2021-11-05;582;796;3675;978882;964160;73948;91.8;90.4;6.9
76;2021-11-06;324;439;1245;979206;964599;75193;91.8;90.4;7.0
76;2021-11-07;8;28;40;979214;964627;75233;91.8;90.4;7.1
76;2021-11-08;286;422;2692;979500;965049;77925;91.8;90.5;7.3
76;2021-11-09;263;427;3400;979763;965476;81325;91.8;90.5;7.6
76;2021-11-10;451;624;4129;980214;966100;85454;91.9;90.6;8.0
76;2021-11-11;10;37;108;980224;966137;85562;91.9;90.6;8.0
76;2021-11-12;457;642;4509;980681;966779;90071;91.9;90.6;8.4
76;2021-11-13;281;372;1456;980962;967151;91527;92.0;90.7;8.6
76;2021-11-14;15;22;66;980977;967173;91593;92.0;90.7;8.6
76;2021-11-15;296;393;3601;981273;967566;95194;92.0;90.7;8.9
76;2021-11-16;319;345;4015;981592;967911;99209;92.0;90.7;9.3
76;2021-11-17;413;503;3757;982005;968414;102966;92.1;90.8;9.7
76;2021-11-18;258;314;3719;982263;968728;106685;92.1;90.8;10.0
76;2021-11-19;541;573;5867;982804;969301;112552;92.1;90.9;10.6
76;2021-11-20;444;498;2455;983248;969799;115007;92.2;90.9;10.8
76;2021-11-21;18;22;70;983266;969821;115077;92.2;90.9;10.8
76;2021-11-22;310;258;4196;983576;970079;119273;92.2;90.9;11.2
76;2021-11-23;371;394;4938;983947;970473;124211;92.2;91.0;11.6
76;2021-11-24;451;464;5007;984398;970937;129218;92.3;91.0;12.1
76;2021-11-25;279;298;5047;984677;971235;134265;92.3;91.0;12.6
76;2021-11-26;447;617;8860;985124;971852;143125;92.3;91.1;13.4
76;2021-11-27;271;418;4988;985395;972270;148113;92.4;91.1;13.9
76;2021-11-28;21;22;914;985416;972292;149027;92.4;91.1;14.0
76;2021-11-29;251;352;8507;985667;972644;157534;92.4;91.2;14.8
76;2021-11-30;313;324;9970;985980;972968;167504;92.4;91.2;15.7
76;2021-12-01;293;407;9192;986273;973375;176696;92.5;91.2;16.6
76;2021-12-02;270;236;11334;986543;973611;188030;92.5;91.3;17.6
76;2021-12-03;332;447;13176;986875;974058;201206;92.5;91.3;18.9
76;2021-12-04;211;345;8118;987086;974403;209324;92.5;91.3;19.6
76;2021-12-05;46;40;2066;987132;974443;211390;92.5;91.3;19.8
76;2021-12-06;248;313;10637;987380;974756;222027;92.6;91.4;20.8
76;2021-12-07;236;324;13112;987616;975080;235139;92.6;91.4;22.0
76;2021-12-08;319;465;12967;987935;975545;248106;92.6;91.4;23.3
76;2021-12-09;307;325;15801;988242;975870;263907;92.6;91.5;24.7
76;2021-12-10;344;579;17982;988586;976449;281889;92.7;91.5;26.4
76;2021-12-11;260;379;11180;988846;976828;293069;92.7;91.6;27.5
76;2021-12-12;68;71;4365;988914;976899;297434;92.7;91.6;27.9
76;2021-12-13;222;350;14054;989136;977249;311488;92.7;91.6;29.2
76;2021-12-14;358;393;16802;989494;977642;328290;92.8;91.6;30.8
76;2021-12-15;354;458;15215;989848;978100;343505;92.8;91.7;32.2
76;2021-12-16;358;391;17013;990206;978491;360518;92.8;91.7;33.8
76;2021-12-17;486;567;19798;990692;979058;380316;92.9;91.8;35.6
76;2021-12-18;298;354;11356;990990;979412;391672;92.9;91.8;36.7
76;2021-12-19;113;96;5065;991103;979508;396737;92.9;91.8;37.2
77;2020-12-27;2;1;0;2;1;0;0.0;0.0;0.0
77;2020-12-28;2;0;0;4;1;0;0.0;0.0;0.0
77;2020-12-29;1;0;0;5;1;0;0.0;0.0;0.0
77;2020-12-30;1;0;0;6;1;0;0.0;0.0;0.0
77;2020-12-31;0;0;0;6;1;0;0.0;0.0;0.0
77;2021-01-01;10;0;0;16;1;0;0.0;0.0;0.0
77;2021-01-02;1;0;0;17;1;0;0.0;0.0;0.0
77;2021-01-03;1;0;0;18;1;0;0.0;0.0;0.0
77;2021-01-04;10;0;0;28;1;0;0.0;0.0;0.0
77;2021-01-05;200;1;0;228;2;0;0.0;0.0;0.0
77;2021-01-06;276;2;0;504;4;0;0.0;0.0;0.0
77;2021-01-07;664;10;0;1168;14;0;0.1;0.0;0.0
77;2021-01-08;735;3;0;1903;17;0;0.2;0.0;0.0
77;2021-01-09;259;1;0;2162;18;0;0.2;0.0;0.0
77;2021-01-10;207;2;0;2369;20;0;0.2;0.0;0.0
77;2021-01-11;881;6;0;3250;26;0;0.3;0.0;0.0
77;2021-01-12;1086;5;0;4336;31;0;0.4;0.0;0.0
77;2021-01-13;1143;8;0;5479;39;0;0.5;0.0;0.0
77;2021-01-14;1136;18;0;6615;57;0;0.6;0.0;0.0
77;2021-01-15;989;18;0;7604;75;0;0.6;0.0;0.0
77;2021-01-16;164;1;0;7768;76;0;0.7;0.0;0.0
77;2021-01-17;109;3;0;7877;79;0;0.7;0.0;0.0
77;2021-01-18;1319;12;0;9196;91;0;0.8;0.0;0.0
77;2021-01-19;1878;28;0;11074;119;0;0.9;0.0;0.0
77;2021-01-20;2600;14;0;13674;133;0;1.2;0.0;0.0
77;2021-01-21;2361;38;0;16035;171;0;1.3;0.0;0.0
77;2021-01-22;1274;9;0;17309;180;0;1.5;0.0;0.0
77;2021-01-23;363;1;0;17672;181;0;1.5;0.0;0.0
77;2021-01-24;45;0;0;17717;181;0;1.5;0.0;0.0
77;2021-01-25;1043;26;0;18760;207;0;1.6;0.0;0.0
77;2021-01-26;1735;31;0;20495;238;0;1.7;0.0;0.0
77;2021-01-27;1493;43;0;21988;281;0;1.9;0.0;0.0
77;2021-01-28;1835;130;0;23823;411;0;2.0;0.0;0.0
77;2021-01-29;1366;177;0;25189;588;0;2.1;0.0;0.0
77;2021-01-30;266;5;0;25455;593;0;2.1;0.0;0.0
77;2021-01-31;5;2;0;25460;595;0;2.1;0.1;0.0
77;2021-02-01;687;226;0;26147;821;0;2.2;0.1;0.0
77;2021-02-02;878;341;0;27025;1162;0;2.3;0.1;0.0
77;2021-02-03;864;596;0;27889;1758;0;2.3;0.1;0.0
77;2021-02-04;866;890;0;28755;2648;0;2.4;0.2;0.0
77;2021-02-05;918;859;0;29673;3507;0;2.5;0.3;0.0
77;2021-02-06;201;102;0;29874;3609;0;2.5;0.3;0.0
77;2021-02-07;19;77;0;29893;3686;0;2.5;0.3;0.0
77;2021-02-08;474;998;0;30367;4684;0;2.6;0.4;0.0
77;2021-02-09;718;1561;0;31085;6245;0;2.6;0.5;0.0
77;2021-02-10;1097;1934;0;32182;8179;0;2.7;0.7;0.0
77;2021-02-11;1184;1842;0;33366;10021;0;2.8;0.8;0.0
77;2021-02-12;1201;1268;0;34567;11289;0;2.9;1.0;0.0
77;2021-02-13;230;181;0;34797;11470;0;2.9;1.0;0.0
77;2021-02-14;15;55;0;34812;11525;0;2.9;1.0;0.0
77;2021-02-15;603;1073;0;35415;12598;0;3.0;1.1;0.0
77;2021-02-16;691;1683;0;36106;14281;0;3.0;1.2;0.0
77;2021-02-17;662;1380;0;36768;15661;0;3.1;1.3;0.0
77;2021-02-18;998;1689;0;37766;17350;0;3.2;1.5;0.0
77;2021-02-19;933;1178;0;38699;18528;0;3.3;1.6;0.0
77;2021-02-20;97;257;0;38796;18785;0;3.3;1.6;0.0
77;2021-02-21;12;36;0;38808;18821;0;3.3;1.6;0.0
77;2021-02-22;388;900;0;39196;19721;0;3.3;1.7;0.0
77;2021-02-23;474;1193;0;39670;20914;0;3.3;1.8;0.0
77;2021-02-24;614;1046;0;40284;21960;0;3.4;1.8;0.0
77;2021-02-25;912;1171;0;41196;23131;0;3.5;1.9;0.0
77;2021-02-26;1000;935;0;42196;24066;0;3.6;2.0;0.0
77;2021-02-27;533;227;0;42729;24293;0;3.6;2.0;0.0
77;2021-02-28;36;15;0;42765;24308;0;3.6;2.0;0.0
77;2021-03-01;810;796;0;43575;25104;0;3.7;2.1;0.0
77;2021-03-02;1228;1026;0;44803;26130;0;3.8;2.2;0.0
77;2021-03-03;2099;1222;0;46902;27352;0;3.9;2.3;0.0
77;2021-03-04;3086;1245;0;49988;28597;0;4.2;2.4;0.0
77;2021-03-05;3767;1073;0;53755;29670;0;4.5;2.5;0.0
77;2021-03-06;5018;299;0;58773;29969;0;4.9;2.5;0.0
77;2021-03-07;3456;183;0;62229;30152;0;5.2;2.5;0.0
77;2021-03-08;1509;607;0;63738;30759;0;5.4;2.6;0.0
77;2021-03-09;2747;729;0;66485;31488;0;5.6;2.7;0.0
77;2021-03-10;2732;703;0;69217;32191;0;5.8;2.7;0.0
77;2021-03-11;3963;879;0;73180;33070;0;6.2;2.8;0.0
77;2021-03-12;4364;821;0;77544;33891;0;6.5;2.9;0.0
77;2021-03-13;4635;251;0;82179;34142;0;6.9;2.9;0.0
77;2021-03-14;2112;115;0;84291;34257;0;7.1;2.9;0.0
77;2021-03-15;2788;383;0;87079;34640;0;7.3;2.9;0.0
77;2021-03-16;2672;437;0;89751;35077;0;7.6;3.0;0.0
77;2021-03-17;2646;462;0;92397;35539;0;7.8;3.0;0.0
77;2021-03-18;3236;457;0;95633;35996;0;8.0;3.0;0.0
77;2021-03-19;3582;483;0;99215;36479;0;8.4;3.1;0.0
77;2021-03-20;2393;125;0;101608;36604;0;8.6;3.1;0.0
77;2021-03-21;452;62;0;102060;36666;0;8.6;3.1;0.0
77;2021-03-22;3255;465;0;105315;37131;0;8.9;3.1;0.0
77;2021-03-23;4885;653;0;110200;37784;0;9.3;3.2;0.0
77;2021-03-24;4623;649;0;114823;38433;0;9.7;3.2;0.0
77;2021-03-25;6424;547;0;121247;38980;0;10.2;3.3;0.0
77;2021-03-26;6820;558;0;128067;39538;0;10.8;3.3;0.0
77;2021-03-27;3997;208;0;132064;39746;0;11.1;3.3;0.0
77;2021-03-28;1878;72;0;133942;39818;0;11.3;3.4;0.0
77;2021-03-29;3293;841;0;137235;40659;0;11.6;3.4;0.0
77;2021-03-30;4699;1319;0;141934;41978;0;11.9;3.5;0.0
77;2021-03-31;4373;1289;0;146307;43267;0;12.3;3.6;0.0
77;2021-04-01;5065;2047;0;151372;45314;0;12.7;3.8;0.0
77;2021-04-02;4738;2206;0;156110;47520;0;13.1;4.0;0.0
77;2021-04-03;2266;2320;0;158376;49840;0;13.3;4.2;0.0
77;2021-04-04;739;1424;0;159115;51264;0;13.4;4.3;0.0
77;2021-04-05;597;184;0;159712;51448;0;13.4;4.3;0.0
77;2021-04-06;3452;2075;0;163164;53523;0;13.7;4.5;0.0
77;2021-04-07;4230;2259;0;167394;55782;0;14.1;4.7;0.0
77;2021-04-08;5650;2522;0;173044;58304;0;14.6;4.9;0.0
77;2021-04-09;5993;2208;0;179037;60512;0;15.1;5.1;0.0
77;2021-04-10;3738;2809;0;182775;63321;0;15.4;5.3;0.0
77;2021-04-11;941;838;0;183716;64159;0;15.5;5.4;0.0
77;2021-04-12;3009;2047;0;186725;66206;0;15.7;5.6;0.0
77;2021-04-13;4337;3068;0;191062;69274;0;16.1;5.8;0.0
77;2021-04-14;3417;2715;0;194479;71989;0;16.4;6.1;0.0
77;2021-04-15;4466;3292;0;198945;75281;0;16.7;6.3;0.0
77;2021-04-16;4476;2857;0;203421;78138;0;17.1;6.6;0.0
77;2021-04-17;2214;891;0;205635;79029;0;17.3;6.7;0.0
77;2021-04-18;403;213;0;206038;79242;0;17.3;6.7;0.0
77;2021-04-19;2877;2671;0;208915;81913;0;17.6;6.9;0.0
77;2021-04-20;3269;3638;0;212184;85551;0;17.9;7.2;0.0
77;2021-04-21;3091;3694;0;215275;89245;0;18.1;7.5;0.0
77;2021-04-22;4080;4245;0;219355;93490;0;18.5;7.9;0.0
77;2021-04-23;4615;4069;0;223970;97559;0;18.9;8.2;0.0
77;2021-04-24;6054;3034;0;230024;100593;0;19.4;8.5;0.0
77;2021-04-25;4618;1420;0;234642;102013;0;19.8;8.6;0.0
77;2021-04-26;4130;2544;0;238772;104557;0;20.1;8.8;0.0
77;2021-04-27;5165;3110;0;243937;107667;0;20.5;9.1;0.0
77;2021-04-28;5288;3174;0;249225;110841;0;21.0;9.3;0.0
77;2021-04-29;5998;3715;0;255223;114556;0;21.5;9.6;0.0
77;2021-04-30;6501;3946;0;261724;118502;0;22.0;10.0;0.0
77;2021-05-01;3631;933;0;265355;119435;0;22.3;10.1;0.0
77;2021-05-02;3498;662;0;268853;120097;0;22.6;10.1;0.0
77;2021-05-03;7134;3357;0;275987;123454;0;23.2;10.4;0.0
77;2021-05-04;7598;3800;0;283585;127254;0;23.9;10.7;0.0
77;2021-05-05;7104;3845;0;290689;131099;0;24.5;11.0;0.0
77;2021-05-06;8178;4344;0;298867;135443;0;25.2;11.4;0.0
77;2021-05-07;9237;4242;0;308104;139685;0;25.9;11.8;0.0
77;2021-05-08;6844;1513;0;314948;141198;0;26.5;11.9;0.0
77;2021-05-09;5315;1044;0;320263;142242;0;27.0;12.0;0.0
77;2021-05-10;8731;3075;0;328994;145317;0;27.7;12.2;0.0
77;2021-05-11;10092;3789;0;339086;149106;0;28.5;12.6;0.0
77;2021-05-12;9503;3037;0;348589;152143;0;29.3;12.8;0.0
77;2021-05-13;9531;1151;0;358120;153294;0;30.1;12.9;0.0
77;2021-05-14;10775;2158;0;368895;155452;0;31.1;13.1;0.0
77;2021-05-15;9254;1616;0;378149;157068;0;31.8;13.2;0.0
77;2021-05-16;5049;579;0;383198;157647;0;32.3;13.3;0.0
77;2021-05-17;10089;1784;0;393287;159431;0;33.1;13.4;0.0
77;2021-05-18;11621;2140;0;404908;161571;0;34.1;13.6;0.0
77;2021-05-19;10629;2190;0;415537;163761;0;35.0;13.8;0.0
77;2021-05-20;11949;2827;0;427486;166588;0;36.0;14.0;0.0
77;2021-05-21;11426;3030;0;438912;169618;0;36.9;14.3;0.0
77;2021-05-22;9510;1849;0;448422;171467;0;37.7;14.4;0.0
77;2021-05-23;6324;834;0;454746;172301;0;38.3;14.5;0.0
77;2021-05-24;6729;874;0;461475;173175;0;38.8;14.6;0.0
77;2021-05-25;8261;3410;0;469736;176585;0;39.5;14.9;0.0
77;2021-05-26;7857;3391;0;477593;179976;0;40.2;15.1;0.0
77;2021-05-27;8028;4547;0;485621;184523;0;40.9;15.5;0.0
77;2021-05-28;8061;4720;0;493682;189243;0;41.6;15.9;0.0
77;2021-05-29;7345;2888;0;501027;192131;0;42.2;16.2;0.0
77;2021-05-30;4201;1059;0;505228;193190;0;42.5;16.3;0.0
77;2021-05-31;7818;4473;0;513046;197663;0;43.2;16.6;0.0
77;2021-06-01;9191;5185;0;522237;202848;0;44.0;17.1;0.0
77;2021-06-02;8671;4622;0;530908;207470;0;44.7;17.5;0.0
77;2021-06-03;8688;6175;0;539596;213645;0;45.4;18.0;0.0
77;2021-06-04;9066;6556;0;548662;220201;0;46.2;18.5;0.0
77;2021-06-05;6408;5976;0;555070;226177;0;46.7;19.0;0.0
77;2021-06-06;4367;3226;0;559437;229403;0;47.1;19.3;0.0
77;2021-06-07;6307;5537;0;565744;234940;0;47.6;19.8;0.0
77;2021-06-08;5934;6243;0;571678;241183;0;48.1;20.3;0.0
77;2021-06-09;5313;6128;0;576991;247311;0;48.6;20.8;0.0
77;2021-06-10;5360;7447;0;582351;254758;0;49.0;21.4;0.0
77;2021-06-11;5990;7281;0;588341;262039;0;49.5;22.1;0.0
77;2021-06-12;6214;5794;0;594555;267833;0;50.0;22.5;0.0
77;2021-06-13;3266;3253;0;597821;271086;0;50.3;22.8;0.0
77;2021-06-14;3605;9135;0;601426;280221;0;50.6;23.6;0.0
77;2021-06-15;4539;9742;0;605965;289963;0;51.0;24.4;0.0
77;2021-06-16;5043;9256;0;611008;299219;0;51.4;25.2;0.0
77;2021-06-17;4830;9880;0;615838;309099;0;51.8;26.0;0.0
77;2021-06-18;4755;11026;0;620593;320125;0;52.2;26.9;0.0
77;2021-06-19;5100;8056;0;625693;328181;0;52.7;27.6;0.0
77;2021-06-20;2167;4297;0;627860;332478;0;52.8;28.0;0.0
77;2021-06-21;3337;10106;0;631197;342584;0;53.1;28.8;0.0
77;2021-06-22;3875;11785;0;635072;354369;0;53.5;29.8;0.0
77;2021-06-23;3741;10622;0;638813;364991;0;53.8;30.7;0.0
77;2021-06-24;3755;11332;0;642568;376323;0;54.1;31.7;0.0
77;2021-06-25;3782;11485;0;646350;387808;0;54.4;32.6;0.0
77;2021-06-26;3905;10569;0;650255;398377;0;54.7;33.5;0.0
77;2021-06-27;2033;6111;0;652288;404488;0;54.9;34.0;0.0
77;2021-06-28;2885;10905;0;655173;415393;0;55.1;35.0;0.0
77;2021-06-29;3596;12622;0;658769;428015;0;55.4;36.0;0.0
77;2021-06-30;3557;11523;0;662326;439538;0;55.7;37.0;0.0
77;2021-07-01;3884;11607;0;666210;451145;0;56.1;38.0;0.0
77;2021-07-02;4141;12403;0;670351;463548;0;56.4;39.0;0.0
77;2021-07-03;3378;10716;0;673729;474264;0;56.7;39.9;0.0
77;2021-07-04;1975;6087;0;675704;480351;0;56.9;40.4;0.0
77;2021-07-05;3791;9661;0;679495;490012;0;57.2;41.2;0.0
77;2021-07-06;3981;9893;0;683476;499905;0;57.5;42.1;0.0
77;2021-07-07;4259;9465;2;687735;509370;2;57.9;42.9;0.0
77;2021-07-08;4446;9482;0;692181;518852;2;58.3;43.7;0.0
77;2021-07-09;5091;10879;0;697272;529731;2;58.7;44.6;0.0
77;2021-07-10;4080;9948;0;701352;539679;2;59.0;45.4;0.0
77;2021-07-11;2866;4921;0;704218;544600;2;59.3;45.8;0.0
77;2021-07-12;3641;10654;0;707859;555254;2;59.6;46.7;0.0
77;2021-07-13;6876;12184;0;714735;567438;2;60.2;47.8;0.0
77;2021-07-14;4172;6241;0;718907;573679;2;60.5;48.3;0.0
77;2021-07-15;8281;12437;0;727188;586116;2;61.2;49.3;0.0
77;2021-07-16;8889;10625;0;736077;596741;2;62.0;50.2;0.0
77;2021-07-17;6538;9532;0;742615;606273;2;62.5;51.0;0.0
77;2021-07-18;4108;5042;0;746723;611315;2;62.9;51.5;0.0
77;2021-07-19;7876;9346;0;754599;620661;2;63.5;52.2;0.0
77;2021-07-20;10285;8989;0;764884;629650;2;64.4;53.0;0.0
77;2021-07-21;10219;8358;0;775103;638008;2;65.2;53.7;0.0
77;2021-07-22;11207;8426;0;786310;646434;2;66.2;54.4;0.0
77;2021-07-23;10690;9149;0;797000;655583;2;67.1;55.2;0.0
77;2021-07-24;7586;8132;0;804586;663715;2;67.7;55.9;0.0
77;2021-07-25;5342;3898;0;809928;667613;2;68.2;56.2;0.0
77;2021-07-26;9121;6582;0;819049;674195;2;68.9;56.7;0.0
77;2021-07-27;10909;6596;0;829958;680791;2;69.9;57.3;0.0
77;2021-07-28;9920;7048;0;839878;687839;2;70.7;57.9;0.0
77;2021-07-29;9800;6160;0;849678;693999;2;71.5;58.4;0.0
77;2021-07-30;9868;6958;0;859546;700957;2;72.3;59.0;0.0
77;2021-07-31;6993;6656;0;866539;707613;2;72.9;59.6;0.0
77;2021-08-01;2864;1433;0;869403;709046;2;73.2;59.7;0.0
77;2021-08-02;7374;6144;0;876777;715190;2;73.8;60.2;0.0
77;2021-08-03;6351;5435;0;883128;720625;2;74.3;60.7;0.0
77;2021-08-04;5399;5272;0;888527;725897;2;74.8;61.1;0.0
77;2021-08-05;3917;4073;0;892444;729970;2;75.1;61.4;0.0
77;2021-08-06;6226;6119;0;898670;736089;2;75.6;62.0;0.0
77;2021-08-07;5245;6988;0;903915;743077;2;76.1;62.5;0.0
77;2021-08-08;1939;2136;0;905854;745213;2;76.2;62.7;0.0
77;2021-08-09;5366;7407;0;911220;752620;2;76.7;63.3;0.0
77;2021-08-10;3526;5116;0;914746;757736;2;77.0;63.8;0.0
77;2021-08-11;3613;7180;0;918359;764916;2;77.3;64.4;0.0
77;2021-08-12;3035;4961;0;921394;769877;2;77.6;64.8;0.0
77;2021-08-13;3277;6011;0;924671;775888;2;77.8;65.3;0.0
77;2021-08-14;3012;7527;0;927683;783415;2;78.1;65.9;0.0
77;2021-08-15;817;941;0;928500;784356;2;78.2;66.0;0.0
77;2021-08-16;2812;7821;0;931312;792177;2;78.4;66.7;0.0
77;2021-08-17;3295;8018;0;934607;800195;2;78.7;67.4;0.0
77;2021-08-18;2980;7295;0;937587;807490;2;78.9;68.0;0.0
77;2021-08-19;2944;6146;0;940531;813636;2;79.2;68.5;0.0
77;2021-08-20;2970;6636;0;943501;820272;2;79.4;69.0;0.0
77;2021-08-21;2691;7318;0;946192;827590;2;79.6;69.7;0.0
77;2021-08-22;1611;4854;0;947803;832444;2;79.8;70.1;0.0
77;2021-08-23;2584;9605;0;950387;842049;2;80.0;70.9;0.0
77;2021-08-24;3191;9316;0;953578;851365;2;80.3;71.7;0.0
77;2021-08-25;2721;6928;0;956299;858293;2;80.5;72.2;0.0
77;2021-08-26;2719;6571;0;959018;864864;2;80.7;72.8;0.0
77;2021-08-27;2895;7538;1;961913;872402;3;81.0;73.4;0.0
77;2021-08-28;2111;7337;0;964024;879739;3;81.1;74.0;0.0
77;2021-08-29;1438;4717;0;965462;884456;3;81.3;74.4;0.0
77;2021-08-30;2690;8262;112;968152;892718;115;81.5;75.1;0.0
77;2021-08-31;2912;6073;153;971064;898791;268;81.7;75.7;0.0
77;2021-09-01;2712;4250;346;973776;903041;614;82.0;76.0;0.1
77;2021-09-02;1918;3248;372;975694;906289;986;82.1;76.3;0.1
77;2021-09-03;2274;4592;470;977968;910881;1456;82.3;76.7;0.1
77;2021-09-04;2517;5782;201;980485;916663;1657;82.5;77.2;0.1
77;2021-09-05;867;1439;183;981352;918102;1840;82.6;77.3;0.2
77;2021-09-06;1286;2504;467;982638;920606;2307;82.7;77.5;0.2
77;2021-09-07;1151;2509;363;983789;923115;2670;82.8;77.7;0.2
77;2021-09-08;1844;3152;528;985633;926267;3198;83.0;78.0;0.3
77;2021-09-09;1136;2251;459;986769;928518;3657;83.1;78.2;0.3
77;2021-09-10;1432;2630;412;988201;931148;4069;83.2;78.4;0.3
77;2021-09-11;1965;5328;328;990166;936476;4397;83.3;78.8;0.4
77;2021-09-12;548;1377;72;990714;937853;4469;83.4;78.9;0.4
77;2021-09-13;1199;2027;661;991913;939880;5130;83.5;79.1;0.4
77;2021-09-14;1209;2009;647;993122;941889;5777;83.6;79.3;0.5
77;2021-09-15;1310;2668;896;994432;944557;6673;83.7;79.5;0.6
77;2021-09-16;1065;1802;979;995497;946359;7652;83.8;79.7;0.6
77;2021-09-17;1310;2334;681;996807;948693;8333;83.9;79.9;0.7
77;2021-09-18;1340;3736;329;998147;952429;8662;84.0;80.2;0.7
77;2021-09-19;254;1177;87;998401;953606;8749;84.0;80.3;0.7
77;2021-09-20;942;1837;712;999343;955443;9461;84.1;80.4;0.8
77;2021-09-21;894;1662;944;1000237;957105;10405;84.2;80.6;0.9
77;2021-09-22;877;2685;933;1001114;959790;11338;84.3;80.8;1.0
77;2021-09-23;633;1552;662;1001747;961342;12000;84.3;80.9;1.0
77;2021-09-24;885;1990;771;1002632;963332;12771;84.4;81.1;1.1
77;2021-09-25;1017;3908;519;1003649;967240;13290;84.5;81.4;1.1
77;2021-09-26;251;862;121;1003900;968102;13411;84.5;81.5;1.1
77;2021-09-27;744;1433;770;1004644;969535;14181;84.6;81.6;1.2
77;2021-09-28;809;1058;574;1005453;970593;14755;84.6;81.7;1.2
77;2021-09-29;1016;1870;1032;1006469;972463;15787;84.7;81.9;1.3
77;2021-09-30;698;1087;651;1007167;973550;16438;84.8;81.9;1.4
77;2021-10-01;1216;1300;760;1008383;974850;17198;84.9;82.1;1.4
77;2021-10-02;1184;2193;610;1009567;977043;17808;85.0;82.2;1.5
77;2021-10-03;181;504;91;1009748;977547;17899;85.0;82.3;1.5
77;2021-10-04;661;931;869;1010409;978478;18768;85.0;82.4;1.6
77;2021-10-05;512;935;743;1010921;979413;19511;85.1;82.4;1.6
77;2021-10-06;704;1416;966;1011625;980829;20477;85.2;82.6;1.7
77;2021-10-07;518;876;829;1012143;981705;21306;85.2;82.6;1.8
77;2021-10-08;852;1405;1103;1012995;983110;22409;85.3;82.7;1.9
77;2021-10-09;929;1963;986;1013924;985073;23395;85.3;82.9;2.0
77;2021-10-10;101;154;43;1014025;985227;23438;85.4;82.9;2.0
77;2021-10-11;715;989;1165;1014740;986216;24603;85.4;83.0;2.1
77;2021-10-12;595;995;1380;1015335;987211;25983;85.5;83.1;2.2
77;2021-10-13;826;1081;1486;1016161;988292;27469;85.5;83.2;2.3
77;2021-10-14;513;830;1153;1016674;989122;28622;85.6;83.3;2.4
77;2021-10-15;765;1201;1440;1017439;990323;30062;85.6;83.4;2.5
77;2021-10-16;914;1298;951;1018353;991621;31013;85.7;83.5;2.6
77;2021-10-17;81;123;54;1018434;991744;31067;85.7;83.5;2.6
77;2021-10-18;582;858;1421;1019016;992602;32488;85.8;83.5;2.7
77;2021-10-19;457;892;1159;1019473;993494;33647;85.8;83.6;2.8
77;2021-10-20;624;1134;1820;1020097;994628;35467;85.9;83.7;3.0
77;2021-10-21;416;682;1370;1020513;995310;36837;85.9;83.8;3.1
77;2021-10-22;668;1100;2038;1021181;996410;38875;86.0;83.9;3.3
77;2021-10-23;800;1243;1400;1021981;997653;40275;86.0;84.0;3.4
77;2021-10-24;39;100;38;1022020;997753;40313;86.0;84.0;3.4
77;2021-10-25;481;661;1411;1022501;998414;41724;86.1;84.0;3.5
77;2021-10-26;348;444;1041;1022849;998858;42765;86.1;84.1;3.6
77;2021-10-27;494;700;2143;1023343;999558;44908;86.1;84.1;3.8
77;2021-10-28;374;555;1294;1023717;1000113;46202;86.2;84.2;3.9
77;2021-10-29;546;787;1752;1024263;1000900;47954;86.2;84.2;4.0
77;2021-10-30;568;900;1392;1024831;1001800;49346;86.3;84.3;4.2
77;2021-10-31;42;89;30;1024873;1001889;49376;86.3;84.3;4.2
77;2021-11-01;149;126;213;1025022;1002015;49589;86.3;84.3;4.2
77;2021-11-02;351;585;1262;1025373;1002600;50851;86.3;84.4;4.3
77;2021-11-03;487;786;1899;1025860;1003386;52750;86.3;84.5;4.4
77;2021-11-04;337;578;1708;1026197;1003964;54458;86.4;84.5;4.6
77;2021-11-05;542;694;2129;1026739;1004658;56587;86.4;84.6;4.8
77;2021-11-06;624;1097;1748;1027363;1005755;58335;86.5;84.7;4.9
77;2021-11-07;32;73;33;1027395;1005828;58368;86.5;84.7;4.9
77;2021-11-08;386;629;2548;1027781;1006457;60916;86.5;84.7;5.1
77;2021-11-09;300;501;2117;1028081;1006958;63033;86.5;84.8;5.3
77;2021-11-10;503;729;3100;1028584;1007687;66133;86.6;84.8;5.6
77;2021-11-11;56;110;393;1028640;1007797;66526;86.6;84.8;5.6
77;2021-11-12;539;723;3103;1029179;1008520;69629;86.6;84.9;5.9
77;2021-11-13;652;1003;2214;1029831;1009523;71843;86.7;85.0;6.0
77;2021-11-14;32;79;119;1029863;1009602;71962;86.7;85.0;6.1
77;2021-11-15;350;461;2562;1030213;1010063;74524;86.7;85.0;6.3
77;2021-11-16;376;431;2973;1030589;1010494;77497;86.7;85.1;6.5
77;2021-11-17;452;625;2708;1031041;1011119;80205;86.8;85.1;6.8
77;2021-11-18;354;463;2969;1031395;1011582;83174;86.8;85.1;7.0
77;2021-11-19;547;605;3453;1031942;1012187;86627;86.9;85.2;7.3
77;2021-11-20;831;1096;3077;1032773;1013283;89704;86.9;85.3;7.6
77;2021-11-21;54;88;306;1032827;1013371;90010;86.9;85.3;7.6
77;2021-11-22;442;477;3211;1033269;1013848;93221;87.0;85.3;7.8
77;2021-11-23;314;400;2588;1033583;1014248;95809;87.0;85.4;8.1
77;2021-11-24;517;690;3636;1034100;1014938;99445;87.0;85.4;8.4
77;2021-11-25;387;443;3705;1034487;1015381;103150;87.1;85.5;8.7
77;2021-11-26;567;621;6425;1035054;1016002;109575;87.1;85.5;9.2
77;2021-11-27;695;862;6182;1035749;1016864;115757;87.2;85.6;9.7
77;2021-11-28;63;98;765;1035812;1016962;116522;87.2;85.6;9.8
77;2021-11-29;278;399;6263;1036090;1017361;122785;87.2;85.6;10.3
77;2021-11-30;355;452;8251;1036445;1017813;131036;87.2;85.7;11.0
77;2021-12-01;393;572;9067;1036838;1018385;140103;87.3;85.7;11.8
77;2021-12-02;322;391;10094;1037160;1018776;150197;87.3;85.8;12.6
77;2021-12-03;339;523;10962;1037499;1019299;161159;87.3;85.8;13.6
77;2021-12-04;476;790;8962;1037975;1020089;170121;87.4;85.9;14.3
77;2021-12-05;92;114;2128;1038067;1020203;172249;87.4;85.9;14.5
77;2021-12-06;318;508;10596;1038385;1020711;182845;87.4;85.9;15.4
77;2021-12-07;378;488;14265;1038763;1021199;197110;87.4;86.0;16.6
77;2021-12-08;462;570;14086;1039225;1021769;211196;87.5;86.0;17.8
77;2021-12-09;408;498;15274;1039633;1022267;226470;87.5;86.0;19.1
77;2021-12-10;420;645;16995;1040053;1022912;243465;87.5;86.1;20.5
77;2021-12-11;503;789;14835;1040556;1023701;258300;87.6;86.2;21.7
77;2021-12-12;240;212;7454;1040796;1023913;265754;87.6;86.2;22.4
77;2021-12-13;337;498;12657;1041133;1024411;278411;87.6;86.2;23.4
77;2021-12-14;403;500;15496;1041536;1024911;293907;87.7;86.3;24.7
77;2021-12-15;459;554;14581;1041995;1025465;308488;87.7;86.3;26.0
77;2021-12-16;430;526;15826;1042425;1025991;324314;87.7;86.4;27.3
77;2021-12-17;458;699;16941;1042883;1026690;341255;87.8;86.4;28.7
77;2021-12-18;638;861;15080;1043521;1027551;356335;87.8;86.5;30.0
77;2021-12-19;234;178;5470;1043755;1027729;361805;87.9;86.5;30.5
78;2020-12-27;4;0;0;4;0;0;0.0;0.0;0.0
78;2020-12-28;0;0;0;4;0;0;0.0;0.0;0.0
78;2020-12-29;2;0;0;6;0;0;0.0;0.0;0.0
78;2020-12-30;6;0;0;12;0;0;0.0;0.0;0.0
78;2020-12-31;12;0;0;24;0;0;0.0;0.0;0.0
78;2021-01-01;7;0;0;31;0;0;0.0;0.0;0.0
78;2021-01-02;1;0;0;32;0;0;0.0;0.0;0.0
78;2021-01-03;5;0;0;37;0;0;0.0;0.0;0.0
78;2021-01-04;122;3;0;159;3;0;0.0;0.0;0.0
78;2021-01-05;221;1;0;380;4;0;0.0;0.0;0.0
78;2021-01-06;262;5;0;642;9;0;0.1;0.0;0.0
78;2021-01-07;517;3;0;1159;12;0;0.1;0.0;0.0
78;2021-01-08;704;5;0;1863;17;0;0.2;0.0;0.0
78;2021-01-09;78;1;0;1941;18;0;0.2;0.0;0.0
78;2021-01-10;49;1;0;1990;19;0;0.2;0.0;0.0
78;2021-01-11;909;8;0;2899;27;0;0.2;0.0;0.0
78;2021-01-12;1074;7;0;3973;34;0;0.3;0.0;0.0
78;2021-01-13;964;12;0;4937;46;0;0.4;0.0;0.0
78;2021-01-14;1080;19;0;6017;65;0;0.5;0.0;0.0
78;2021-01-15;1025;9;0;7042;74;0;0.6;0.0;0.0
78;2021-01-16;108;2;0;7150;76;0;0.6;0.0;0.0
78;2021-01-17;80;0;0;7230;76;0;0.6;0.0;0.0
78;2021-01-18;1552;13;0;8782;89;0;0.7;0.0;0.0
78;2021-01-19;2024;23;0;10806;112;0;0.9;0.0;0.0
78;2021-01-20;2045;17;0;12851;129;0;1.1;0.0;0.0
78;2021-01-21;3491;27;0;16342;156;0;1.3;0.0;0.0
78;2021-01-22;2526;25;0;18868;181;0;1.5;0.0;0.0
78;2021-01-23;454;0;0;19322;181;0;1.6;0.0;0.0
78;2021-01-24;74;2;0;19396;183;0;1.6;0.0;0.0
78;2021-01-25;1151;33;0;20547;216;0;1.7;0.0;0.0
78;2021-01-26;1738;39;0;22285;255;0;1.8;0.0;0.0
78;2021-01-27;2320;73;0;24605;328;0;2.0;0.0;0.0
78;2021-01-28;2868;137;0;27473;465;0;2.3;0.0;0.0
78;2021-01-29;1870;103;0;29343;568;0;2.4;0.0;0.0
78;2021-01-30;359;9;0;29702;577;0;2.4;0.0;0.0
78;2021-01-31;33;4;0;29735;581;0;2.4;0.0;0.0
78;2021-02-01;974;262;0;30709;843;0;2.5;0.1;0.0
78;2021-02-02;1191;372;0;31900;1215;0;2.6;0.1;0.0
78;2021-02-03;1202;324;0;33102;1539;0;2.7;0.1;0.0
78;2021-02-04;1374;526;0;34476;2065;0;2.8;0.2;0.0
78;2021-02-05;1346;581;0;35822;2646;0;2.9;0.2;0.0
78;2021-02-06;302;58;0;36124;2704;0;3.0;0.2;0.0
78;2021-02-07;104;34;0;36228;2738;0;3.0;0.2;0.0
78;2021-02-08;841;735;0;37069;3473;0;3.0;0.3;0.0
78;2021-02-09;1260;1193;0;38329;4666;0;3.1;0.4;0.0
78;2021-02-10;1415;1365;0;39744;6031;0;3.3;0.5;0.0
78;2021-02-11;1958;2088;0;41702;8119;0;3.4;0.7;0.0
78;2021-02-12;1953;1481;0;43655;9600;0;3.6;0.8;0.0
78;2021-02-13;196;154;0;43851;9754;0;3.6;0.8;0.0
78;2021-02-14;43;67;0;43894;9821;0;3.6;0.8;0.0
78;2021-02-15;516;1626;0;44410;11447;0;3.6;0.9;0.0
78;2021-02-16;681;1983;0;45091;13430;0;3.7;1.1;0.0
78;2021-02-17;726;2395;0;45817;15825;0;3.8;1.3;0.0
78;2021-02-18;1159;2633;0;46976;18458;0;3.9;1.5;0.0
78;2021-02-19;1015;2010;0;47991;20468;0;3.9;1.7;0.0
78;2021-02-20;174;275;0;48165;20743;0;4.0;1.7;0.0
78;2021-02-21;16;54;0;48181;20797;0;4.0;1.7;0.0
78;2021-02-22;605;1295;0;48786;22092;0;4.0;1.8;0.0
78;2021-02-23;699;1331;0;49485;23423;0;4.1;1.9;0.0
78;2021-02-24;735;1502;0;50220;24925;0;4.1;2.0;0.0
78;2021-02-25;1067;1609;0;51287;26534;0;4.2;2.2;0.0
78;2021-02-26;1421;1473;0;52708;28007;0;4.3;2.3;0.0
78;2021-02-27;825;274;0;53533;28281;0;4.4;2.3;0.0
78;2021-02-28;117;48;0;53650;28329;0;4.4;2.3;0.0
78;2021-03-01;1156;1107;0;54806;29436;0;4.5;2.4;0.0
78;2021-03-02;2035;1274;0;56841;30710;0;4.7;2.5;0.0
78;2021-03-03;2284;1443;0;59125;32153;0;4.9;2.6;0.0
78;2021-03-04;3568;1821;0;62693;33974;0;5.1;2.8;0.0
78;2021-03-05;4090;1867;0;66783;35841;0;5.5;2.9;0.0
78;2021-03-06;7016;384;0;73799;36225;0;6.1;3.0;0.0
78;2021-03-07;4421;221;0;78220;36446;0;6.4;3.0;0.0
78;2021-03-08;1974;929;0;80194;37375;0;6.6;3.1;0.0
78;2021-03-09;3625;1088;0;83819;38463;0;6.9;3.2;0.0
78;2021-03-10;3705;1293;0;87524;39756;0;7.2;3.3;0.0
78;2021-03-11;4975;1536;0;92499;41292;0;7.6;3.4;0.0
78;2021-03-12;6187;1591;0;98686;42883;0;8.1;3.5;0.0
78;2021-03-13;5418;316;0;104104;43199;0;8.5;3.5;0.0
78;2021-03-14;1522;73;0;105626;43272;0;8.7;3.6;0.0
78;2021-03-15;4102;380;0;109728;43652;0;9.0;3.6;0.0
78;2021-03-16;3172;616;0;112900;44268;0;9.3;3.6;0.0
78;2021-03-17;3479;545;0;116379;44813;0;9.6;3.7;0.0
78;2021-03-18;4578;550;0;120957;45363;0;9.9;3.7;0.0
78;2021-03-19;6153;617;0;127110;45980;0;10.4;3.8;0.0
78;2021-03-20;2803;160;0;129913;46140;0;10.7;3.8;0.0
78;2021-03-21;310;39;0;130223;46179;0;10.7;3.8;0.0
78;2021-03-22;3891;508;0;134114;46687;0;11.0;3.8;0.0
78;2021-03-23;5787;698;0;139901;47385;0;11.5;3.9;0.0
78;2021-03-24;5408;728;0;145309;48113;0;11.9;4.0;0.0
78;2021-03-25;7749;776;0;153058;48889;0;12.6;4.0;0.0
78;2021-03-26;7755;921;0;160813;49810;0;13.2;4.1;0.0
78;2021-03-27;4506;336;0;165319;50146;0;13.6;4.1;0.0
78;2021-03-28;2118;81;0;167437;50227;0;13.7;4.1;0.0
78;2021-03-29;4257;1000;0;171694;51227;0;14.1;4.2;0.0
78;2021-03-30;5878;1362;0;177572;52589;0;14.6;4.3;0.0
78;2021-03-31;5746;1692;0;183318;54281;0;15.1;4.5;0.0
78;2021-04-01;6351;2796;0;189669;57077;0;15.6;4.7;0.0
78;2021-04-02;5618;3278;0;195287;60355;0;16.0;5.0;0.0
78;2021-04-03;2411;3384;0;197698;63739;0;16.2;5.2;0.0
78;2021-04-04;464;345;0;198162;64084;0;16.3;5.3;0.0
78;2021-04-05;518;76;0;198680;64160;0;16.3;5.3;0.0
78;2021-04-06;3865;2822;0;202545;66982;0;16.6;5.5;0.0
78;2021-04-07;5059;3114;0;207604;70096;0;17.0;5.8;0.0
78;2021-04-08;6107;3213;0;213711;73309;0;17.5;6.0;0.0
78;2021-04-09;7529;3038;0;221240;76347;0;18.2;6.3;0.0
78;2021-04-10;4190;2465;0;225430;78812;0;18.5;6.5;0.0
78;2021-04-11;582;852;0;226012;79664;0;18.6;6.5;0.0
78;2021-04-12;3692;2767;0;229704;82431;0;18.9;6.8;0.0
78;2021-04-13;5624;3294;0;235328;85725;0;19.3;7.0;0.0
78;2021-04-14;5369;3846;0;240697;89571;0;19.8;7.4;0.0
78;2021-04-15;5201;4634;0;245898;94205;0;20.2;7.7;0.0
78;2021-04-16;6405;4615;0;252303;98820;0;20.7;8.1;0.0
78;2021-04-17;4025;1159;0;256328;99979;0;21.0;8.2;0.0
78;2021-04-18;549;159;0;256877;100138;0;21.1;8.2;0.0
78;2021-04-19;3525;3103;0;260402;103241;0;21.4;8.5;0.0
78;2021-04-20;5008;4124;0;265410;107365;0;21.8;8.8;0.0
78;2021-04-21;5257;3865;0;270667;111230;0;22.2;9.1;0.0
78;2021-04-22;5075;5122;0;275742;116352;0;22.6;9.6;0.0
78;2021-04-23;5781;5048;0;281523;121400;0;23.1;10.0;0.0
78;2021-04-24;5865;3163;0;287388;124563;0;23.6;10.2;0.0
78;2021-04-25;3300;1813;0;290688;126376;0;23.9;10.4;0.0
78;2021-04-26;4999;3630;0;295687;130006;0;24.3;10.7;0.0
78;2021-04-27;5827;4529;0;301514;134535;0;24.8;11.0;0.0
78;2021-04-28;6047;4906;0;307561;139441;0;25.3;11.5;0.0
78;2021-04-29;6938;4716;0;314499;144157;0;25.8;11.8;0.0
78;2021-04-30;8204;4812;0;322703;148969;0;26.5;12.2;0.0
78;2021-05-01;1243;449;0;323946;149418;0;26.6;12.3;0.0
78;2021-05-02;2032;307;0;325978;149725;0;26.8;12.3;0.0
78;2021-05-03;7299;2402;0;333277;152127;0;27.4;12.5;0.0
78;2021-05-04;6865;4374;0;340142;156501;0;27.9;12.9;0.0
78;2021-05-05;7799;5052;0;347941;161553;0;28.6;13.3;0.0
78;2021-05-06;7717;5549;0;355658;167102;0;29.2;13.7;0.0
78;2021-05-07;9421;5684;0;365079;172786;0;30.0;14.2;0.0
78;2021-05-08;4605;1776;0;369684;174562;0;30.4;14.3;0.0
78;2021-05-09;3682;654;0;373366;175216;0;30.7;14.4;0.0
78;2021-05-10;8861;4592;0;382227;179808;0;31.4;14.8;0.0
78;2021-05-11;10240;5598;0;392467;185406;0;32.2;15.2;0.0
78;2021-05-12;10900;4352;0;403367;189758;0;33.1;15.6;0.0
78;2021-05-13;9030;953;0;412397;190711;0;33.9;15.7;0.0
78;2021-05-14;11885;2747;0;424282;193458;0;34.8;15.9;0.0
78;2021-05-15;6943;2624;0;431225;196082;0;35.4;16.1;0.0
78;2021-05-16;4765;868;0;435990;196950;0;35.8;16.2;0.0
78;2021-05-17;9787;1714;0;445777;198664;0;36.6;16.3;0.0
78;2021-05-18;12018;2430;0;457795;201094;0;37.6;16.5;0.0
78;2021-05-19;13399;2739;0;471194;203833;0;38.7;16.7;0.0
78;2021-05-20;13740;3045;0;484934;206878;0;39.8;17.0;0.0
78;2021-05-21;14063;3186;0;498997;210064;0;41.0;17.3;0.0
78;2021-05-22;8861;1739;0;507858;211803;0;41.7;17.4;0.0
78;2021-05-23;4370;547;0;512228;212350;0;42.1;17.4;0.0
78;2021-05-24;5307;709;0;517535;213059;0;42.5;17.5;0.0
78;2021-05-25;10910;3181;0;528445;216240;0;43.4;17.8;0.0
78;2021-05-26;11309;4343;0;539754;220583;0;44.3;18.1;0.0
78;2021-05-27;12115;5230;0;551869;225813;0;45.3;18.5;0.0
78;2021-05-28;12298;6703;0;564167;232516;0;46.3;19.1;0.0
78;2021-05-29;5545;3662;0;569712;236178;0;46.8;19.4;0.0
78;2021-05-30;1204;550;0;570916;236728;0;46.9;19.4;0.0
78;2021-05-31;8878;5480;0;579794;242208;0;47.6;19.9;0.0
78;2021-06-01;11615;7145;0;591409;249353;0;48.6;20.5;0.0
78;2021-06-02;10468;6849;0;601877;256202;0;49.4;21.0;0.0
78;2021-06-03;11191;7493;0;613068;263695;0;50.3;21.7;0.0
78;2021-06-04;11470;8665;0;624538;272360;0;51.3;22.4;0.0
78;2021-06-05;7838;6954;0;632376;279314;0;51.9;22.9;0.0
78;2021-06-06;2877;2188;0;635253;281502;0;52.2;23.1;0.0
78;2021-06-07;9702;6918;0;644955;288420;0;53.0;23.7;0.0
78;2021-06-08;9583;7853;0;654538;296273;0;53.7;24.3;0.0
78;2021-06-09;8571;7714;0;663109;303987;0;54.5;25.0;0.0
78;2021-06-10;8293;8632;0;671402;312619;0;55.1;25.7;0.0
78;2021-06-11;8750;8999;0;680152;321618;0;55.9;26.4;0.0
78;2021-06-12;7760;4069;0;687912;325687;0;56.5;26.7;0.0
78;2021-06-13;1675;2821;0;689587;328508;0;56.6;27.0;0.0
78;2021-06-14;4497;10086;0;694084;338594;0;57.0;27.8;0.0
78;2021-06-15;6293;9515;0;700377;348109;0;57.5;28.6;0.0
78;2021-06-16;6179;9784;0;706556;357893;0;58.0;29.4;0.0
78;2021-06-17;6180;9819;0;712736;367712;0;58.5;30.2;0.0
78;2021-06-18;6829;11700;0;719565;379412;0;59.1;31.2;0.0
78;2021-06-19;5774;7014;0;725339;386426;0;59.6;31.7;0.0
78;2021-06-20;1001;3874;0;726340;390300;0;59.6;32.1;0.0
78;2021-06-21;4466;10832;0;730806;401132;0;60.0;32.9;0.0
78;2021-06-22;4088;12077;0;734894;413209;0;60.3;33.9;0.0
78;2021-06-23;4481;12250;0;739375;425459;0;60.7;34.9;0.0
78;2021-06-24;4484;11823;0;743859;437282;0;61.1;35.9;0.0
78;2021-06-25;4753;14948;0;748612;452230;0;61.5;37.1;0.0
78;2021-06-26;4706;10086;0;753318;462316;0;61.9;38.0;0.0
78;2021-06-27;1324;3577;0;754642;465893;0;62.0;38.3;0.0
78;2021-06-28;3740;12367;0;758382;478260;0;62.3;39.3;0.0
78;2021-06-29;3848;13172;0;762230;491432;0;62.6;40.4;0.0
78;2021-06-30;4509;14733;0;766739;506165;0;63.0;41.6;0.0
78;2021-07-01;4646;13999;0;771385;520164;0;63.3;42.7;0.0
78;2021-07-02;4799;15232;0;776184;535396;0;63.7;44.0;0.0
78;2021-07-03;3405;10872;0;779589;546268;0;64.0;44.9;0.0
78;2021-07-04;960;2729;0;780549;548997;0;64.1;45.1;0.0
78;2021-07-05;3843;10869;0;784392;559866;0;64.4;46.0;0.0
78;2021-07-06;3903;13378;0;788295;573244;0;64.7;47.1;0.0
78;2021-07-07;4482;12796;0;792777;586040;0;65.1;48.1;0.0
78;2021-07-08;4791;13040;0;797568;599080;0;65.5;49.2;0.0
78;2021-07-09;5409;13987;0;802977;613067;0;65.9;50.3;0.0
78;2021-07-10;3234;8488;0;806211;621555;0;66.2;51.0;0.0
78;2021-07-11;1123;2822;0;807334;624377;0;66.3;51.3;0.0
78;2021-07-12;4005;13787;0;811339;638164;0;66.6;52.4;0.0
78;2021-07-13;6449;14086;0;817788;652250;0;67.2;53.6;0.0
78;2021-07-14;4018;6117;0;821806;658367;0;67.5;54.1;0.0
78;2021-07-15;7403;14479;0;829209;672846;0;68.1;55.3;0.0
78;2021-07-16;8542;13196;0;837751;686042;0;68.8;56.3;0.0
78;2021-07-17;5647;6830;0;843398;692872;0;69.3;56.9;0.0
78;2021-07-18;1745;1207;0;845143;694079;0;69.4;57.0;0.0
78;2021-07-19;5832;12443;0;850975;706522;0;69.9;58.0;0.0
78;2021-07-20;7428;11939;0;858403;718461;0;70.5;59.0;0.0
78;2021-07-21;8185;11764;0;866588;730225;0;71.2;60.0;0.0
78;2021-07-22;8777;11268;0;875365;741493;0;71.9;60.9;0.0
78;2021-07-23;8787;11227;0;884152;752720;0;72.6;61.8;0.0
78;2021-07-24;4722;6319;0;888874;759039;0;73.0;62.3;0.0
78;2021-07-25;1917;1286;0;890791;760325;0;73.2;62.4;0.0
78;2021-07-26;7720;8602;0;898511;768927;0;73.8;63.1;0.0
78;2021-07-27;10372;8642;0;908883;777569;0;74.6;63.9;0.0
78;2021-07-28;10018;7803;0;918901;785372;0;75.5;64.5;0.0
78;2021-07-29;10342;7465;0;929243;792837;0;76.3;65.1;0.0
78;2021-07-30;9622;8805;0;938865;801642;0;77.1;65.8;0.0
78;2021-07-31;4320;3873;0;943185;805515;0;77.5;66.1;0.0
78;2021-08-01;1235;820;0;944420;806335;0;77.6;66.2;0.0
78;2021-08-02;4622;3814;0;949042;810149;0;77.9;66.5;0.0
78;2021-08-03;5964;6141;0;955006;816290;0;78.4;67.0;0.0
78;2021-08-04;6109;4770;0;961115;821060;0;78.9;67.4;0.0
78;2021-08-05;5586;4873;0;966701;825933;0;79.4;67.8;0.0
78;2021-08-06;5418;5843;0;972119;831776;0;79.8;68.3;0.0
78;2021-08-07;3458;4447;0;975577;836223;0;80.1;68.7;0.0
78;2021-08-08;838;836;0;976415;837059;0;80.2;68.7;0.0
78;2021-08-09;3298;3904;0;979713;840963;0;80.5;69.1;0.0
78;2021-08-10;4380;5654;0;984093;846617;0;80.8;69.5;0.0
78;2021-08-11;4129;5412;0;988222;852029;0;81.2;70.0;0.0
78;2021-08-12;3937;5680;0;992159;857709;0;81.5;70.4;0.0
78;2021-08-13;3660;4812;0;995819;862521;0;81.8;70.8;0.0
78;2021-08-14;2839;4117;0;998658;866638;0;82.0;71.2;0.0
78;2021-08-15;424;618;0;999082;867256;0;82.0;71.2;0.0
78;2021-08-16;1858;4919;0;1000940;872175;0;82.2;71.6;0.0
78;2021-08-17;3222;6393;0;1004162;878568;0;82.5;72.1;0.0
78;2021-08-18;3085;6032;0;1007247;884600;0;82.7;72.6;0.0
78;2021-08-19;2830;5470;0;1010077;890070;0;82.9;73.1;0.0
78;2021-08-20;2763;6147;0;1012840;896217;0;83.2;73.6;0.0
78;2021-08-21;2232;5008;0;1015072;901225;0;83.4;74.0;0.0
78;2021-08-22;244;732;0;1015316;901957;0;83.4;74.1;0.0
78;2021-08-23;2510;6273;0;1017826;908230;0;83.6;74.6;0.0
78;2021-08-24;3573;8218;0;1021399;916448;0;83.9;75.3;0.0
78;2021-08-25;3408;7923;0;1024807;924371;0;84.2;75.9;0.0
78;2021-08-26;3024;8513;0;1027831;932884;0;84.4;76.6;0.0
78;2021-08-27;2961;8611;0;1030792;941495;0;84.6;77.3;0.0
78;2021-08-28;2536;6213;0;1033328;947708;0;84.9;77.8;0.0
78;2021-08-29;360;705;0;1033688;948413;0;84.9;77.9;0.0
78;2021-08-30;2929;5944;109;1036617;954357;109;85.1;78.4;0.0
78;2021-08-31;3399;6440;189;1040016;960797;298;85.4;78.9;0.0
78;2021-09-01;3131;5957;507;1043147;966754;805;85.7;79.4;0.1
78;2021-09-02;2319;4807;572;1045466;971561;1377;85.9;79.8;0.1
78;2021-09-03;2368;5132;601;1047834;976693;1978;86.0;80.2;0.2
78;2021-09-04;2702;5140;339;1050536;981833;2317;86.3;80.6;0.2
78;2021-09-05;293;415;34;1050829;982248;2351;86.3;80.7;0.2
78;2021-09-06;1342;2812;594;1052171;985060;2945;86.4;80.9;0.2
78;2021-09-07;1463;3215;700;1053634;988275;3645;86.5;81.2;0.3
78;2021-09-08;1807;3682;607;1055441;991957;4252;86.7;81.5;0.3
78;2021-09-09;1145;2866;657;1056586;994823;4909;86.8;81.7;0.4
78;2021-09-10;1525;3330;618;1058111;998153;5527;86.9;82.0;0.5
78;2021-09-11;2220;4323;511;1060331;1002476;6038;87.1;82.3;0.5
78;2021-09-12;131;230;36;1060462;1002706;6074;87.1;82.3;0.5
78;2021-09-13;1100;2122;700;1061562;1004828;6774;87.2;82.5;0.6
78;2021-09-14;1209;2780;1161;1062771;1007608;7935;87.3;82.7;0.7
78;2021-09-15;1375;3784;1004;1064146;1011392;8939;87.4;83.1;0.7
78;2021-09-16;915;2109;1035;1065061;1013501;9974;87.5;83.2;0.8
78;2021-09-17;1260;2870;991;1066321;1016371;10965;87.6;83.5;0.9
78;2021-09-18;1488;4354;426;1067809;1020725;11391;87.7;83.8;0.9
78;2021-09-19;128;387;31;1067937;1021112;11422;87.7;83.9;0.9
78;2021-09-20;753;1675;853;1068690;1022787;12275;87.8;84.0;1.0
78;2021-09-21;831;1957;1179;1069521;1024744;13454;87.8;84.2;1.1
78;2021-09-22;987;3563;940;1070508;1028307;14394;87.9;84.4;1.2
78;2021-09-23;873;1622;1315;1071381;1029929;15709;88.0;84.6;1.3
78;2021-09-24;1017;2326;1079;1072398;1032255;16788;88.1;84.8;1.4
78;2021-09-25;1123;4146;554;1073521;1036401;17342;88.2;85.1;1.4
78;2021-09-26;63;175;17;1073584;1036576;17359;88.2;85.1;1.4
78;2021-09-27;688;1484;990;1074272;1038060;18349;88.2;85.2;1.5
78;2021-09-28;847;1439;1164;1075119;1039499;19513;88.3;85.4;1.6
78;2021-09-29;1050;2270;1087;1076169;1041769;20600;88.4;85.5;1.7
78;2021-09-30;584;1017;933;1076753;1042786;21533;88.4;85.6;1.8
78;2021-10-01;1296;1778;1275;1078049;1044564;22808;88.5;85.8;1.9
78;2021-10-02;1334;2640;738;1079383;1047204;23546;88.6;86.0;1.9
78;2021-10-03;76;110;30;1079459;1047314;23576;88.6;86.0;1.9
78;2021-10-04;612;964;1053;1080071;1048278;24629;88.7;86.1;2.0
78;2021-10-05;574;906;1090;1080645;1049184;25719;88.7;86.2;2.1
78;2021-10-06;888;1584;1721;1081533;1050768;27440;88.8;86.3;2.3
78;2021-10-07;487;857;1300;1082020;1051625;28740;88.9;86.4;2.4
78;2021-10-08;925;1674;2145;1082945;1053299;30885;88.9;86.5;2.5
78;2021-10-09;938;1874;908;1083883;1055173;31793;89.0;86.6;2.6
78;2021-10-10;83;113;60;1083966;1055286;31853;89.0;86.7;2.6
78;2021-10-11;585;824;1250;1084551;1056110;33103;89.1;86.7;2.7
78;2021-10-12;472;757;1457;1085023;1056867;34560;89.1;86.8;2.8
78;2021-10-13;709;1373;2018;1085732;1058240;36578;89.2;86.9;3.0
78;2021-10-14;546;895;1574;1086278;1059135;38152;89.2;87.0;3.1
78;2021-10-15;772;1340;2619;1087050;1060475;40771;89.3;87.1;3.3
78;2021-10-16;878;1342;1097;1087928;1061817;41868;89.3;87.2;3.4
78;2021-10-17;60;89;49;1087988;1061906;41917;89.3;87.2;3.4
78;2021-10-18;475;812;1527;1088463;1062718;43444;89.4;87.3;3.6
78;2021-10-19;449;746;1462;1088912;1063464;44906;89.4;87.3;3.7
78;2021-10-20;720;1208;2637;1089632;1064672;47543;89.5;87.4;3.9
78;2021-10-21;433;785;2020;1090065;1065457;49563;89.5;87.5;4.1
78;2021-10-22;711;1164;2798;1090776;1066621;52361;89.6;87.6;4.3
78;2021-10-23;756;1225;1224;1091532;1067846;53585;89.6;87.7;4.4
78;2021-10-24;56;92;49;1091588;1067938;53634;89.6;87.7;4.4
78;2021-10-25;476;619;1883;1092064;1068557;55517;89.7;87.7;4.6
78;2021-10-26;317;527;1717;1092381;1069084;57234;89.7;87.8;4.7
78;2021-10-27;553;865;2759;1092934;1069949;59993;89.8;87.9;4.9
78;2021-10-28;330;502;1973;1093264;1070451;61966;89.8;87.9;5.1
78;2021-10-29;501;778;2639;1093765;1071229;64605;89.8;88.0;5.3
78;2021-10-30;408;878;1288;1094173;1072107;65893;89.9;88.0;5.4
78;2021-10-31;61;89;65;1094234;1072196;65958;89.9;88.0;5.4
78;2021-11-01;99;80;80;1094333;1072276;66038;89.9;88.1;5.4
78;2021-11-02;423;508;1763;1094756;1072784;67801;89.9;88.1;5.6
78;2021-11-03;481;581;1955;1095237;1073365;69756;89.9;88.1;5.7
78;2021-11-04;416;530;2097;1095653;1073895;71853;90.0;88.2;5.9
78;2021-11-05;554;809;2817;1096207;1074704;74670;90.0;88.3;6.1
78;2021-11-06;361;601;946;1096568;1075305;75616;90.0;88.3;6.2
78;2021-11-07;54;92;142;1096622;1075397;75758;90.1;88.3;6.2
78;2021-11-08;274;599;2122;1096896;1075996;77880;90.1;88.4;6.4
78;2021-11-09;361;567;3213;1097257;1076563;81093;90.1;88.4;6.7
78;2021-11-10;474;782;3334;1097731;1077345;84427;90.1;88.5;6.9
78;2021-11-11;76;116;332;1097807;1077461;84759;90.2;88.5;7.0
78;2021-11-12;436;744;4090;1098243;1078205;88849;90.2;88.5;7.3
78;2021-11-13;378;543;1454;1098621;1078748;90303;90.2;88.6;7.4
78;2021-11-14;70;62;131;1098691;1078810;90434;90.2;88.6;7.4
78;2021-11-15;250;500;2949;1098941;1079310;93383;90.2;88.6;7.7
78;2021-11-16;413;492;4170;1099354;1079802;97553;90.3;88.7;8.0
78;2021-11-17;481;707;4105;1099835;1080509;101658;90.3;88.7;8.3
78;2021-11-18;349;587;3635;1100184;1081096;105293;90.3;88.8;8.6
78;2021-11-19;601;735;5046;1100785;1081831;110339;90.4;88.8;9.1
78;2021-11-20;502;648;2178;1101287;1082479;112517;90.4;88.9;9.2
78;2021-11-21;67;81;205;1101354;1082560;112722;90.4;88.9;9.3
78;2021-11-22;320;433;3390;1101674;1082993;116112;90.5;88.9;9.5
78;2021-11-23;471;513;5000;1102145;1083506;121112;90.5;89.0;9.9
78;2021-11-24;501;691;4543;1102646;1084197;125655;90.5;89.0;10.3
78;2021-11-25;446;506;5527;1103092;1084703;131182;90.6;89.1;10.8
78;2021-11-26;496;710;8250;1103588;1085413;139432;90.6;89.1;11.5
78;2021-11-27;420;534;4856;1104008;1085947;144288;90.7;89.2;11.8
78;2021-11-28;80;100;1398;1104088;1086047;145686;90.7;89.2;12.0
78;2021-11-29;248;416;7035;1104336;1086463;152721;90.7;89.2;12.5
78;2021-11-30;393;537;11197;1104729;1087000;163918;90.7;89.3;13.5
78;2021-12-01;392;489;10894;1105121;1087489;174812;90.8;89.3;14.4
78;2021-12-02;322;411;12494;1105443;1087900;187306;90.8;89.3;15.4
78;2021-12-03;371;561;14275;1105814;1088461;201581;90.8;89.4;16.6
78;2021-12-04;291;411;8752;1106105;1088872;210333;90.8;89.4;17.3
78;2021-12-05;107;147;3690;1106212;1089019;214023;90.8;89.4;17.6
78;2021-12-06;302;457;11407;1106514;1089476;225430;90.9;89.5;18.5
78;2021-12-07;370;578;15689;1106884;1090054;241119;90.9;89.5;19.8
78;2021-12-08;399;617;15810;1107283;1090671;256929;90.9;89.6;21.1
78;2021-12-09;384;478;17826;1107667;1091149;274755;91.0;89.6;22.6
78;2021-12-10;447;682;19367;1108114;1091831;294122;91.0;89.7;24.2
78;2021-12-11;390;661;11903;1108504;1092492;306025;91.0;89.7;25.1
78;2021-12-12;124;162;5112;1108628;1092654;311137;91.0;89.7;25.6
78;2021-12-13;309;523;14323;1108937;1093177;325460;91.1;89.8;26.7
78;2021-12-14;413;658;19324;1109350;1093835;344784;91.1;89.8;28.3
78;2021-12-15;425;636;18072;1109775;1094471;362856;91.1;89.9;29.8
78;2021-12-16;410;591;20160;1110185;1095062;383016;91.2;89.9;31.5
78;2021-12-17;475;739;21154;1110660;1095801;404170;91.2;90.0;33.2
78;2021-12-18;418;534;12378;1111078;1096335;416548;91.2;90.0;34.2
78;2021-12-19;197;181;6242;1111275;1096516;422790;91.3;90.0;34.7
79;2020-12-27;0;0;0;0;0;0;0.0;0.0;0.0
79;2020-12-28;3;0;0;3;0;0;0.0;0.0;0.0
79;2020-12-29;0;0;0;3;0;0;0.0;0.0;0.0
79;2020-12-30;0;0;0;3;0;0;0.0;0.0;0.0
79;2020-12-31;0;0;0;3;0;0;0.0;0.0;0.0
79;2021-01-01;0;0;0;3;0;0;0.0;0.0;0.0
79;2021-01-02;0;0;0;3;0;0;0.0;0.0;0.0
79;2021-01-03;0;0;0;3;0;0;0.0;0.0;0.0
79;2021-01-04;3;0;0;6;0;0;0.0;0.0;0.0
79;2021-01-05;1;0;0;7;0;0;0.0;0.0;0.0
79;2021-01-06;3;0;0;10;0;0;0.0;0.0;0.0
79;2021-01-07;165;0;0;175;0;0;0.1;0.0;0.0
79;2021-01-08;173;0;0;348;0;0;0.1;0.0;0.0
79;2021-01-09;95;1;0;443;1;0;0.1;0.0;0.0
79;2021-01-10;5;0;0;448;1;0;0.1;0.0;0.0
79;2021-01-11;184;1;0;632;2;0;0.2;0.0;0.0
79;2021-01-12;249;1;0;881;3;0;0.3;0.0;0.0
79;2021-01-13;261;0;0;1142;3;0;0.4;0.0;0.0
79;2021-01-14;484;7;0;1626;10;0;0.5;0.0;0.0
79;2021-01-15;585;7;0;2211;17;0;0.7;0.0;0.0
79;2021-01-16;59;0;0;2270;17;0;0.7;0.0;0.0
79;2021-01-17;3;0;0;2273;17;0;0.7;0.0;0.0
79;2021-01-18;471;2;0;2744;19;0;0.8;0.0;0.0
79;2021-01-19;1276;3;0;4020;22;0;1.2;0.0;0.0
79;2021-01-20;1607;2;0;5627;24;0;1.7;0.0;0.0
79;2021-01-21;1947;9;0;7574;33;0;2.3;0.0;0.0
79;2021-01-22;882;5;0;8456;38;0;2.6;0.0;0.0
79;2021-01-23;75;0;0;8531;38;0;2.6;0.0;0.0
79;2021-01-24;1;0;0;8532;38;0;2.6;0.0;0.0
79;2021-01-25;652;6;0;9184;44;0;2.8;0.0;0.0
79;2021-01-26;598;16;0;9782;60;0;3.0;0.0;0.0
79;2021-01-27;729;80;0;10511;140;0;3.3;0.0;0.0
79;2021-01-28;757;155;0;11268;295;0;3.5;0.1;0.0
79;2021-01-29;487;87;0;11755;382;0;3.6;0.1;0.0
79;2021-01-30;9;2;0;11764;384;0;3.6;0.1;0.0
79;2021-01-31;4;0;0;11768;384;0;3.6;0.1;0.0
79;2021-02-01;232;110;0;12000;494;0;3.7;0.2;0.0
79;2021-02-02;333;77;0;12333;571;0;3.8;0.2;0.0
79;2021-02-03;342;64;0;12675;635;0;3.9;0.2;0.0
79;2021-02-04;323;116;0;12998;751;0;4.0;0.2;0.0
79;2021-02-05;333;274;0;13331;1025;0;4.1;0.3;0.0
79;2021-02-06;10;3;0;13341;1028;0;4.1;0.3;0.0
79;2021-02-07;21;2;0;13362;1030;0;4.1;0.3;0.0
79;2021-02-08;280;163;0;13642;1193;0;4.2;0.4;0.0
79;2021-02-09;428;755;0;14070;1948;0;4.4;0.6;0.0
79;2021-02-10;545;1103;0;14615;3051;0;4.5;0.9;0.0
79;2021-02-11;768;1206;0;15383;4257;0;4.8;1.3;0.0
79;2021-02-12;458;742;0;15841;4999;0;4.9;1.5;0.0
79;2021-02-13;53;70;0;15894;5069;0;4.9;1.6;0.0
79;2021-02-14;0;1;0;15894;5070;0;4.9;1.6;0.0
79;2021-02-15;184;486;0;16078;5556;0;5.0;1.7;0.0
79;2021-02-16;338;735;0;16416;6291;0;5.1;1.9;0.0
79;2021-02-17;252;816;0;16668;7107;0;5.2;2.2;0.0
79;2021-02-18;377;990;0;17045;8097;0;5.3;2.5;0.0
79;2021-02-19;306;584;0;17351;8681;0;5.4;2.7;0.0
79;2021-02-20;14;25;0;17365;8706;0;5.4;2.7;0.0
79;2021-02-21;0;0;0;17365;8706;0;5.4;2.7;0.0
79;2021-02-22;142;463;0;17507;9169;0;5.4;2.8;0.0
79;2021-02-23;245;569;0;17752;9738;0;5.5;3.0;0.0
79;2021-02-24;256;518;0;18008;10256;0;5.6;3.2;0.0
79;2021-02-25;538;483;0;18546;10739;0;5.7;3.3;0.0
79;2021-02-26;649;386;0;19195;11125;0;5.9;3.4;0.0
79;2021-02-27;409;10;0;19604;11135;0;6.1;3.4;0.0
79;2021-02-28;29;5;0;19633;11140;0;6.1;3.4;0.0
79;2021-03-01;97;364;0;19730;11504;0;6.1;3.6;0.0
79;2021-03-02;335;495;0;20065;11999;0;6.2;3.7;0.0
79;2021-03-03;671;497;0;20736;12496;0;6.4;3.9;0.0
79;2021-03-04;928;565;0;21664;13061;0;6.7;4.0;0.0
79;2021-03-05;1258;412;0;22922;13473;0;7.1;4.2;0.0
79;2021-03-06;696;13;0;23618;13486;0;7.3;4.2;0.0
79;2021-03-07;98;2;0;23716;13488;0;7.3;4.2;0.0
79;2021-03-08;347;312;0;24063;13800;0;7.4;4.3;0.0
79;2021-03-09;855;347;0;24918;14147;0;7.7;4.4;0.0
79;2021-03-10;1176;373;0;26094;14520;0;8.1;4.5;0.0
79;2021-03-11;1676;325;0;27770;14845;0;8.6;4.6;0.0
79;2021-03-12;1788;156;0;29558;15001;0;9.1;4.6;0.0
79;2021-03-13;1162;15;0;30720;15016;0;9.5;4.6;0.0
79;2021-03-14;53;1;0;30773;15017;0;9.5;4.6;0.0
79;2021-03-15;544;164;0;31317;15181;0;9.7;4.7;0.0
79;2021-03-16;713;155;0;32030;15336;0;9.9;4.7;0.0
79;2021-03-17;636;121;0;32666;15457;0;10.1;4.8;0.0
79;2021-03-18;591;214;0;33257;15671;0;10.3;4.8;0.0
79;2021-03-19;720;256;0;33977;15927;0;10.5;4.9;0.0
79;2021-03-20;1003;20;0;34980;15947;0;10.8;4.9;0.0
79;2021-03-21;9;0;0;34989;15947;0;10.8;4.9;0.0
79;2021-03-22;983;209;0;35972;16156;0;11.1;5.0;0.0
79;2021-03-23;1621;193;0;37593;16349;0;11.6;5.1;0.0
79;2021-03-24;1803;176;0;39396;16525;0;12.2;5.1;0.0
79;2021-03-25;2509;206;0;41905;16731;0;13.0;5.2;0.0
79;2021-03-26;2394;143;0;44299;16874;0;13.7;5.2;0.0
79;2021-03-27;684;21;0;44983;16895;0;13.9;5.2;0.0
79;2021-03-28;3;2;0;44986;16897;0;13.9;5.2;0.0
79;2021-03-29;2065;119;0;47051;17016;0;14.6;5.3;0.0
79;2021-03-30;2702;85;0;49753;17101;0;15.4;5.3;0.0
79;2021-03-31;2649;389;0;52402;17490;0;16.2;5.4;0.0
79;2021-04-01;2656;400;0;55058;17890;0;17.0;5.5;0.0
79;2021-04-02;2699;399;0;57757;18289;0;17.9;5.7;0.0
79;2021-04-03;659;67;0;58416;18356;0;18.1;5.7;0.0
79;2021-04-04;9;1;0;58425;18357;0;18.1;5.7;0.0
79;2021-04-05;384;7;0;58809;18364;0;18.2;5.7;0.0
79;2021-04-06;1676;593;0;60485;18957;0;18.7;5.9;0.0
79;2021-04-07;2903;754;0;63388;19711;0;19.6;6.1;0.0
79;2021-04-08;2537;712;0;65925;20423;0;20.4;6.3;0.0
79;2021-04-09;3518;560;0;69443;20983;0;21.5;6.5;0.0
79;2021-04-10;1363;388;0;70806;21371;0;21.9;6.6;0.0
79;2021-04-11;12;2;0;70818;21373;0;21.9;6.6;0.0
79;2021-04-12;1695;395;0;72513;21768;0;22.4;6.7;0.0
79;2021-04-13;2131;766;0;74644;22534;0;23.1;7.0;0.0
79;2021-04-14;2335;704;0;76979;23238;0;23.8;7.2;0.0
79;2021-04-15;2229;692;0;79208;23930;0;24.5;7.4;0.0
79;2021-04-16;1470;467;0;80678;24397;0;25.0;7.5;0.0
79;2021-04-17;610;350;0;81288;24747;0;25.1;7.7;0.0
79;2021-04-18;14;16;0;81302;24763;0;25.1;7.7;0.0
79;2021-04-19;1117;839;0;82419;25602;0;25.5;7.9;0.0
79;2021-04-20;1548;1247;0;83967;26849;0;26.0;8.3;0.0
79;2021-04-21;1440;1431;0;85407;28280;0;26.4;8.7;0.0
79;2021-04-22;1702;1122;0;87109;29402;0;26.9;9.1;0.0
79;2021-04-23;1345;1213;0;88454;30615;0;27.4;9.5;0.0
79;2021-04-24;681;391;0;89135;31006;0;27.6;9.6;0.0
79;2021-04-25;41;1;0;89176;31007;0;27.6;9.6;0.0
79;2021-04-26;1437;1719;0;90613;32726;0;28.0;10.1;0.0
79;2021-04-27;2054;2256;0;92667;34982;0;28.7;10.8;0.0
79;2021-04-28;1505;2732;0;94172;37714;0;29.1;11.7;0.0
79;2021-04-29;2221;2165;0;96393;39879;0;29.8;12.3;0.0
79;2021-04-30;2192;2299;0;98585;42178;0;30.5;13.0;0.0
79;2021-05-01;581;379;0;99166;42557;0;30.7;13.2;0.0
79;2021-05-02;41;22;0;99207;42579;0;30.7;13.2;0.0
79;2021-05-03;1327;1270;0;100534;43849;0;31.1;13.6;0.0
79;2021-05-04;1879;2190;0;102413;46039;0;31.7;14.2;0.0
79;2021-05-05;1765;2285;0;104178;48324;0;32.2;14.9;0.0
79;2021-05-06;2514;2135;0;106692;50459;0;33.0;15.6;0.0
79;2021-05-07;2142;2601;0;108834;53060;0;33.7;16.4;0.0
79;2021-05-08;396;464;0;109230;53524;0;33.8;16.6;0.0
79;2021-05-09;98;16;0;109328;53540;0;33.8;16.6;0.0
79;2021-05-10;1636;1741;0;110964;55281;0;34.3;17.1;0.0
79;2021-05-11;2516;1654;0;113480;56935;0;35.1;17.6;0.0
79;2021-05-12;2099;2579;0;115579;59514;0;35.7;18.4;0.0
79;2021-05-13;839;325;0;116418;59839;0;36.0;18.5;0.0
79;2021-05-14;2203;713;0;118621;60552;0;36.7;18.7;0.0
79;2021-05-15;1419;514;0;120040;61066;0;37.1;18.9;0.0
79;2021-05-16;129;31;0;120169;61097;0;37.2;18.9;0.0
79;2021-05-17;1917;1147;0;122086;62244;0;37.8;19.2;0.0
79;2021-05-18;3067;1317;0;125153;63561;0;38.7;19.7;0.0
79;2021-05-19;2943;984;0;128096;64545;0;39.6;20.0;0.0
79;2021-05-20;3386;1292;0;131482;65837;0;40.7;20.4;0.0
79;2021-05-21;2871;1137;0;134353;66974;0;41.5;20.7;0.0
79;2021-05-22;1304;285;0;135657;67259;0;42.0;20.8;0.0
79;2021-05-23;115;9;0;135772;67268;0;42.0;20.8;0.0
79;2021-05-24;453;30;0;136225;67298;0;42.1;20.8;0.0
79;2021-05-25;3396;1037;0;139621;68335;0;43.2;21.1;0.0
79;2021-05-26;3317;888;0;142938;69223;0;44.2;21.4;0.0
79;2021-05-27;3872;1753;0;146810;70976;0;45.4;21.9;0.0
79;2021-05-28;3319;1882;0;150129;72858;0;46.4;22.5;0.0
79;2021-05-29;1270;502;0;151399;73360;0;46.8;22.7;0.0
79;2021-05-30;55;16;0;151454;73376;0;46.8;22.7;0.0
79;2021-05-31;2423;826;0;153877;74202;0;47.6;22.9;0.0
79;2021-06-01;3230;1638;0;157107;75840;0;48.6;23.5;0.0
79;2021-06-02;3716;1206;0;160823;77046;0;49.7;23.8;0.0
79;2021-06-03;4125;1776;0;164948;78822;0;51.0;24.4;0.0
79;2021-06-04;3753;2061;0;168701;80883;0;52.2;25.0;0.0
79;2021-06-05;2577;834;0;171278;81717;0;53.0;25.3;0.0
79;2021-06-06;666;73;0;171944;81790;0;53.2;25.3;0.0
79;2021-06-07;2538;1544;0;174482;83334;0;54.0;25.8;0.0
79;2021-06-08;2854;2230;0;177336;85564;0;54.8;26.5;0.0
79;2021-06-09;2996;1952;0;180332;87516;0;55.8;27.1;0.0
79;2021-06-10;2980;2038;0;183312;89554;0;56.7;27.7;0.0
79;2021-06-11;3356;2314;0;186668;91868;0;57.7;28.4;0.0
79;2021-06-12;1510;699;0;188178;92567;0;58.2;28.6;0.0
79;2021-06-13;172;116;0;188350;92683;0;58.2;28.7;0.0
79;2021-06-14;1164;1828;0;189514;94511;0;58.6;29.2;0.0
79;2021-06-15;1707;2572;0;191221;97083;0;59.1;30.0;0.0
79;2021-06-16;1935;2287;0;193156;99370;0;59.7;30.7;0.0
79;2021-06-17;2119;2710;0;195275;102080;0;60.4;31.6;0.0
79;2021-06-18;2176;2409;0;197451;104489;0;61.1;32.3;0.0
79;2021-06-19;1085;692;0;198536;105181;0;61.4;32.5;0.0
79;2021-06-20;15;46;0;198551;105227;0;61.4;32.5;0.0
79;2021-06-21;1124;2376;0;199675;107603;0;61.8;33.3;0.0
79;2021-06-22;1452;3050;0;201127;110653;0;62.2;34.2;0.0
79;2021-06-23;1466;2499;0;202593;113152;0;62.7;35.0;0.0
79;2021-06-24;1915;2055;0;204508;115207;0;63.2;35.6;0.0
79;2021-06-25;1300;2881;0;205808;118088;0;63.6;36.5;0.0
79;2021-06-26;801;981;0;206609;119069;0;63.9;36.8;0.0
79;2021-06-27;29;89;0;206638;119158;0;63.9;36.9;0.0
79;2021-06-28;944;2655;0;207582;121813;0;64.2;37.7;0.0
79;2021-06-29;1265;3672;0;208847;125485;0;64.6;38.8;0.0
79;2021-06-30;1125;3397;0;209972;128882;0;64.9;39.9;0.0
79;2021-07-01;1171;3718;0;211143;132600;0;65.3;41.0;0.0
79;2021-07-02;1344;3407;0;212487;136007;0;65.7;42.1;0.0
79;2021-07-03;367;1656;0;212854;137663;0;65.8;42.6;0.0
79;2021-07-04;18;102;0;212872;137765;0;65.8;42.6;0.0
79;2021-07-05;689;2304;0;213561;140069;0;66.0;43.3;0.0
79;2021-07-06;842;3875;0;214403;143944;0;66.3;44.5;0.0
79;2021-07-07;1184;4186;0;215587;148130;0;66.7;45.8;0.0
79;2021-07-08;1070;4117;0;216657;152247;0;67.0;47.1;0.0
79;2021-07-09;886;3681;0;217543;155928;0;67.3;48.2;0.0
79;2021-07-10;570;1425;0;218113;157353;0;67.5;48.7;0.0
79;2021-07-11;21;44;0;218134;157397;0;67.5;48.7;0.0
79;2021-07-12;578;3618;0;218712;161015;0;67.6;49.8;0.0
79;2021-07-13;1017;5078;0;219729;166093;0;68.0;51.4;0.0
79;2021-07-14;195;879;0;219924;166972;0;68.0;51.6;0.0
79;2021-07-15;1210;4603;0;221134;171575;0;68.4;53.1;0.0
79;2021-07-16;1295;3997;0;222429;175572;0;68.8;54.3;0.0
79;2021-07-17;605;2310;0;223034;177882;0;69.0;55.0;0.0
79;2021-07-18;109;492;0;223143;178374;0;69.0;55.2;0.0
79;2021-07-19;827;3186;0;223970;181560;0;69.3;56.1;0.0
79;2021-07-20;1455;3720;0;225425;185280;0;69.7;57.3;0.0
79;2021-07-21;1286;3655;0;226711;188935;0;70.1;58.4;0.0
79;2021-07-22;1661;3710;0;228372;192645;0;70.6;59.6;0.0
79;2021-07-23;1505;4112;0;229877;196757;0;71.1;60.8;0.0
79;2021-07-24;1007;1458;0;230884;198215;0;71.4;61.3;0.0
79;2021-07-25;110;236;0;230994;198451;0;71.4;61.4;0.0
79;2021-07-26;1375;2433;0;232369;200884;0;71.9;62.1;0.0
79;2021-07-27;2487;2793;0;234856;203677;0;72.6;63.0;0.0
79;2021-07-28;2535;2231;0;237391;205908;0;73.4;63.7;0.0
79;2021-07-29;3127;2676;0;240518;208584;0;74.4;64.5;0.0
79;2021-07-30;2276;2688;0;242794;211272;0;75.1;65.3;0.0
79;2021-07-31;1010;1071;0;243804;212343;0;75.4;65.7;0.0
79;2021-08-01;74;28;0;243878;212371;0;75.4;65.7;0.0
79;2021-08-02;1854;1515;0;245732;213886;0;76.0;66.1;0.0
79;2021-08-03;2976;1901;0;248708;215787;0;76.9;66.7;0.0
79;2021-08-04;2895;1510;0;251603;217297;0;77.8;67.2;0.0
79;2021-08-05;3065;2083;0;254668;219380;0;78.8;67.8;0.0
79;2021-08-06;2412;1461;0;257080;220841;0;79.5;68.3;0.0
79;2021-08-07;1013;774;0;258093;221615;0;79.8;68.5;0.0
79;2021-08-08;74;29;0;258167;221644;0;79.8;68.5;0.0
79;2021-08-09;2355;1073;0;260522;222717;0;80.6;68.9;0.0
79;2021-08-10;2936;1488;0;263458;224205;0;81.5;69.3;0.0
79;2021-08-11;2394;1407;0;265852;225612;0;82.2;69.8;0.0
79;2021-08-12;2606;1410;0;268458;227022;0;83.0;70.2;0.0
79;2021-08-13;2592;1141;0;271050;228163;0;83.8;70.6;0.0
79;2021-08-14;588;442;0;271638;228605;0;84.0;70.7;0.0
79;2021-08-15;39;26;0;271677;228631;0;84.0;70.7;0.0
79;2021-08-16;1566;1243;0;273243;229874;0;84.5;71.1;0.0
79;2021-08-17;2071;1763;0;275314;231637;0;85.1;71.6;0.0
79;2021-08-18;1837;1747;0;277151;233384;0;85.7;72.2;0.0
79;2021-08-19;1456;1804;0;278607;235188;0;86.2;72.7;0.0
79;2021-08-20;1387;2118;0;279994;237306;0;86.6;73.4;0.0
79;2021-08-21;317;659;0;280311;237965;0;86.7;73.6;0.0
79;2021-08-22;13;73;0;280324;238038;0;86.7;73.6;0.0
79;2021-08-23;740;2202;0;281064;240240;0;86.9;74.3;0.0
79;2021-08-24;1013;2552;0;282077;242792;0;87.2;75.1;0.0
79;2021-08-25;1006;2592;0;283083;245384;0;87.5;75.9;0.0
79;2021-08-26;984;2408;0;284067;247792;0;87.8;76.6;0.0
79;2021-08-27;633;2152;0;284700;249944;0;88.0;77.3;0.0
79;2021-08-28;295;904;0;284995;250848;0;88.1;77.6;0.0
79;2021-08-29;10;61;0;285005;250909;0;88.1;77.6;0.0
79;2021-08-30;522;2321;23;285527;253230;23;88.3;78.3;0.0
79;2021-08-31;612;2750;28;286139;255980;51;88.5;79.2;0.0
79;2021-09-01;612;2638;77;286751;258618;128;88.7;80.0;0.0
79;2021-09-02;746;2427;109;287497;261045;237;88.9;80.7;0.1
79;2021-09-03;613;2644;113;288110;263689;350;89.1;81.5;0.1
79;2021-09-04;281;735;25;288391;264424;375;89.2;81.8;0.1
79;2021-09-05;13;47;8;288404;264471;383;89.2;81.8;0.1
79;2021-09-06;345;1691;119;288749;266162;502;89.3;82.3;0.2
79;2021-09-07;368;1972;113;289117;268134;615;89.4;82.9;0.2
79;2021-09-08;519;2091;120;289636;270225;735;89.6;83.6;0.2
79;2021-09-09;331;1537;129;289967;271762;864;89.7;84.0;0.3
79;2021-09-10;409;1880;229;290376;273642;1093;89.8;84.6;0.3
79;2021-09-11;146;893;33;290522;274535;1126;89.8;84.9;0.3
79;2021-09-12;3;26;4;290525;274561;1130;89.8;84.9;0.3
79;2021-09-13;328;942;249;290853;275503;1379;89.9;85.2;0.4
79;2021-09-14;352;1078;382;291205;276581;1761;90.1;85.5;0.5
79;2021-09-15;422;1356;367;291627;277937;2128;90.2;86.0;0.7
79;2021-09-16;436;987;325;292063;278924;2453;90.3;86.3;0.8
79;2021-09-17;427;1269;381;292490;280193;2834;90.5;86.7;0.9
79;2021-09-18;149;634;64;292639;280827;2898;90.5;86.8;0.9
79;2021-09-19;1;12;0;292640;280839;2898;90.5;86.9;0.9
79;2021-09-20;186;532;418;292826;281371;3316;90.6;87.0;1.0
79;2021-09-21;314;684;549;293140;282055;3865;90.7;87.2;1.2
79;2021-09-22;216;1007;571;293356;283062;4436;90.7;87.5;1.4
79;2021-09-23;381;568;449;293737;283630;4885;90.8;87.7;1.5
79;2021-09-24;228;1233;312;293965;284863;5197;90.9;88.1;1.6
79;2021-09-25;80;330;48;294045;285193;5245;90.9;88.2;1.6
79;2021-09-26;0;2;4;294045;285195;5249;90.9;88.2;1.6
79;2021-09-27;202;528;234;294247;285723;5483;91.0;88.4;1.7
79;2021-09-28;129;380;393;294376;286103;5876;91.0;88.5;1.8
79;2021-09-29;299;715;455;294675;286818;6331;91.1;88.7;2.0
79;2021-09-30;153;304;353;294828;287122;6684;91.2;88.8;2.1
79;2021-10-01;272;512;531;295100;287634;7215;91.3;89.0;2.2
79;2021-10-02;119;260;99;295219;287894;7314;91.3;89.0;2.3
79;2021-10-03;1;4;0;295220;287898;7314;91.3;89.0;2.3
79;2021-10-04;168;332;286;295388;288230;7600;91.4;89.1;2.4
79;2021-10-05;109;241;404;295497;288471;8004;91.4;89.2;2.5
79;2021-10-06;151;345;559;295648;288816;8563;91.4;89.3;2.6
79;2021-10-07;109;217;478;295757;289033;9041;91.5;89.4;2.8
79;2021-10-08;217;536;350;295974;289569;9391;91.5;89.6;2.9
79;2021-10-09;92;138;57;296066;289707;9448;91.6;89.6;2.9
79;2021-10-10;1;4;8;296067;289711;9456;91.6;89.6;2.9
79;2021-10-11;126;263;512;296193;289974;9968;91.6;89.7;3.1
79;2021-10-12;150;321;461;296343;290295;10429;91.6;89.8;3.2
79;2021-10-13;182;258;515;296525;290553;10944;91.7;89.9;3.4
79;2021-10-14;136;316;533;296661;290869;11477;91.7;90.0;3.5
79;2021-10-15;197;552;652;296858;291421;12129;91.8;90.1;3.8
79;2021-10-16;86;113;109;296944;291534;12238;91.8;90.2;3.8
79;2021-10-17;2;3;2;296946;291537;12240;91.8;90.2;3.8
79;2021-10-18;129;236;519;297075;291773;12759;91.9;90.2;3.9
79;2021-10-19;91;146;458;297166;291919;13217;91.9;90.3;4.1
79;2021-10-20;115;172;637;297281;292091;13854;91.9;90.3;4.3
79;2021-10-21;91;252;347;297372;292343;14201;92.0;90.4;4.4
79;2021-10-22;189;356;701;297561;292699;14902;92.0;90.5;4.6
79;2021-10-23;95;116;183;297656;292815;15085;92.1;90.6;4.7
79;2021-10-24;0;1;0;297656;292816;15085;92.1;90.6;4.7
79;2021-10-25;119;225;665;297775;293041;15750;92.1;90.6;4.9
79;2021-10-26;119;138;786;297894;293179;16536;92.1;90.7;5.1
79;2021-10-27;121;201;753;298015;293380;17289;92.2;90.7;5.3
79;2021-10-28;75;122;745;298090;293502;18034;92.2;90.8;5.6
79;2021-10-29;117;186;933;298207;293688;18967;92.2;90.8;5.9
79;2021-10-30;78;103;284;298285;293791;19251;92.2;90.9;6.0
79;2021-10-31;0;1;2;298285;293792;19253;92.2;90.9;6.0
79;2021-11-01;4;3;0;298289;293795;19253;92.2;90.9;6.0
79;2021-11-02;94;160;938;298383;293955;20191;92.3;90.9;6.2
79;2021-11-03;109;191;917;298492;294146;21108;92.3;91.0;6.5
79;2021-11-04;107;103;1066;298599;294249;22174;92.3;91.0;6.9
79;2021-11-05;180;299;1266;298779;294548;23440;92.4;91.1;7.2
79;2021-11-06;64;121;321;298843;294669;23761;92.4;91.1;7.3
79;2021-11-07;0;4;2;298843;294673;23763;92.4;91.1;7.3
79;2021-11-08;84;163;1228;298927;294836;24991;92.4;91.2;7.7
79;2021-11-09;86;130;1342;299013;294966;26333;92.5;91.2;8.1
79;2021-11-10;132;167;1422;299145;295133;27755;92.5;91.3;8.6
79;2021-11-11;0;2;24;299145;295135;27779;92.5;91.3;8.6
79;2021-11-12;100;207;1339;299245;295342;29118;92.5;91.3;9.0
79;2021-11-13;56;99;378;299301;295441;29496;92.6;91.4;9.1
79;2021-11-14;0;2;3;299301;295443;29499;92.6;91.4;9.1
79;2021-11-15;76;135;1274;299377;295578;30773;92.6;91.4;9.5
79;2021-11-16;69;131;1692;299446;295709;32465;92.6;91.5;10.0
79;2021-11-17;127;146;1435;299573;295855;33900;92.6;91.5;10.5
79;2021-11-18;77;115;1724;299650;295970;35624;92.7;91.5;11.0
79;2021-11-19;151;147;1827;299801;296117;37451;92.7;91.6;11.6
79;2021-11-20;90;79;377;299891;296196;37828;92.7;91.6;11.7
79;2021-11-21;2;2;12;299893;296198;37840;92.7;91.6;11.7
79;2021-11-22;77;46;1361;299970;296244;39201;92.8;91.6;12.1
79;2021-11-23;118;81;1973;300088;296325;41174;92.8;91.6;12.7
79;2021-11-24;151;113;1468;300239;296438;42642;92.9;91.7;13.2
79;2021-11-25;100;107;1731;300339;296545;44373;92.9;91.7;13.7
79;2021-11-26;147;193;2085;300486;296738;46458;92.9;91.8;14.4
79;2021-11-27;69;79;961;300555;296817;47419;92.9;91.8;14.7
79;2021-11-28;2;2;34;300557;296819;47453;92.9;91.8;14.7
79;2021-11-29;95;109;2196;300652;296928;49649;93.0;91.8;15.4
79;2021-11-30;110;77;2368;300762;297005;52017;93.0;91.9;16.1
79;2021-12-01;91;85;2616;300853;297090;54633;93.0;91.9;16.9
79;2021-12-02;74;75;2839;300927;297165;57472;93.1;91.9;17.8
79;2021-12-03;79;138;3201;301006;297303;60673;93.1;91.9;18.8
79;2021-12-04;48;57;1086;301054;297360;61759;93.1;92.0;19.1
79;2021-12-05;9;5;172;301063;297365;61931;93.1;92.0;19.2
79;2021-12-06;77;93;3013;301140;297458;64944;93.1;92.0;20.1
79;2021-12-07;78;108;3954;301218;297566;68898;93.2;92.0;21.3
79;2021-12-08;92;146;4087;301310;297712;72985;93.2;92.1;22.6
79;2021-12-09;97;85;4343;301407;297797;77328;93.2;92.1;23.9
79;2021-12-10;82;148;3932;301489;297945;81260;93.2;92.1;25.1
79;2021-12-11;63;92;1815;301552;298037;83075;93.3;92.2;25.7
79;2021-12-12;3;11;167;301555;298048;83242;93.3;92.2;25.7
79;2021-12-13;87;98;3878;301642;298146;87120;93.3;92.2;26.9
79;2021-12-14;86;128;5056;301728;298274;92176;93.3;92.2;28.5
79;2021-12-15;115;143;4711;301843;298417;96887;93.3;92.3;30.0
79;2021-12-16;107;115;5386;301950;298532;102273;93.4;92.3;31.6
79;2021-12-17;134;217;5930;302084;298749;108203;93.4;92.4;33.5
79;2021-12-18;89;72;2540;302173;298821;110743;93.4;92.4;34.2
79;2021-12-19;6;7;311;302179;298828;111054;93.5;92.4;34.3
80;2020-12-27;0;0;0;0;0;0;0.0;0.0;0.0
80;2020-12-28;0;0;0;0;0;0;0.0;0.0;0.0
80;2020-12-29;11;0;0;11;0;0;0.0;0.0;0.0
80;2020-12-30;0;0;0;11;0;0;0.0;0.0;0.0
80;2020-12-31;0;0;0;11;0;0;0.0;0.0;0.0
80;2021-01-01;0;0;0;11;0;0;0.0;0.0;0.0
80;2021-01-02;2;0;0;13;0;0;0.0;0.0;0.0
80;2021-01-03;1;0;0;14;0;0;0.0;0.0;0.0
80;2021-01-04;0;0;0;14;0;0;0.0;0.0;0.0
80;2021-01-05;4;0;0;18;0;0;0.0;0.0;0.0
80;2021-01-06;34;0;0;52;0;0;0.0;0.0;0.0
80;2021-01-07;270;2;0;322;2;0;0.1;0.0;0.0
80;2021-01-08;340;2;0;662;4;0;0.1;0.0;0.0
80;2021-01-09;125;1;0;787;5;0;0.2;0.0;0.0
80;2021-01-10;26;0;0;813;5;0;0.2;0.0;0.0
80;2021-01-11;279;1;0;1092;6;0;0.2;0.0;0.0
80;2021-01-12;454;1;0;1546;7;0;0.3;0.0;0.0
80;2021-01-13;535;4;0;2081;11;0;0.4;0.0;0.0
80;2021-01-14;458;3;0;2539;14;0;0.5;0.0;0.0
80;2021-01-15;382;1;0;2921;15;0;0.6;0.0;0.0
80;2021-01-16;112;1;0;3033;16;0;0.6;0.0;0.0
80;2021-01-17;132;1;0;3165;17;0;0.6;0.0;0.0
80;2021-01-18;502;3;0;3667;20;0;0.7;0.0;0.0
80;2021-01-19;989;17;0;4656;37;0;0.9;0.0;0.0
80;2021-01-20;1115;10;0;5771;47;0;1.2;0.0;0.0
80;2021-01-21;1098;10;0;6869;57;0;1.4;0.0;0.0
80;2021-01-22;1178;6;0;8047;63;0;1.6;0.0;0.0
80;2021-01-23;885;17;0;8932;80;0;1.8;0.0;0.0
80;2021-01-24;778;9;0;9710;89;0;2.0;0.0;0.0
80;2021-01-25;1502;18;0;11212;107;0;2.3;0.0;0.0
80;2021-01-26;1448;13;0;12660;120;0;2.6;0.0;0.0
80;2021-01-27;844;29;0;13504;149;0;2.7;0.0;0.0
80;2021-01-28;650;170;0;14154;319;0;2.9;0.1;0.0
80;2021-01-29;652;206;0;14806;525;0;3.0;0.1;0.0
80;2021-01-30;96;79;0;14902;604;0;3.0;0.1;0.0
80;2021-01-31;1;2;0;14903;606;0;3.0;0.1;0.0
80;2021-02-01;58;236;0;14961;842;0;3.0;0.2;0.0
80;2021-02-02;74;442;0;15035;1284;0;3.1;0.3;0.0
80;2021-02-03;73;533;0;15108;1817;0;3.1;0.4;0.0
80;2021-02-04;327;353;0;15435;2170;0;3.1;0.4;0.0
80;2021-02-05;391;221;0;15826;2391;0;3.2;0.5;0.0
80;2021-02-06;174;72;0;16000;2463;0;3.2;0.5;0.0
80;2021-02-07;3;8;0;16003;2471;0;3.3;0.5;0.0
80;2021-02-08;437;286;0;16440;2757;0;3.3;0.6;0.0
80;2021-02-09;704;297;0;17144;3054;0;3.5;0.6;0.0
80;2021-02-10;623;507;0;17767;3561;0;3.6;0.7;0.0
80;2021-02-11;856;428;0;18623;3989;0;3.8;0.8;0.0
80;2021-02-12;934;376;0;19557;4365;0;4.0;0.9;0.0
80;2021-02-13;202;408;0;19759;4773;0;4.0;1.0;0.0
80;2021-02-14;77;547;0;19836;5320;0;4.0;1.1;0.0
80;2021-02-15;566;1042;0;20402;6362;0;4.1;1.3;0.0
80;2021-02-16;641;1081;0;21043;7443;0;4.3;1.5;0.0
80;2021-02-17;460;1174;0;21503;8617;0;4.4;1.8;0.0
80;2021-02-18;565;1142;0;22068;9759;0;4.5;2.0;0.0
80;2021-02-19;520;899;0;22588;10658;0;4.6;2.2;0.0
80;2021-02-20;36;499;0;22624;11157;0;4.6;2.3;0.0
80;2021-02-21;47;45;0;22671;11202;0;4.6;2.3;0.0
80;2021-02-22;182;621;0;22853;11823;0;4.6;2.4;0.0
80;2021-02-23;450;711;0;23303;12534;0;4.7;2.5;0.0
80;2021-02-24;464;696;0;23767;13230;0;4.8;2.7;0.0
80;2021-02-25;803;550;0;24570;13780;0;5.0;2.8;0.0
80;2021-02-26;1077;534;0;25647;14314;0;5.2;2.9;0.0
80;2021-02-27;495;75;0;26142;14389;0;5.3;2.9;0.0
80;2021-02-28;46;26;0;26188;14415;0;5.3;2.9;0.0
80;2021-03-01;743;101;0;26931;14516;0;5.5;2.9;0.0
80;2021-03-02;1040;138;0;27971;14654;0;5.7;3.0;0.0
80;2021-03-03;1035;105;0;29006;14759;0;5.9;3.0;0.0
80;2021-03-04;1407;297;0;30413;15056;0;6.2;3.1;0.0
80;2021-03-05;1887;379;0;32300;15435;0;6.6;3.1;0.0
80;2021-03-06;2889;322;0;35189;15757;0;7.1;3.2;0.0
80;2021-03-07;1794;81;0;36983;15838;0;7.5;3.2;0.0
80;2021-03-08;720;602;0;37703;16440;0;7.7;3.3;0.0
80;2021-03-09;1288;879;0;38991;17319;0;7.9;3.5;0.0
80;2021-03-10;1766;758;0;40757;18077;0;8.3;3.7;0.0
80;2021-03-11;1916;822;0;42673;18899;0;8.7;3.8;0.0
80;2021-03-12;3168;735;0;45841;19634;0;9.3;4.0;0.0
80;2021-03-13;4018;232;0;49859;19866;0;10.1;4.0;0.0
80;2021-03-14;426;18;0;50285;19884;0;10.2;4.0;0.0
80;2021-03-15;1091;272;0;51376;20156;0;10.4;4.1;0.0
80;2021-03-16;904;366;0;52280;20522;0;10.6;4.2;0.0
80;2021-03-17;722;274;0;53002;20796;0;10.8;4.2;0.0
80;2021-03-18;1074;313;0;54076;21109;0;11.0;4.3;0.0
80;2021-03-19;1801;412;0;55877;21521;0;11.3;4.4;0.0
80;2021-03-20;3825;116;0;59702;21637;0;12.1;4.4;0.0
80;2021-03-21;624;35;0;60326;21672;0;12.3;4.4;0.0
80;2021-03-22;1023;317;0;61349;21989;0;12.5;4.5;0.0
80;2021-03-23;1906;432;0;63255;22421;0;12.8;4.6;0.0
80;2021-03-24;1805;477;0;65060;22898;0;13.2;4.7;0.0
80;2021-03-25;2838;468;0;67898;23366;0;13.8;4.7;0.0
80;2021-03-26;3256;444;0;71154;23810;0;14.5;4.8;0.0
80;2021-03-27;2388;227;0;73542;24037;0;14.9;4.9;0.0
80;2021-03-28;737;93;0;74279;24130;0;15.1;4.9;0.0
80;2021-03-29;2026;764;0;76305;24894;0;15.5;5.1;0.0
80;2021-03-30;2054;884;0;78359;25778;0;15.9;5.2;0.0
80;2021-03-31;1638;1014;0;79997;26792;0;16.2;5.4;0.0
80;2021-04-01;2142;1471;0;82139;28263;0;16.7;5.7;0.0
80;2021-04-02;2896;1603;0;85035;29866;0;17.3;6.1;0.0
80;2021-04-03;3095;857;0;88130;30723;0;17.9;6.2;0.0
80;2021-04-04;238;37;0;88368;30760;0;17.9;6.2;0.0
80;2021-04-05;787;201;0;89155;30961;0;18.1;6.3;0.0
80;2021-04-06;1406;992;0;90561;31953;0;18.4;6.5;0.0
80;2021-04-07;1713;1185;0;92274;33138;0;18.7;6.7;0.0
80;2021-04-08;2239;931;0;94513;34069;0;19.2;6.9;0.0
80;2021-04-09;3585;1406;0;98098;35475;0;19.9;7.2;0.0
80;2021-04-10;2690;1892;0;100788;37367;0;20.5;7.6;0.0
80;2021-04-11;280;228;0;101068;37595;0;20.5;7.6;0.0
80;2021-04-12;1942;585;0;103010;38180;0;20.9;7.8;0.0
80;2021-04-13;2484;1046;0;105494;39226;0;21.4;8.0;0.0
80;2021-04-14;2871;1197;0;108365;40423;0;22.0;8.2;0.0
80;2021-04-15;3701;932;0;112066;41355;0;22.8;8.4;0.0
80;2021-04-16;3441;1008;0;115507;42363;0;23.5;8.6;0.0
80;2021-04-17;1759;2362;0;117266;44725;0;23.8;9.1;0.0
80;2021-04-18;401;488;0;117667;45213;0;23.9;9.2;0.0
80;2021-04-19;1042;902;0;118709;46115;0;24.1;9.4;0.0
80;2021-04-20;1708;960;0;120417;47075;0;24.5;9.6;0.0
80;2021-04-21;1741;1053;0;122158;48128;0;24.8;9.8;0.0
80;2021-04-22;2207;1356;0;124365;49484;0;25.3;10.0;0.0
80;2021-04-23;2693;1411;0;127058;50895;0;25.8;10.3;0.0
80;2021-04-24;1495;1336;0;128553;52231;0;26.1;10.6;0.0
80;2021-04-25;275;594;0;128828;52825;0;26.2;10.7;0.0
80;2021-04-26;1455;1501;0;130283;54326;0;26.5;11.0;0.0
80;2021-04-27;2157;1520;0;132440;55846;0;26.9;11.3;0.0
80;2021-04-28;2345;1518;0;134785;57364;0;27.4;11.7;0.0
80;2021-04-29;3349;2059;0;138134;59423;0;28.1;12.1;0.0
80;2021-04-30;3226;2984;0;141360;62407;0;28.7;12.7;0.0
80;2021-05-01;1090;747;0;142450;63154;0;28.9;12.8;0.0
80;2021-05-02;530;130;0;142980;63284;0;29.0;12.9;0.0
80;2021-05-03;2785;1282;0;145765;64566;0;29.6;13.1;0.0
80;2021-05-04;2667;1815;0;148432;66381;0;30.1;13.5;0.0
80;2021-05-05;3463;1998;0;151895;68379;0;30.8;13.9;0.0
80;2021-05-06;3303;2523;0;155198;70902;0;31.5;14.4;0.0
80;2021-05-07;3572;2701;0;158770;73603;0;32.2;14.9;0.0
80;2021-05-08;2979;883;0;161749;74486;0;32.8;15.1;0.0
80;2021-05-09;1647;301;0;163396;74787;0;33.2;15.2;0.0
80;2021-05-10;2039;1963;0;165435;76750;0;33.6;15.6;0.0
80;2021-05-11;3384;1922;0;168819;78672;0;34.3;16.0;0.0
80;2021-05-12;4647;1693;0;173466;80365;0;35.2;16.3;0.0
80;2021-05-13;3933;429;0;177399;80794;0;36.0;16.4;0.0
80;2021-05-14;5200;1457;0;182599;82251;0;37.1;16.7;0.0
80;2021-05-15;5906;1043;0;188505;83294;0;38.3;16.9;0.0
80;2021-05-16;2811;313;0;191316;83607;0;38.9;17.0;0.0
80;2021-05-17;2564;916;0;193880;84523;0;39.4;17.2;0.0
80;2021-05-18;3922;926;0;197802;85449;0;40.2;17.4;0.0
80;2021-05-19;4013;1036;0;201815;86485;0;41.0;17.6;0.0
80;2021-05-20;4664;1259;0;206479;87744;0;41.9;17.8;0.0
80;2021-05-21;4949;1693;0;211428;89437;0;42.9;18.2;0.0
80;2021-05-22;5185;1210;0;216613;90647;0;44.0;18.4;0.0
80;2021-05-23;2015;262;0;218628;90909;0;44.4;18.5;0.0
80;2021-05-24;1788;209;0;220416;91118;0;44.8;18.5;0.0
80;2021-05-25;2807;1237;0;223223;92355;0;45.3;18.8;0.0
80;2021-05-26;4352;1766;0;227575;94121;0;46.2;19.1;0.0
80;2021-05-27;4042;2469;0;231617;96590;0;47.0;19.6;0.0
80;2021-05-28;3886;2992;0;235503;99582;0;47.8;20.2;0.0
80;2021-05-29;3723;1670;0;239226;101252;0;48.6;20.6;0.0
80;2021-05-30;1215;206;0;240441;101458;0;48.8;20.6;0.0
80;2021-05-31;2715;1460;0;243156;102918;0;49.4;20.9;0.0
80;2021-06-01;4053;2503;0;247209;105421;0;50.2;21.4;0.0
80;2021-06-02;3322;2097;0;250531;107518;0;50.9;21.8;0.0
80;2021-06-03;4240;3048;0;254771;110566;0;51.7;22.5;0.0
80;2021-06-04;4633;3164;0;259404;113730;0;52.7;23.1;0.0
80;2021-06-05;3482;2216;0;262886;115946;0;53.4;23.5;0.0
80;2021-06-06;854;227;0;263740;116173;0;53.6;23.6;0.0
80;2021-06-07;1866;2095;0;265606;118268;0;53.9;24.0;0.0
80;2021-06-08;2732;2761;0;268338;121029;0;54.5;24.6;0.0
80;2021-06-09;2916;2822;0;271254;123851;0;55.1;25.2;0.0
80;2021-06-10;3132;3265;0;274386;127116;0;55.7;25.8;0.0
80;2021-06-11;3165;3954;0;277551;131070;0;56.4;26.6;0.0
80;2021-06-12;3028;2430;0;280579;133500;0;57.0;27.1;0.0
80;2021-06-13;546;545;0;281125;134045;0;57.1;27.2;0.0
80;2021-06-14;1395;3022;0;282520;137067;0;57.4;27.8;0.0
80;2021-06-15;2359;3582;0;284879;140649;0;57.9;28.6;0.0
80;2021-06-16;1654;4343;0;286533;144992;0;58.2;29.4;0.0
80;2021-06-17;2452;3815;0;288985;148807;0;58.7;30.2;0.0
80;2021-06-18;2574;4139;0;291559;152946;0;59.2;31.1;0.0
80;2021-06-19;2891;4480;0;294450;157426;0;59.8;32.0;0.0
80;2021-06-20;326;1250;0;294776;158676;0;59.9;32.2;0.0
80;2021-06-21;1073;2820;0;295849;161496;0;60.1;32.8;0.0
80;2021-06-22;1242;4145;0;297091;165641;0;60.3;33.6;0.0
80;2021-06-23;1796;5244;0;298887;170885;0;60.7;34.7;0.0
80;2021-06-24;1787;4779;0;300674;175664;0;61.1;35.7;0.0
80;2021-06-25;1423;6193;0;302097;181857;0;61.4;36.9;0.0
80;2021-06-26;1896;6211;0;303993;188068;0;61.7;38.2;0.0
80;2021-06-27;412;2214;0;304405;190282;0;61.8;38.6;0.0
80;2021-06-28;997;3403;0;305402;193685;0;62.0;39.3;0.0
80;2021-06-29;1865;4707;0;307267;198392;0;62.4;40.3;0.0
80;2021-06-30;1297;4838;0;308564;203230;0;62.7;41.3;0.0
80;2021-07-01;1668;5067;0;310232;208297;0;63.0;42.3;0.0
80;2021-07-02;1897;6098;0;312129;214395;0;63.4;43.5;0.0
80;2021-07-03;1355;5419;0;313484;219814;0;63.7;44.6;0.0
80;2021-07-04;777;1698;0;314261;221512;0;63.8;45.0;0.0
80;2021-07-05;971;3239;0;315232;224751;0;64.0;45.6;0.0
80;2021-07-06;1854;4061;0;317086;228812;0;64.4;46.5;0.0
80;2021-07-07;1557;4598;0;318643;233410;0;64.7;47.4;0.0
80;2021-07-08;2113;4995;0;320756;238405;0;65.1;48.4;0.0
80;2021-07-09;2606;5418;0;323362;243823;0;65.7;49.5;0.0
80;2021-07-10;1633;4145;0;324995;247968;0;66.0;50.4;0.0
80;2021-07-11;448;949;0;325443;248917;0;66.1;50.6;0.0
80;2021-07-12;951;3600;0;326394;252517;0;66.3;51.3;0.0
80;2021-07-13;2165;5191;0;328559;257708;0;66.7;52.3;0.0
80;2021-07-14;2725;1641;0;331284;259349;0;67.3;52.7;0.0
80;2021-07-15;2865;5310;0;334149;264659;0;67.9;53.7;0.0
80;2021-07-16;3864;5770;0;338013;270429;0;68.6;54.9;0.0
80;2021-07-17;3323;4368;0;341336;274797;0;69.3;55.8;0.0
80;2021-07-18;1025;1019;0;342361;275816;0;69.5;56.0;0.0
80;2021-07-19;2272;3184;0;344633;279000;0;70.0;56.7;0.0
80;2021-07-20;3316;4946;0;347949;283946;0;70.7;57.7;0.0
80;2021-07-21;3496;4407;0;351445;288353;0;71.4;58.6;0.0
80;2021-07-22;4164;4564;0;355609;292917;0;72.2;59.5;0.0
80;2021-07-23;4948;4741;0;360557;297658;0;73.2;60.5;0.0
80;2021-07-24;4084;4302;0;364641;301960;0;74.1;61.3;0.0
80;2021-07-25;1226;725;0;365867;302685;0;74.3;61.5;0.0
80;2021-07-26;2684;2451;0;368551;305136;0;74.8;62.0;0.0
80;2021-07-27;4147;3701;0;372698;308837;0;75.7;62.7;0.0
80;2021-07-28;4691;2790;0;377389;311627;0;76.6;63.3;0.0
80;2021-07-29;4794;3248;0;382183;314875;0;77.6;63.9;0.0
80;2021-07-30;4754;3627;0;386937;318502;0;78.6;64.7;0.0
80;2021-07-31;3905;2983;0;390842;321485;0;79.4;65.3;0.0
80;2021-08-01;1319;421;0;392161;321906;0;79.6;65.4;0.0
80;2021-08-02;2098;1879;0;394259;323785;0;80.1;65.8;0.0
80;2021-08-03;3466;2448;0;397725;326233;0;80.8;66.3;0.0
80;2021-08-04;3219;2519;0;400944;328752;0;81.4;66.8;0.0
80;2021-08-05;3060;2615;0;404004;331367;0;82.0;67.3;0.0
80;2021-08-06;3044;2882;0;407048;334249;0;82.7;67.9;0.0
80;2021-08-07;2304;2537;0;409352;336786;0;83.1;68.4;0.0
80;2021-08-08;652;814;0;410004;337600;0;83.3;68.6;0.0
80;2021-08-09;1407;2215;0;411411;339815;0;83.6;69.0;0.0
80;2021-08-10;2250;2883;0;413661;342698;0;84.0;69.6;0.0
80;2021-08-11;1819;2442;0;415480;345140;0;84.4;70.1;0.0
80;2021-08-12;2090;2683;0;417570;347823;0;84.8;70.6;0.0
80;2021-08-13;1804;3000;0;419374;350823;0;85.2;71.2;0.0
80;2021-08-14;1279;1991;0;420653;352814;0;85.4;71.7;0.0
80;2021-08-15;377;669;0;421030;353483;0;85.5;71.8;0.0
80;2021-08-16;974;2646;0;422004;356129;0;85.7;72.3;0.0
80;2021-08-17;1610;3499;0;423614;359628;0;86.0;73.0;0.0
80;2021-08-18;1146;3629;0;424760;363257;0;86.3;73.8;0.0
80;2021-08-19;1425;3830;0;426185;367087;0;86.6;74.6;0.0
80;2021-08-20;1210;4308;0;427395;371395;0;86.8;75.4;0.0
80;2021-08-21;983;2748;0;428378;374143;0;87.0;76.0;0.0
80;2021-08-22;133;797;0;428511;374940;0;87.0;76.1;0.0
80;2021-08-23;616;3185;0;429127;378125;0;87.2;76.8;0.0
80;2021-08-24;1057;4311;0;430184;382436;0;87.4;77.7;0.0
80;2021-08-25;913;3532;0;431097;385968;0;87.6;78.4;0.0
80;2021-08-26;951;3797;0;432048;389765;0;87.7;79.2;0.0
80;2021-08-27;1030;4340;0;433078;394105;0;88.0;80.0;0.0
80;2021-08-28;655;3219;0;433733;397324;0;88.1;80.7;0.0
80;2021-08-29;193;665;0;433926;397989;0;88.1;80.8;0.0
80;2021-08-30;526;2398;32;434452;400387;32;88.2;81.3;0.0
80;2021-08-31;734;3090;89;435186;403477;121;88.4;81.9;0.0
80;2021-09-01;687;2226;184;435873;405703;305;88.5;82.4;0.1
80;2021-09-02;571;2046;208;436444;407749;513;88.6;82.8;0.1
80;2021-09-03;759;2708;324;437203;410457;837;88.8;83.4;0.2
80;2021-09-04;910;2471;170;438113;412928;1007;89.0;83.9;0.2
80;2021-09-05;162;407;38;438275;413335;1045;89.0;83.9;0.2
80;2021-09-06;410;1361;285;438685;414696;1330;89.1;84.2;0.3
80;2021-09-07;497;1567;274;439182;416263;1604;89.2;84.5;0.3
80;2021-09-08;464;1476;369;439646;417739;1973;89.3;84.8;0.4
80;2021-09-09;521;1395;266;440167;419134;2239;89.4;85.1;0.5
80;2021-09-10;645;1691;395;440812;420825;2634;89.5;85.5;0.5
80;2021-09-11;485;1757;167;441297;422582;2801;89.6;85.8;0.6
80;2021-09-12;73;290;23;441370;422872;2824;89.6;85.9;0.6
80;2021-09-13;324;804;419;441694;423676;3243;89.7;86.0;0.7
80;2021-09-14;599;979;582;442293;424655;3825;89.8;86.2;0.8
80;2021-09-15;377;995;540;442670;425650;4365;89.9;86.4;0.9
80;2021-09-16;482;978;435;443152;426628;4800;90.0;86.6;1.0
80;2021-09-17;521;1193;642;443673;427821;5442;90.1;86.9;1.1
80;2021-09-18;326;1143;265;443999;428964;5707;90.2;87.1;1.2
80;2021-09-19;14;156;19;444013;429120;5726;90.2;87.2;1.2
80;2021-09-20;313;457;343;444326;429577;6069;90.2;87.2;1.2
80;2021-09-21;273;567;546;444599;430144;6615;90.3;87.4;1.3
80;2021-09-22;271;700;579;444870;430844;7194;90.3;87.5;1.5
80;2021-09-23;305;528;610;445175;431372;7804;90.4;87.6;1.6
80;2021-09-24;384;915;713;445559;432287;8517;90.5;87.8;1.7
80;2021-09-25;286;1053;350;445845;433340;8867;90.5;88.0;1.8
80;2021-09-26;12;99;11;445857;433439;8878;90.5;88.0;1.8
80;2021-09-27;178;545;415;446035;433984;9293;90.6;88.1;1.9
80;2021-09-28;156;397;471;446191;434381;9764;90.6;88.2;2.0
80;2021-09-29;283;544;458;446474;434925;10222;90.7;88.3;2.1
80;2021-09-30;197;344;493;446671;435269;10715;90.7;88.4;2.2
80;2021-10-01;333;731;850;447004;436000;11565;90.8;88.5;2.3
80;2021-10-02;316;802;317;447320;436802;11882;90.8;88.7;2.4
80;2021-10-03;17;61;30;447337;436863;11912;90.8;88.7;2.4
80;2021-10-04;157;336;487;447494;437199;12399;90.9;88.8;2.5
80;2021-10-05;159;441;537;447653;437640;12936;90.9;88.9;2.6
80;2021-10-06;272;446;564;447925;438086;13500;91.0;89.0;2.7
80;2021-10-07;197;446;509;448122;438532;14009;91.0;89.1;2.8
80;2021-10-08;278;717;887;448400;439249;14896;91.1;89.2;3.0
80;2021-10-09;268;457;456;448668;439706;15352;91.1;89.3;3.1
80;2021-10-10;22;16;38;448690;439722;15390;91.1;89.3;3.1
80;2021-10-11;156;221;671;448846;439943;16061;91.2;89.3;3.3
80;2021-10-12;178;389;746;449024;440332;16807;91.2;89.4;3.4
80;2021-10-13;197;278;745;449221;440610;17552;91.2;89.5;3.6
80;2021-10-14;212;319;630;449433;440929;18182;91.3;89.5;3.7
80;2021-10-15;318;527;1196;449751;441456;19378;91.3;89.7;3.9
80;2021-10-16;225;369;556;449976;441825;19934;91.4;89.7;4.0
80;2021-10-17;19;17;41;449995;441842;19975;91.4;89.7;4.1
80;2021-10-18;165;307;688;450160;442149;20663;91.4;89.8;4.2
80;2021-10-19;108;167;608;450268;442316;21271;91.4;89.8;4.3
80;2021-10-20;186;266;737;450454;442582;22008;91.5;89.9;4.5
80;2021-10-21;177;282;875;450631;442864;22883;91.5;89.9;4.6
80;2021-10-22;269;384;1278;450900;443248;24161;91.6;90.0;4.9
80;2021-10-23;202;299;688;451102;443547;24849;91.6;90.1;5.0
80;2021-10-24;16;27;28;451118;443574;24877;91.6;90.1;5.1
80;2021-10-25;121;164;809;451239;443738;25686;91.6;90.1;5.2
80;2021-10-26;117;148;866;451356;443886;26552;91.7;90.1;5.4
80;2021-10-27;159;234;889;451515;444120;27441;91.7;90.2;5.6
80;2021-10-28;168;203;765;451683;444323;28206;91.7;90.2;5.7
80;2021-10-29;223;294;1312;451906;444617;29518;91.8;90.3;6.0
80;2021-10-30;158;239;769;452064;444856;30287;91.8;90.3;6.2
80;2021-10-31;12;21;28;452076;444877;30315;91.8;90.4;6.2
80;2021-11-01;7;13;11;452083;444890;30326;91.8;90.4;6.2
80;2021-11-02;180;206;945;452263;445096;31271;91.9;90.4;6.4
80;2021-11-03;86;217;866;452349;445313;32137;91.9;90.4;6.5
80;2021-11-04;134;205;761;452483;445518;32898;91.9;90.5;6.7
80;2021-11-05;251;349;1405;452734;445867;34303;91.9;90.6;7.0
80;2021-11-06;192;269;1017;452926;446136;35320;92.0;90.6;7.2
80;2021-11-07;9;28;54;452935;446164;35374;92.0;90.6;7.2
80;2021-11-08;98;138;871;453033;446302;36245;92.0;90.6;7.4
80;2021-11-09;119;178;1447;453152;446480;37692;92.0;90.7;7.7
80;2021-11-10;155;173;1356;453307;446653;39048;92.1;90.7;7.9
80;2021-11-11;8;9;95;453315;446662;39143;92.1;90.7;7.9
80;2021-11-12;229;319;1641;453544;446981;40784;92.1;90.8;8.3
80;2021-11-13;133;220;1043;453677;447201;41827;92.1;90.8;8.5
80;2021-11-14;22;15;81;453699;447216;41908;92.1;90.8;8.5
80;2021-11-15;95;127;853;453794;447343;42761;92.2;90.9;8.7
80;2021-11-16;144;153;1675;453938;447496;44436;92.2;90.9;9.0
80;2021-11-17;148;180;1285;454086;447676;45721;92.2;90.9;9.3
80;2021-11-18;144;189;1610;454230;447865;47331;92.2;91.0;9.6
80;2021-11-19;278;346;2365;454508;448211;49696;92.3;91.0;10.1
80;2021-11-20;245;261;1440;454753;448472;51136;92.4;91.1;10.4
80;2021-11-21;19;24;92;454772;448496;51228;92.4;91.1;10.4
80;2021-11-22;122;89;1191;454894;448585;52419;92.4;91.1;10.6
80;2021-11-23;145;129;1826;455039;448714;54245;92.4;91.1;11.0
80;2021-11-24;178;138;1670;455217;448852;55915;92.5;91.2;11.4
80;2021-11-25;163;177;2043;455380;449029;57958;92.5;91.2;11.8
80;2021-11-26;242;278;3921;455622;449307;61879;92.5;91.3;12.6
80;2021-11-27;180;238;4349;455802;449545;66228;92.6;91.3;13.5
80;2021-11-28;17;25;1190;455819;449570;67418;92.6;91.3;13.7
80;2021-11-29;97;117;3148;455916;449687;70566;92.6;91.3;14.3
80;2021-11-30;133;149;4975;456049;449836;75541;92.6;91.4;15.3
80;2021-12-01;120;179;4519;456169;450015;80060;92.6;91.4;16.3
80;2021-12-02;162;97;5893;456331;450112;85953;92.7;91.4;17.5
80;2021-12-03;187;232;7106;456518;450344;93059;92.7;91.5;18.9
80;2021-12-04;160;152;6468;456678;450496;99527;92.7;91.5;20.2
80;2021-12-05;39;44;1571;456717;450540;101098;92.8;91.5;20.5
80;2021-12-06;105;138;4288;456822;450678;105386;92.8;91.5;21.4
80;2021-12-07;113;139;6560;456935;450817;111946;92.8;91.6;22.7
80;2021-12-08;139;187;6299;457074;451004;118245;92.8;91.6;24.0
80;2021-12-09;137;135;7012;457211;451139;125257;92.9;91.6;25.4
80;2021-12-10;155;246;8784;457366;451385;134041;92.9;91.7;27.2
80;2021-12-11;157;203;6640;457523;451588;140681;92.9;91.7;28.6
80;2021-12-12;42;33;2325;457565;451621;143006;92.9;91.7;29.0
80;2021-12-13;82;112;5061;457647;451733;148067;92.9;91.7;30.1
80;2021-12-14;171;184;7421;457818;451917;155488;93.0;91.8;31.6
80;2021-12-15;161;176;7223;457979;452093;162711;93.0;91.8;33.0
80;2021-12-16;163;183;7961;458142;452276;170672;93.0;91.9;34.7
80;2021-12-17;222;287;8701;458364;452563;179373;93.1;91.9;36.4
80;2021-12-18;181;192;6674;458545;452755;186047;93.1;92.0;37.8
80;2021-12-19;33;36;1829;458578;452791;187876;93.1;92.0;38.2
81;2020-12-27;0;0;0;0;0;0;0.0;0.0;0.0
81;2020-12-28;0;0;0;0;0;0;0.0;0.0;0.0
81;2020-12-29;0;0;0;0;0;0;0.0;0.0;0.0
81;2020-12-30;0;0;0;0;0;0;0.0;0.0;0.0
81;2020-12-31;1;1;0;1;1;0;0.0;0.0;0.0
81;2021-01-01;0;0;0;1;1;0;0.0;0.0;0.0
81;2021-01-02;0;0;0;1;1;0;0.0;0.0;0.0
81;2021-01-03;0;0;0;1;1;0;0.0;0.0;0.0
81;2021-01-04;1;0;0;2;1;0;0.0;0.0;0.0
81;2021-01-05;2;0;0;4;1;0;0.0;0.0;0.0
81;2021-01-06;7;0;0;11;1;0;0.0;0.0;0.0
81;2021-01-07;269;0;0;280;1;0;0.1;0.0;0.0
81;2021-01-08;311;1;0;591;2;0;0.2;0.0;0.0
81;2021-01-09;71;1;0;662;3;0;0.2;0.0;0.0
81;2021-01-10;4;0;0;666;3;0;0.2;0.0;0.0
81;2021-01-11;146;0;0;812;3;0;0.2;0.0;0.0
81;2021-01-12;250;0;0;1062;3;0;0.3;0.0;0.0
81;2021-01-13;268;1;0;1330;4;0;0.4;0.0;0.0
81;2021-01-14;970;7;0;2300;11;0;0.7;0.0;0.0
81;2021-01-15;572;4;0;2872;15;0;0.8;0.0;0.0
81;2021-01-16;80;2;0;2952;17;0;0.9;0.0;0.0
81;2021-01-17;3;0;0;2955;17;0;0.9;0.0;0.0
81;2021-01-18;566;2;0;3521;19;0;1.0;0.0;0.0
81;2021-01-19;708;5;0;4229;24;0;1.2;0.0;0.0
81;2021-01-20;813;3;0;5042;27;0;1.5;0.0;0.0
81;2021-01-21;1205;13;0;6247;40;0;1.8;0.0;0.0
81;2021-01-22;851;3;0;7098;43;0;2.1;0.0;0.0
81;2021-01-23;227;2;0;7325;45;0;2.2;0.0;0.0
81;2021-01-24;100;0;0;7425;45;0;2.2;0.0;0.0
81;2021-01-25;563;6;0;7988;51;0;2.4;0.0;0.0
81;2021-01-26;635;7;0;8623;58;0;2.5;0.0;0.0
81;2021-01-27;581;3;0;9204;61;0;2.7;0.0;0.0
81;2021-01-28;659;226;0;9863;287;0;2.9;0.1;0.0
81;2021-01-29;317;187;0;10180;474;0;3.0;0.1;0.0
81;2021-01-30;197;38;0;10377;512;0;3.1;0.2;0.0
81;2021-01-31;98;1;0;10475;513;0;3.1;0.2;0.0
81;2021-02-01;296;171;0;10771;684;0;3.2;0.2;0.0
81;2021-02-02;441;182;0;11212;866;0;3.3;0.3;0.0
81;2021-02-03;477;288;0;11689;1154;0;3.4;0.3;0.0
81;2021-02-04;1374;700;0;13063;1854;0;3.8;0.5;0.0
81;2021-02-05;822;325;0;13885;2179;0;4.1;0.6;0.0
81;2021-02-06;242;19;0;14127;2198;0;4.2;0.6;0.0
81;2021-02-07;97;1;0;14224;2199;0;4.2;0.6;0.0
81;2021-02-08;272;226;0;14496;2425;0;4.3;0.7;0.0
81;2021-02-09;430;273;0;14926;2698;0;4.4;0.8;0.0
81;2021-02-10;376;338;0;15302;3036;0;4.5;0.9;0.0
81;2021-02-11;657;481;0;15959;3517;0;4.7;1.0;0.0
81;2021-02-12;543;526;0;16502;4043;0;4.9;1.2;0.0
81;2021-02-13;196;163;0;16698;4206;0;4.9;1.2;0.0
81;2021-02-14;93;1;0;16791;4207;0;4.9;1.2;0.0
81;2021-02-15;236;453;0;17027;4660;0;5.0;1.4;0.0
81;2021-02-16;290;636;0;17317;5296;0;5.1;1.6;0.0
81;2021-02-17;248;546;0;17565;5842;0;5.2;1.7;0.0
81;2021-02-18;488;700;0;18053;6542;0;5.3;1.9;0.0
81;2021-02-19;570;432;0;18623;6974;0;5.5;2.1;0.0
81;2021-02-20;317;279;0;18940;7253;0;5.6;2.1;0.0
81;2021-02-21;22;81;0;18962;7334;0;5.6;2.2;0.0
81;2021-02-22;232;539;0;19194;7873;0;5.7;2.3;0.0
81;2021-02-23;185;593;0;19379;8466;0;5.7;2.5;0.0
81;2021-02-24;298;667;0;19677;9133;0;5.8;2.7;0.0
81;2021-02-25;715;1018;0;20392;10151;0;6.0;3.0;0.0
81;2021-02-26;943;927;0;21335;11078;0;6.3;3.3;0.0
81;2021-02-27;283;234;0;21618;11312;0;6.4;3.3;0.0
81;2021-02-28;18;85;0;21636;11397;0;6.4;3.4;0.0
81;2021-03-01;233;416;0;21869;11813;0;6.4;3.5;0.0
81;2021-03-02;388;506;0;22257;12319;0;6.6;3.6;0.0
81;2021-03-03;485;444;0;22742;12763;0;6.7;3.8;0.0
81;2021-03-04;1118;458;0;23860;13221;0;7.0;3.9;0.0
81;2021-03-05;1402;409;0;25262;13630;0;7.4;4.0;0.0
81;2021-03-06;1010;164;0;26272;13794;0;7.7;4.1;0.0
81;2021-03-07;189;92;0;26461;13886;0;7.8;4.1;0.0
81;2021-03-08;484;359;0;26945;14245;0;7.9;4.2;0.0
81;2021-03-09;826;365;0;27771;14610;0;8.2;4.3;0.0
81;2021-03-10;926;398;0;28697;15008;0;8.5;4.4;0.0
81;2021-03-11;1380;371;0;30077;15379;0;8.9;4.5;0.0
81;2021-03-12;1724;322;0;31801;15701;0;9.4;4.6;0.0
81;2021-03-13;1062;199;0;32863;15900;0;9.7;4.7;0.0
81;2021-03-14;67;78;0;32930;15978;0;9.7;4.7;0.0
81;2021-03-15;1078;239;0;34008;16217;0;10.0;4.8;0.0
81;2021-03-16;737;250;0;34745;16467;0;10.2;4.9;0.0
81;2021-03-17;851;282;0;35596;16749;0;10.5;4.9;0.0
81;2021-03-18;967;571;0;36563;17320;0;10.8;5.1;0.0
81;2021-03-19;1294;472;0;37857;17792;0;11.2;5.2;0.0
81;2021-03-20;698;285;0;38555;18077;0;11.4;5.3;0.0
81;2021-03-21;142;22;0;38697;18099;0;11.4;5.3;0.0
81;2021-03-22;949;285;0;39646;18384;0;11.7;5.4;0.0
81;2021-03-23;1461;231;0;41107;18615;0;12.1;5.5;0.0
81;2021-03-24;1675;297;0;42782;18912;0;12.6;5.6;0.0
81;2021-03-25;2124;362;0;44906;19274;0;13.2;5.7;0.0
81;2021-03-26;2155;301;0;47061;19575;0;13.9;5.8;0.0
81;2021-03-27;1145;42;0;48206;19617;0;14.2;5.8;0.0
81;2021-03-28;716;41;0;48922;19658;0;14.4;5.8;0.0
81;2021-03-29;2792;185;0;51714;19843;0;15.2;5.8;0.0
81;2021-03-30;3088;240;0;54802;20083;0;16.2;5.9;0.0
81;2021-03-31;2694;283;0;57496;20366;0;16.9;6.0;0.0
81;2021-04-01;3324;570;0;60820;20936;0;17.9;6.2;0.0
81;2021-04-02;2658;401;0;63478;21337;0;18.7;6.3;0.0
81;2021-04-03;1149;305;0;64627;21642;0;19.0;6.4;0.0
81;2021-04-04;1333;26;0;65960;21668;0;19.4;6.4;0.0
81;2021-04-05;711;20;0;66671;21688;0;19.6;6.4;0.0
81;2021-04-06;1649;526;0;68320;22214;0;20.1;6.5;0.0
81;2021-04-07;1860;566;0;70180;22780;0;20.7;6.7;0.0
81;2021-04-08;2658;822;0;72838;23602;0;21.5;7.0;0.0
81;2021-04-09;3040;480;0;75878;24082;0;22.4;7.1;0.0
81;2021-04-10;1472;504;0;77350;24586;0;22.8;7.2;0.0
81;2021-04-11;1236;71;0;78586;24657;0;23.2;7.3;0.0
81;2021-04-12;1305;676;0;79891;25333;0;23.5;7.5;0.0
81;2021-04-13;2527;811;0;82418;26144;0;24.3;7.7;0.0
81;2021-04-14;2469;840;0;84887;26984;0;25.0;8.0;0.0
81;2021-04-15;3126;1236;0;88013;28220;0;25.9;8.3;0.0
81;2021-04-16;2735;1100;0;90748;29320;0;26.7;8.6;0.0
81;2021-04-17;1252;338;0;92000;29658;0;27.1;8.7;0.0
81;2021-04-18;497;139;0;92497;29797;0;27.3;8.8;0.0
81;2021-04-19;929;825;0;93426;30622;0;27.5;9.0;0.0
81;2021-04-20;2247;1200;0;95673;31822;0;28.2;9.4;0.0
81;2021-04-21;2155;1065;0;97828;32887;0;28.8;9.7;0.0
81;2021-04-22;2762;1134;0;100590;34021;0;29.6;10.0;0.0
81;2021-04-23;2752;1024;0;103342;35045;0;30.5;10.3;0.0
81;2021-04-24;1258;771;0;104600;35816;0;30.8;10.6;0.0
81;2021-04-25;432;689;0;105032;36505;0;31.0;10.8;0.0
81;2021-04-26;1062;2330;0;106094;38835;0;31.3;11.4;0.0
81;2021-04-27;1516;2341;0;107610;41176;0;31.7;12.1;0.0
81;2021-04-28;1383;2399;0;108993;43575;0;32.1;12.8;0.0
81;2021-04-29;1747;2748;0;110740;46323;0;32.6;13.7;0.0
81;2021-04-30;1931;2322;0;112671;48645;0;33.2;14.3;0.0
81;2021-05-01;379;657;0;113050;49302;0;33.3;14.5;0.0
81;2021-05-02;302;1309;0;113352;50611;0;33.4;14.9;0.0
81;2021-05-03;1102;1205;0;114454;51816;0;33.7;15.3;0.0
81;2021-05-04;2440;1895;0;116894;53711;0;34.4;15.8;0.0
81;2021-05-05;1962;1944;0;118856;55655;0;35.0;16.4;0.0
81;2021-05-06;2658;3420;0;121514;59075;0;35.8;17.4;0.0
81;2021-05-07;1998;2966;0;123512;62041;0;36.4;18.3;0.0
81;2021-05-08;875;944;0;124387;62985;0;36.7;18.6;0.0
81;2021-05-09;572;1278;0;124959;64263;0;36.8;18.9;0.0
81;2021-05-10;838;1624;0;125797;65887;0;37.1;19.4;0.0
81;2021-05-11;1562;2538;0;127359;68425;0;37.5;20.2;0.0
81;2021-05-12;1520;2440;0;128879;70865;0;38.0;20.9;0.0
81;2021-05-13;1167;567;0;130046;71432;0;38.3;21.1;0.0
81;2021-05-14;1804;1660;0;131850;73092;0;38.9;21.5;0.0
81;2021-05-15;1397;596;0;133247;73688;0;39.3;21.7;0.0
81;2021-05-16;1160;385;0;134407;74073;0;39.6;21.8;0.0
81;2021-05-17;1067;884;0;135474;74957;0;39.9;22.1;0.0
81;2021-05-18;1619;1446;0;137093;76403;0;40.4;22.5;0.0
81;2021-05-19;2480;1229;0;139573;77632;0;41.1;22.9;0.0
81;2021-05-20;2768;1348;0;142341;78980;0;41.9;23.3;0.0
81;2021-05-21;2510;1150;0;144851;80130;0;42.7;23.6;0.0
81;2021-05-22;2323;506;0;147174;80636;0;43.4;23.8;0.0
81;2021-05-23;995;72;0;148169;80708;0;43.7;23.8;0.0
81;2021-05-24;678;89;0;148847;80797;0;43.9;23.8;0.0
81;2021-05-25;2223;1071;0;151070;81868;0;44.5;24.1;0.0
81;2021-05-26;1661;850;0;152731;82718;0;45.0;24.4;0.0
81;2021-05-27;2274;1580;0;155005;84298;0;45.7;24.8;0.0
81;2021-05-28;2265;1701;0;157270;85999;0;46.3;25.3;0.0
81;2021-05-29;1211;551;0;158481;86550;0;46.7;25.5;0.0
81;2021-05-30;756;199;0;159237;86749;0;46.9;25.6;0.0
81;2021-05-31;1055;1336;0;160292;88085;0;47.2;26.0;0.0
81;2021-06-01;1699;2608;0;161991;90693;0;47.7;26.7;0.0
81;2021-06-02;1867;2360;0;163858;93053;0;48.3;27.4;0.0
81;2021-06-03;1882;2507;0;165740;95560;0;48.8;28.2;0.0
81;2021-06-04;1924;2854;0;167664;98414;0;49.4;29.0;0.0
81;2021-06-05;1466;1224;0;169130;99638;0;49.8;29.4;0.0
81;2021-06-06;461;356;0;169591;99994;0;50.0;29.5;0.0
81;2021-06-07;1193;1510;0;170784;101504;0;50.3;29.9;0.0
81;2021-06-08;2283;2290;0;173067;103794;0;51.0;30.6;0.0
81;2021-06-09;2348;1781;0;175415;105575;0;51.7;31.1;0.0
81;2021-06-10;1317;1521;0;176732;107096;0;52.1;31.6;0.0
81;2021-06-11;2519;2126;0;179251;109222;0;52.8;32.2;0.0
81;2021-06-12;1579;1009;0;180830;110231;0;53.3;32.5;0.0
81;2021-06-13;514;493;0;181344;110724;0;53.4;32.6;0.0
81;2021-06-14;842;1416;0;182186;112140;0;53.7;33.0;0.0
81;2021-06-15;1656;3356;0;183842;115496;0;54.2;34.0;0.0
81;2021-06-16;1304;2847;0;185146;118343;0;54.6;34.9;0.0
81;2021-06-17;1359;2476;0;186505;120819;0;55.0;35.6;0.0
81;2021-06-18;1861;2632;0;188366;123451;0;55.5;36.4;0.0
81;2021-06-19;882;969;0;189248;124420;0;55.8;36.7;0.0
81;2021-06-20;446;475;0;189694;124895;0;55.9;36.8;0.0
81;2021-06-21;471;1085;0;190165;125980;0;56.0;37.1;0.0
81;2021-06-22;1099;2387;0;191264;128367;0;56.4;37.8;0.0
81;2021-06-23;1143;2059;0;192407;130426;0;56.7;38.4;0.0
81;2021-06-24;1141;1844;0;193548;132270;0;57.0;39.0;0.0
81;2021-06-25;1201;2674;0;194749;134944;0;57.4;39.8;0.0
81;2021-06-26;739;1564;0;195488;136508;0;57.6;40.2;0.0
81;2021-06-27;541;1403;0;196029;137911;0;57.8;40.6;0.0
81;2021-06-28;508;1476;0;196537;139387;0;57.9;41.1;0.0
81;2021-06-29;1056;2495;0;197593;141882;0;58.2;41.8;0.0
81;2021-06-30;1021;2957;0;198614;144839;0;58.5;42.7;0.0
81;2021-07-01;913;2503;0;199527;147342;0;58.8;43.4;0.0
81;2021-07-02;1038;2804;0;200565;150146;0;59.1;44.2;0.0
81;2021-07-03;730;2407;0;201295;152553;0;59.3;45.0;0.0
81;2021-07-04;297;912;0;201592;153465;0;59.4;45.2;0.0
81;2021-07-05;750;1533;0;202342;154998;0;59.6;45.7;0.0
81;2021-07-06;994;2985;1;203336;157983;1;59.9;46.6;0.0
81;2021-07-07;1053;2289;0;204389;160272;1;60.2;47.2;0.0
81;2021-07-08;1016;2152;1;205405;162424;2;60.5;47.9;0.0
81;2021-07-09;1174;2598;0;206579;165022;2;60.9;48.6;0.0
81;2021-07-10;787;1421;0;207366;166443;2;61.1;49.1;0.0
81;2021-07-11;449;921;0;207815;167364;2;61.2;49.3;0.0
81;2021-07-12;782;1649;0;208597;169013;2;61.5;49.8;0.0
81;2021-07-13;2005;2953;0;210602;171966;2;62.1;50.7;0.0
81;2021-07-14;1454;1439;0;212056;173405;2;62.5;51.1;0.0
81;2021-07-15;2451;2718;0;214507;176123;2;63.2;51.9;0.0
81;2021-07-16;2097;2934;0;216604;179057;2;63.8;52.8;0.0
81;2021-07-17;1312;2316;0;217916;181373;2;64.2;53.5;0.0
81;2021-07-18;730;1147;0;218646;182520;2;64.4;53.8;0.0
81;2021-07-19;1171;1755;0;219817;184275;2;64.8;54.3;0.0
81;2021-07-20;2753;2686;0;222570;186961;2;65.6;55.1;0.0
81;2021-07-21;3204;2272;0;225774;189233;2;66.5;55.8;0.0
81;2021-07-22;3209;2047;0;228983;191280;2;67.5;56.4;0.0
81;2021-07-23;2920;3132;0;231903;194412;2;68.3;57.3;0.0
81;2021-07-24;2435;1688;0;234338;196100;2;69.1;57.8;0.0
81;2021-07-25;1555;737;0;235893;196837;2;69.5;58.0;0.0
81;2021-07-26;1871;1542;0;237764;198379;2;70.1;58.5;0.0
81;2021-07-27;3233;2380;0;240997;200759;2;71.0;59.2;0.0
81;2021-07-28;2877;2097;0;243874;202856;2;71.9;59.8;0.0
81;2021-07-29;3133;1754;0;247007;204610;2;72.8;60.3;0.0
81;2021-07-30;2672;2214;0;249679;206824;2;73.6;61.0;0.0
81;2021-07-31;1824;1012;0;251503;207836;2;74.1;61.3;0.0
81;2021-08-01;809;640;0;252312;208476;2;74.4;61.4;0.0
81;2021-08-02;1154;1044;0;253466;209520;2;74.7;61.7;0.0
81;2021-08-03;2214;2017;0;255680;211537;2;75.4;62.3;0.0
81;2021-08-04;1962;1502;0;257642;213039;2;75.9;62.8;0.0
81;2021-08-05;1482;1814;0;259124;214853;2;76.4;63.3;0.0
81;2021-08-06;1649;1980;0;260773;216833;2;76.9;63.9;0.0
81;2021-08-07;959;1086;0;261732;217919;2;77.1;64.2;0.0
81;2021-08-08;428;752;0;262160;218671;2;77.3;64.4;0.0
81;2021-08-09;813;794;0;262973;219465;2;77.5;64.7;0.0
81;2021-08-10;1534;2543;0;264507;222008;2;78.0;65.4;0.0
81;2021-08-11;1109;2345;0;265616;224353;2;78.3;66.1;0.0
81;2021-08-12;1067;2152;0;266683;226505;2;78.6;66.8;0.0
81;2021-08-13;906;2346;0;267589;228851;2;78.9;67.4;0.0
81;2021-08-14;519;1753;0;268108;230604;2;79.0;68.0;0.0
81;2021-08-15;185;1044;0;268293;231648;2;79.1;68.3;0.0
81;2021-08-16;682;1725;0;268975;233373;2;79.3;68.8;0.0
81;2021-08-17;1282;2915;0;270257;236288;2;79.6;69.6;0.0
81;2021-08-18;1020;2295;0;271277;238583;2;79.9;70.3;0.0
81;2021-08-19;923;2182;0;272200;240765;2;80.2;71.0;0.0
81;2021-08-20;912;2253;0;273112;243018;2;80.5;71.6;0.0
81;2021-08-21;489;1575;0;273601;244593;2;80.6;72.1;0.0
81;2021-08-22;215;956;0;273816;245549;2;80.7;72.4;0.0
81;2021-08-23;501;1329;0;274317;246878;2;80.8;72.8;0.0
81;2021-08-24;793;2461;0;275110;249339;2;81.1;73.5;0.0
81;2021-08-25;717;2056;0;275827;251395;2;81.3;74.1;0.0
81;2021-08-26;869;2041;0;276696;253436;2;81.5;74.7;0.0
81;2021-08-27;828;2113;0;277524;255549;2;81.8;75.3;0.0
81;2021-08-28;469;1422;0;277993;256971;2;81.9;75.7;0.0
81;2021-08-29;178;843;0;278171;257814;2;82.0;76.0;0.0
81;2021-08-30;427;1127;27;278598;258941;29;82.1;76.3;0.0
81;2021-08-31;787;1952;92;279385;260893;121;82.3;76.9;0.0
81;2021-09-01;695;1224;171;280080;262117;292;82.5;77.2;0.1
81;2021-09-02;577;1004;207;280657;263121;499;82.7;77.5;0.1
81;2021-09-03;587;1274;193;281244;264395;692;82.9;77.9;0.2
81;2021-09-04;498;898;72;281742;265293;764;83.0;78.2;0.2
81;2021-09-05;119;247;24;281861;265540;788;83.1;78.3;0.2
81;2021-09-06;301;536;197;282162;266076;985;83.2;78.4;0.3
81;2021-09-07;396;1051;268;282558;267127;1253;83.3;78.7;0.4
81;2021-09-08;421;1080;192;282979;268207;1445;83.4;79.0;0.4
81;2021-09-09;383;801;228;283362;269008;1673;83.5;79.3;0.5
81;2021-09-10;409;957;269;283771;269965;1942;83.6;79.6;0.6
81;2021-09-11;395;879;75;284166;270844;2017;83.7;79.8;0.6
81;2021-09-12;79;238;30;284245;271082;2047;83.8;79.9;0.6
81;2021-09-13;241;473;274;284486;271555;2321;83.8;80.0;0.7
81;2021-09-14;490;683;452;284976;272238;2773;84.0;80.2;0.8
81;2021-09-15;444;787;481;285420;273025;3254;84.1;80.5;1.0
81;2021-09-16;346;537;387;285766;273562;3641;84.2;80.6;1.1
81;2021-09-17;430;796;355;286196;274358;3996;84.3;80.9;1.2
81;2021-09-18;267;671;136;286463;275029;4132;84.4;81.1;1.2
81;2021-09-19;57;169;17;286520;275198;4149;84.4;81.1;1.2
81;2021-09-20;136;311;224;286656;275509;4373;84.5;81.2;1.3
81;2021-09-21;263;550;531;286919;276059;4904;84.6;81.4;1.4
81;2021-09-22;201;676;395;287120;276735;5299;84.6;81.6;1.6
81;2021-09-23;162;502;471;287282;277237;5770;84.7;81.7;1.7
81;2021-09-24;299;686;471;287581;277923;6241;84.8;81.9;1.8
81;2021-09-25;168;685;99;287749;278608;6340;84.8;82.1;1.9
81;2021-09-26;34;137;22;287783;278745;6362;84.8;82.1;1.9
81;2021-09-27;137;277;246;287920;279022;6608;84.9;82.2;1.9
81;2021-09-28;178;356;271;288098;279378;6879;84.9;82.3;2.0
81;2021-09-29;233;499;268;288331;279877;7147;85.0;82.5;2.1
81;2021-09-30;150;301;336;288481;280178;7483;85.0;82.6;2.2
81;2021-10-01;289;456;339;288770;280634;7822;85.1;82.7;2.3
81;2021-10-02;198;422;157;288968;281056;7979;85.2;82.8;2.4
81;2021-10-03;52;106;23;289020;281162;8002;85.2;82.9;2.4
81;2021-10-04;111;211;209;289131;281373;8211;85.2;82.9;2.4
81;2021-10-05;149;333;454;289280;281706;8665;85.3;83.0;2.6
81;2021-10-06;215;458;432;289495;282164;9097;85.3;83.2;2.7
81;2021-10-07;153;313;541;289648;282477;9638;85.4;83.2;2.8
81;2021-10-08;209;500;793;289857;282977;10431;85.4;83.4;3.1
81;2021-10-09;151;320;102;290008;283297;10533;85.5;83.5;3.1
81;2021-10-10;45;69;45;290053;283366;10578;85.5;83.5;3.1
81;2021-10-11;135;216;357;290188;283582;10935;85.5;83.6;3.2
81;2021-10-12;131;240;504;290319;283822;11439;85.6;83.6;3.4
81;2021-10-13;208;307;266;290527;284129;11705;85.6;83.7;3.4
81;2021-10-14;136;246;465;290663;284375;12170;85.7;83.8;3.6
81;2021-10-15;257;355;925;290920;284730;13095;85.7;83.9;3.9
81;2021-10-16;190;199;119;291110;284929;13214;85.8;84.0;3.9
81;2021-10-17;3;8;1;291113;284937;13215;85.8;84.0;3.9
81;2021-10-18;105;139;308;291218;285076;13523;85.8;84.0;4.0
81;2021-10-19;142;196;477;291360;285272;14000;85.9;84.1;4.1
81;2021-10-20;175;243;507;291535;285515;14507;85.9;84.1;4.3
81;2021-10-21;114;187;615;291649;285702;15122;86.0;84.2;4.5
81;2021-10-22;194;330;670;291843;286032;15792;86.0;84.3;4.7
81;2021-10-23;122;216;205;291965;286248;15997;86.0;84.4;4.7
81;2021-10-24;43;62;86;292008;286310;16083;86.1;84.4;4.7
81;2021-10-25;127;143;507;292135;286453;16590;86.1;84.4;4.9
81;2021-10-26;104;119;706;292239;286572;17296;86.1;84.5;5.1
81;2021-10-27;104;139;500;292343;286711;17796;86.2;84.5;5.2
81;2021-10-28;69;121;656;292412;286832;18452;86.2;84.5;5.4
81;2021-10-29;145;186;795;292557;287018;19247;86.2;84.6;5.7
81;2021-10-30;132;208;962;292689;287226;20209;86.3;84.6;6.0
81;2021-10-31;38;48;118;292727;287274;20327;86.3;84.7;6.0
81;2021-11-01;7;3;0;292734;287277;20327;86.3;84.7;6.0
81;2021-11-02;109;158;708;292843;287435;21035;86.3;84.7;6.2
81;2021-11-03;190;286;1051;293033;287721;22086;86.4;84.8;6.5
81;2021-11-04;120;135;922;293153;287856;23008;86.4;84.8;6.8
81;2021-11-05;161;238;1177;293314;288094;24185;86.4;84.9;7.1
81;2021-11-06;112;190;449;293426;288284;24634;86.5;85.0;7.3
81;2021-11-07;45;49;109;293471;288333;24743;86.5;85.0;7.3
81;2021-11-08;71;97;553;293542;288430;25296;86.5;85.0;7.5
81;2021-11-09;107;173;1639;293649;288603;26935;86.5;85.1;7.9
81;2021-11-10;208;244;1621;293857;288847;28556;86.6;85.1;8.4
81;2021-11-11;3;5;54;293860;288852;28610;86.6;85.1;8.4
81;2021-11-12;128;182;1195;293988;289034;29805;86.6;85.2;8.8
81;2021-11-13;118;161;602;294106;289195;30407;86.7;85.2;9.0
81;2021-11-14;21;51;138;294127;289246;30545;86.7;85.2;9.0
81;2021-11-15;121;103;1286;294248;289349;31831;86.7;85.3;9.4
81;2021-11-16;127;179;1959;294375;289528;33790;86.8;85.3;10.0
81;2021-11-17;89;153;995;294464;289681;34785;86.8;85.4;10.3
81;2021-11-18;110;151;1489;294574;289832;36274;86.8;85.4;10.7
81;2021-11-19;126;131;1537;294700;289963;37811;86.9;85.5;11.1
81;2021-11-20;61;85;338;294761;290048;38149;86.9;85.5;11.2
81;2021-11-21;122;111;634;294883;290159;38783;86.9;85.5;11.4
81;2021-11-22;52;41;810;294935;290200;39593;86.9;85.5;11.7
81;2021-11-23;177;130;2683;295112;290330;42276;87.0;85.6;12.5
81;2021-11-24;224;194;1935;295336;290524;44211;87.0;85.6;13.0
81;2021-11-25;141;112;2212;295477;290636;46423;87.1;85.7;13.7
81;2021-11-26;221;200;3185;295698;290836;49608;87.1;85.7;14.6
81;2021-11-27;169;173;1541;295867;291009;51149;87.2;85.8;15.1
81;2021-11-28;38;51;842;295905;291060;51991;87.2;85.8;15.3
81;2021-11-29;62;68;1255;295967;291128;53246;87.2;85.8;15.7
81;2021-11-30;140;130;4130;296107;291258;57376;87.3;85.8;16.9
81;2021-12-01;128;166;3102;296235;291424;60478;87.3;85.9;17.8
81;2021-12-02;101;70;3601;296336;291494;64079;87.3;85.9;18.9
81;2021-12-03;86;130;3712;296422;291624;67791;87.4;85.9;20.0
81;2021-12-04;74;74;1651;296496;291698;69442;87.4;86.0;20.5
81;2021-12-05;12;15;764;296508;291713;70206;87.4;86.0;20.7
81;2021-12-06;92;72;2936;296600;291785;73142;87.4;86.0;21.6
81;2021-12-07;113;134;4851;296713;291919;77993;87.4;86.0;23.0
81;2021-12-08;140;228;3782;296853;292147;81775;87.5;86.1;24.1
81;2021-12-09;117;121;4354;296970;292268;86129;87.5;86.1;25.4
81;2021-12-10;122;154;4615;297092;292422;90744;87.6;86.2;26.7
81;2021-12-11;85;91;2464;297177;292513;93208;87.6;86.2;27.5
81;2021-12-12;36;21;1011;297213;292534;94219;87.6;86.2;27.8
81;2021-12-13;93;77;3240;297306;292611;97459;87.6;86.2;28.7
81;2021-12-14;149;204;5649;297455;292815;103108;87.7;86.3;30.4
81;2021-12-15;164;259;4391;297619;293074;107499;87.7;86.4;31.7
81;2021-12-16;152;185;4972;297771;293259;112471;87.8;86.4;33.1
81;2021-12-17;122;194;4041;297893;293453;116512;87.8;86.5;34.3
81;2021-12-18;116;243;2270;298009;293696;118782;87.8;86.6;35.0
81;2021-12-19;12;19;436;298021;293715;119218;87.8;86.6;35.1
82;2020-12-27;0;0;0;0;0;0;0.0;0.0;0.0
82;2020-12-28;1;0;0;1;0;0;0.0;0.0;0.0
82;2020-12-29;0;0;0;1;0;0;0.0;0.0;0.0
82;2020-12-30;0;0;0;1;0;0;0.0;0.0;0.0
82;2020-12-31;0;0;0;1;0;0;0.0;0.0;0.0
82;2021-01-01;0;0;0;1;0;0;0.0;0.0;0.0
82;2021-01-02;0;0;0;1;0;0;0.0;0.0;0.0
82;2021-01-03;0;0;0;1;0;0;0.0;0.0;0.0
82;2021-01-04;0;0;0;1;0;0;0.0;0.0;0.0
82;2021-01-05;78;0;0;79;0;0;0.0;0.0;0.0
82;2021-01-06;4;0;0;83;0;0;0.0;0.0;0.0
82;2021-01-07;68;0;0;151;0;0;0.1;0.0;0.0
82;2021-01-08;61;0;0;212;0;0;0.1;0.0;0.0
82;2021-01-09;75;0;0;287;0;0;0.1;0.0;0.0
82;2021-01-10;2;0;0;289;0;0;0.1;0.0;0.0
82;2021-01-11;102;0;0;391;0;0;0.2;0.0;0.0
82;2021-01-12;286;0;0;677;0;0;0.3;0.0;0.0
82;2021-01-13;324;1;0;1001;1;0;0.4;0.0;0.0
82;2021-01-14;416;5;0;1417;6;0;0.6;0.0;0.0
82;2021-01-15;602;3;0;2019;9;0;0.9;0.0;0.0
82;2021-01-16;214;3;0;2233;12;0;1.0;0.0;0.0
82;2021-01-17;89;0;0;2322;12;0;1.0;0.0;0.0
82;2021-01-18;415;0;0;2737;12;0;1.2;0.0;0.0
82;2021-01-19;478;1;0;3215;13;0;1.4;0.0;0.0
82;2021-01-20;643;5;0;3858;18;0;1.7;0.0;0.0
82;2021-01-21;450;2;0;4308;20;0;1.9;0.0;0.0
82;2021-01-22;465;2;0;4773;22;0;2.1;0.0;0.0
82;2021-01-23;159;0;0;4932;22;0;2.2;0.0;0.0
82;2021-01-24;2;0;0;4934;22;0;2.2;0.0;0.0
82;2021-01-25;365;0;0;5299;22;0;2.4;0.0;0.0
82;2021-01-26;446;0;0;5745;22;0;2.5;0.0;0.0
82;2021-01-27;508;5;0;6253;27;0;2.8;0.0;0.0
82;2021-01-28;544;34;0;6797;61;0;3.0;0.0;0.0
82;2021-01-29;387;102;0;7184;163;0;3.2;0.1;0.0
82;2021-01-30;57;24;0;7241;187;0;3.2;0.1;0.0
82;2021-01-31;4;2;0;7245;189;0;3.2;0.1;0.0
82;2021-02-01;289;76;0;7534;265;0;3.3;0.1;0.0
82;2021-02-02;360;117;0;7894;382;0;3.5;0.2;0.0
82;2021-02-03;430;81;0;8324;463;0;3.7;0.2;0.0
82;2021-02-04;729;206;0;9053;669;0;4.0;0.3;0.0
82;2021-02-05;456;150;0;9509;819;0;4.2;0.4;0.0
82;2021-02-06;89;37;0;9598;856;0;4.3;0.4;0.0
82;2021-02-07;30;71;0;9628;927;0;4.3;0.4;0.0
82;2021-02-08;151;224;0;9779;1151;0;4.3;0.5;0.0
82;2021-02-09;220;381;0;9999;1532;0;4.4;0.7;0.0
82;2021-02-10;259;575;0;10258;2107;0;4.6;0.9;0.0
82;2021-02-11;221;379;0;10479;2486;0;4.7;1.1;0.0
82;2021-02-12;191;573;0;10670;3059;0;4.7;1.4;0.0
82;2021-02-13;59;119;0;10729;3178;0;4.8;1.4;0.0
82;2021-02-14;6;86;0;10735;3264;0;4.8;1.4;0.0
82;2021-02-15;220;306;0;10955;3570;0;4.9;1.6;0.0
82;2021-02-16;266;381;0;11221;3951;0;5.0;1.8;0.0
82;2021-02-17;328;514;0;11549;4465;0;5.1;2.0;0.0
82;2021-02-18;457;486;0;12006;4951;0;5.3;2.2;0.0
82;2021-02-19;439;513;0;12445;5464;0;5.5;2.4;0.0
82;2021-02-20;68;141;0;12513;5605;0;5.6;2.5;0.0
82;2021-02-21;3;0;0;12516;5605;0;5.6;2.5;0.0
82;2021-02-22;190;390;0;12706;5995;0;5.6;2.7;0.0
82;2021-02-23;268;453;0;12974;6448;0;5.8;2.9;0.0
82;2021-02-24;266;439;0;13240;6887;0;5.9;3.1;0.0
82;2021-02-25;581;497;0;13821;7384;0;6.1;3.3;0.0
82;2021-02-26;600;380;0;14421;7764;0;6.4;3.4;0.0
82;2021-02-27;206;74;0;14627;7838;0;6.5;3.5;0.0
82;2021-02-28;33;8;0;14660;7846;0;6.5;3.5;0.0
82;2021-03-01;257;212;0;14917;8058;0;6.6;3.6;0.0
82;2021-03-02;477;400;0;15394;8458;0;6.8;3.8;0.0
82;2021-03-03;405;361;0;15799;8819;0;7.0;3.9;0.0
82;2021-03-04;565;302;0;16364;9121;0;7.3;4.0;0.0
82;2021-03-05;667;369;0;17031;9490;0;7.6;4.2;0.0
82;2021-03-06;675;54;0;17706;9544;0;7.9;4.2;0.0
82;2021-03-07;318;6;0;18024;9550;0;8.0;4.2;0.0
82;2021-03-08;568;150;0;18592;9700;0;8.3;4.3;0.0
82;2021-03-09;563;245;0;19155;9945;0;8.5;4.4;0.0
82;2021-03-10;736;232;0;19891;10177;0;8.8;4.5;0.0
82;2021-03-11;923;274;0;20814;10451;0;9.2;4.6;0.0
82;2021-03-12;952;115;0;21766;10566;0;9.7;4.7;0.0
82;2021-03-13;548;53;0;22314;10619;0;9.9;4.7;0.0
82;2021-03-14;63;5;0;22377;10624;0;9.9;4.7;0.0
82;2021-03-15;488;309;0;22865;10933;0;10.1;4.9;0.0
82;2021-03-16;214;307;0;23079;11240;0;10.2;5.0;0.0
82;2021-03-17;200;259;0;23279;11499;0;10.3;5.1;0.0
82;2021-03-18;279;326;0;23558;11825;0;10.5;5.2;0.0
82;2021-03-19;508;279;0;24066;12104;0;10.7;5.4;0.0
82;2021-03-20;248;59;0;24314;12163;0;10.8;5.4;0.0
82;2021-03-21;27;0;0;24341;12163;0;10.8;5.4;0.0
82;2021-03-22;410;281;0;24751;12444;0;11.0;5.5;0.0
82;2021-03-23;574;277;0;25325;12721;0;11.2;5.6;0.0
82;2021-03-24;622;298;0;25947;13019;0;11.5;5.8;0.0
82;2021-03-25;916;241;0;26863;13260;0;11.9;5.9;0.0
82;2021-03-26;1113;257;0;27976;13517;0;12.4;6.0;0.0
82;2021-03-27;421;83;0;28397;13600;0;12.6;6.0;0.0
82;2021-03-28;141;3;0;28538;13603;0;12.7;6.0;0.0
82;2021-03-29;783;344;0;29321;13947;0;13.0;6.2;0.0
82;2021-03-30;1079;266;0;30400;14213;0;13.5;6.3;0.0
82;2021-03-31;911;228;0;31311;14441;0;13.9;6.4;0.0
82;2021-04-01;1017;177;0;32328;14618;0;14.3;6.5;0.0
82;2021-04-02;1127;259;0;33455;14877;0;14.8;6.6;0.0
82;2021-04-03;596;125;0;34051;15002;0;15.1;6.7;0.0
82;2021-04-04;247;15;0;34298;15017;0;15.2;6.7;0.0
82;2021-04-05;329;16;0;34627;15033;0;15.4;6.7;0.0
82;2021-04-06;870;473;0;35497;15506;0;15.8;6.9;0.0
82;2021-04-07;944;443;0;36441;15949;0;16.2;7.1;0.0
82;2021-04-08;1384;401;0;37825;16350;0;16.8;7.3;0.0
82;2021-04-09;1526;454;0;39351;16804;0;17.5;7.5;0.0
82;2021-04-10;1502;92;0;40853;16896;0;18.1;7.5;0.0
82;2021-04-11;487;24;0;41340;16920;0;18.3;7.5;0.0
82;2021-04-12;1211;293;0;42551;17213;0;18.9;7.6;0.0
82;2021-04-13;1546;290;0;44097;17503;0;19.6;7.8;0.0
82;2021-04-14;1374;286;0;45471;17789;0;20.2;7.9;0.0
82;2021-04-15;1705;327;0;47176;18116;0;20.9;8.0;0.0
82;2021-04-16;1462;339;0;48638;18455;0;21.6;8.2;0.0
82;2021-04-17;1134;76;0;49772;18531;0;22.1;8.2;0.0
82;2021-04-18;507;16;0;50279;18547;0;22.3;8.2;0.0
82;2021-04-19;895;328;0;51174;18875;0;22.7;8.4;0.0
82;2021-04-20;1205;373;0;52379;19248;0;23.2;8.5;0.0
82;2021-04-21;1115;352;0;53494;19600;0;23.7;8.7;0.0
82;2021-04-22;1399;298;0;54893;19898;0;24.4;8.8;0.0
82;2021-04-23;1034;562;0;55927;20460;0;24.8;9.1;0.0
82;2021-04-24;1042;209;0;56969;20669;0;25.3;9.2;0.0
82;2021-04-25;635;46;0;57604;20715;0;25.6;9.2;0.0
82;2021-04-26;698;624;0;58302;21339;0;25.9;9.5;0.0
82;2021-04-27;903;836;0;59205;22175;0;26.3;9.8;0.0
82;2021-04-28;852;788;0;60057;22963;0;26.7;10.2;0.0
82;2021-04-29;1043;831;0;61100;23794;0;27.1;10.6;0.0
82;2021-04-30;1000;804;0;62100;24598;0;27.6;10.9;0.0
82;2021-05-01;1001;234;0;63101;24832;0;28.0;11.0;0.0
82;2021-05-02;609;136;0;63710;24968;0;28.3;11.1;0.0
82;2021-05-03;423;1033;0;64133;26001;0;28.5;11.5;0.0
82;2021-05-04;820;1050;0;64953;27051;0;28.8;12.0;0.0
82;2021-05-05;592;1088;0;65545;28139;0;29.1;12.5;0.0
82;2021-05-06;849;1340;0;66394;29479;0;29.5;13.1;0.0
82;2021-05-07;786;1322;0;67180;30801;0;29.8;13.7;0.0
82;2021-05-08;833;482;0;68013;31283;0;30.2;13.9;0.0
82;2021-05-09;629;504;0;68642;31787;0;30.5;14.1;0.0
82;2021-05-10;665;1234;0;69307;33021;0;30.8;14.7;0.0
82;2021-05-11;1074;1278;0;70381;34299;0;31.2;15.2;0.0
82;2021-05-12;838;1255;0;71219;35554;0;31.6;15.8;0.0
82;2021-05-13;1215;406;0;72434;35960;0;32.1;16.0;0.0
82;2021-05-14;1306;1144;0;73740;37104;0;32.7;16.5;0.0
82;2021-05-15;1384;624;0;75124;37728;0;33.3;16.7;0.0
82;2021-05-16;497;115;0;75621;37843;0;33.6;16.8;0.0
82;2021-05-17;853;1071;0;76474;38914;0;33.9;17.3;0.0
82;2021-05-18;1314;1085;0;77788;39999;0;34.5;17.8;0.0
82;2021-05-19;1041;879;0;78829;40878;0;35.0;18.1;0.0
82;2021-05-20;1337;1096;0;80166;41974;0;35.6;18.6;0.0
82;2021-05-21;1125;1119;0;81291;43093;0;36.1;19.1;0.0
82;2021-05-22;1436;532;0;82727;43625;0;36.7;19.4;0.0
82;2021-05-23;579;99;0;83306;43724;0;37.0;19.4;0.0
82;2021-05-24;1082;224;0;84388;43948;0;37.4;19.5;0.0
82;2021-05-25;1308;895;0;85696;44843;0;38.0;19.9;0.0
82;2021-05-26;1145;841;0;86841;45684;0;38.5;20.3;0.0
82;2021-05-27;1254;976;0;88095;46660;0;39.1;20.7;0.0
82;2021-05-28;1252;1080;0;89347;47740;0;39.7;21.2;0.0
82;2021-05-29;1122;512;0;90469;48252;0;40.1;21.4;0.0
82;2021-05-30;283;101;0;90752;48353;0;40.3;21.5;0.0
82;2021-05-31;1206;923;0;91958;49276;0;40.8;21.9;0.0
82;2021-06-01;1507;998;0;93465;50274;0;41.5;22.3;0.0
82;2021-06-02;1211;928;0;94676;51202;0;42.0;22.7;0.0
82;2021-06-03;1351;1159;0;96027;52361;0;42.6;23.2;0.0
82;2021-06-04;1884;1206;0;97911;53567;0;43.5;23.8;0.0
82;2021-06-05;1541;863;0;99452;54430;0;44.1;24.2;0.0
82;2021-06-06;295;126;0;99747;54556;0;44.3;24.2;0.0
82;2021-06-07;802;1169;0;100549;55725;0;44.6;24.7;0.0
82;2021-06-08;1354;1067;0;101903;56792;0;45.2;25.2;0.0
82;2021-06-09;1353;1049;0;103256;57841;0;45.8;25.7;0.0
82;2021-06-10;1353;1162;0;104609;59003;0;46.4;26.2;0.0
82;2021-06-11;1635;1032;0;106244;60035;0;47.1;26.6;0.0
82;2021-06-12;1696;1107;0;107940;61142;0;47.9;27.1;0.0
82;2021-06-13;360;119;0;108300;61261;0;48.1;27.2;0.0
82;2021-06-14;1116;1004;0;109416;62265;0;48.6;27.6;0.0
82;2021-06-15;1352;1144;0;110768;63409;0;49.2;28.1;0.0
82;2021-06-16;1471;1100;0;112239;64509;0;49.8;28.6;0.0
82;2021-06-17;1153;1384;0;113392;65893;0;50.3;29.2;0.0
82;2021-06-18;1332;1379;0;114724;67272;0;50.9;29.9;0.0
82;2021-06-19;1734;834;0;116458;68106;0;51.7;30.2;0.0
82;2021-06-20;268;162;0;116726;68268;0;51.8;30.3;0.0
82;2021-06-21;517;1127;0;117243;69395;0;52.0;30.8;0.0
82;2021-06-22;866;1553;0;118109;70948;0;52.4;31.5;0.0
82;2021-06-23;1138;1328;0;119247;72276;0;52.9;32.1;0.0
82;2021-06-24;720;1674;0;119967;73950;0;53.2;32.8;0.0
82;2021-06-25;761;1615;0;120728;75565;0;53.6;33.5;0.0
82;2021-06-26;1084;1652;0;121812;77217;0;54.1;34.3;0.0
82;2021-06-27;177;376;0;121989;77593;0;54.1;34.4;0.0
82;2021-06-28;359;1229;0;122348;78822;0;54.3;35.0;0.0
82;2021-06-29;522;1660;0;122870;80482;0;54.5;35.7;0.0
82;2021-06-30;884;1569;0;123754;82051;0;54.9;36.4;0.0
82;2021-07-01;659;1488;0;124413;83539;0;55.2;37.1;0.0
82;2021-07-02;950;1961;0;125363;85500;0;55.6;37.9;0.0
82;2021-07-03;810;1758;0;126173;87258;0;56.0;38.7;0.0
82;2021-07-04;147;396;0;126320;87654;0;56.1;38.9;0.0
82;2021-07-05;443;1385;0;126763;89039;0;56.3;39.5;0.0
82;2021-07-06;588;1687;0;127351;90726;0;56.5;40.3;0.0
82;2021-07-07;786;1492;0;128137;92218;0;56.9;40.9;0.0
82;2021-07-08;572;1402;1;128709;93620;1;57.1;41.5;0.0
82;2021-07-09;817;1830;0;129526;95450;1;57.5;42.4;0.0
82;2021-07-10;704;1780;0;130230;97230;1;57.8;43.1;0.0
82;2021-07-11;109;336;0;130339;97566;1;57.8;43.3;0.0
82;2021-07-12;595;1640;0;130934;99206;1;58.1;44.0;0.0
82;2021-07-13;848;1881;0;131782;101087;1;58.5;44.9;0.0
82;2021-07-14;698;578;0;132480;101665;1;58.8;45.1;0.0
82;2021-07-15;1052;1707;0;133532;103372;1;59.3;45.9;0.0
82;2021-07-16;1521;2394;0;135053;105766;1;59.9;46.9;0.0
82;2021-07-17;814;1846;0;135867;107612;1;60.3;47.8;0.0
82;2021-07-18;274;169;0;136141;107781;1;60.4;47.8;0.0
82;2021-07-19;931;1793;0;137072;109574;1;60.8;48.6;0.0
82;2021-07-20;1194;1864;0;138266;111438;1;61.4;49.5;0.0
82;2021-07-21;1538;1648;0;139804;113086;1;62.0;50.2;0.0
82;2021-07-22;1430;1764;0;141234;114850;1;62.7;51.0;0.0
82;2021-07-23;1370;2679;0;142604;117529;1;63.3;52.2;0.0
82;2021-07-24;1490;1404;0;144094;118933;1;63.9;52.8;0.0
82;2021-07-25;525;184;0;144619;119117;1;64.2;52.9;0.0
82;2021-07-26;1151;1824;0;145770;120941;1;64.7;53.7;0.0
82;2021-07-27;1615;1643;0;147385;122584;1;65.4;54.4;0.0
82;2021-07-28;1791;1425;0;149176;124009;1;66.2;55.0;0.0
82;2021-07-29;1628;1502;0;150804;125511;1;66.9;55.7;0.0
82;2021-07-30;1872;2209;0;152676;127720;1;67.8;56.7;0.0
82;2021-07-31;868;466;0;153544;128186;1;68.1;56.9;0.0
82;2021-08-01;426;139;0;153970;128325;1;68.3;56.9;0.0
82;2021-08-02;1453;874;0;155423;129199;1;69.0;57.3;0.0
82;2021-08-03;1686;883;0;157109;130082;1;69.7;57.7;0.0
82;2021-08-04;1650;998;0;158759;131080;1;70.5;58.2;0.0
82;2021-08-05;1693;760;0;160452;131840;1;71.2;58.5;0.0
82;2021-08-06;1252;812;0;161704;132652;1;71.8;58.9;0.0
82;2021-08-07;1132;1271;0;162836;133923;1;72.3;59.4;0.0
82;2021-08-08;307;237;0;163143;134160;1;72.4;59.5;0.0
82;2021-08-09;1208;1100;0;164351;135260;1;72.9;60.0;0.0
82;2021-08-10;1514;1088;0;165865;136348;1;73.6;60.5;0.0
82;2021-08-11;1362;1218;0;167227;137566;1;74.2;61.0;0.0
82;2021-08-12;1540;1091;0;168767;138657;1;74.9;61.5;0.0
82;2021-08-13;1406;1190;0;170173;139847;1;75.5;62.1;0.0
82;2021-08-14;498;778;0;170671;140625;1;75.7;62.4;0.0
82;2021-08-15;81;158;0;170752;140783;1;75.8;62.5;0.0
82;2021-08-16;834;1640;0;171586;142423;1;76.1;63.2;0.0
82;2021-08-17;1029;1429;0;172615;143852;1;76.6;63.8;0.0
82;2021-08-18;688;1107;0;173303;144959;1;76.9;64.3;0.0
82;2021-08-19;981;1281;0;174284;146240;1;77.3;64.9;0.0
82;2021-08-20;987;2018;0;175271;148258;1;77.8;65.8;0.0
82;2021-08-21;509;1129;0;175780;149387;1;78.0;66.3;0.0
82;2021-08-22;52;260;0;175832;149647;1;78.0;66.4;0.0
82;2021-08-23;736;1455;0;176568;151102;1;78.4;67.1;0.0
82;2021-08-24;855;1304;0;177423;152406;1;78.7;67.6;0.0
82;2021-08-25;768;1658;0;178191;154064;1;79.1;68.4;0.0
82;2021-08-26;602;1266;0;178793;155330;1;79.3;68.9;0.0
82;2021-08-27;822;1813;0;179615;157143;1;79.7;69.7;0.0
82;2021-08-28;240;954;0;179855;158097;1;79.8;70.2;0.0
82;2021-08-29;72;254;0;179927;158351;1;79.8;70.3;0.0
82;2021-08-30;395;1233;8;180322;159584;9;80.0;70.8;0.0
82;2021-08-31;381;1227;23;180703;160811;32;80.2;71.4;0.0
82;2021-09-01;674;1432;53;181377;162243;85;80.5;72.0;0.0
82;2021-09-02;405;1285;62;181782;163528;147;80.7;72.6;0.1
82;2021-09-03;520;1855;146;182302;165383;293;80.9;73.4;0.1
82;2021-09-04;406;958;45;182708;166341;338;81.1;73.8;0.1
82;2021-09-05;33;82;1;182741;166423;339;81.1;73.9;0.2
82;2021-09-06;360;1118;149;183101;167541;488;81.3;74.4;0.2
82;2021-09-07;227;887;93;183328;168428;581;81.4;74.7;0.3
82;2021-09-08;438;1172;90;183766;169600;671;81.6;75.3;0.3
82;2021-09-09;264;920;112;184030;170520;783;81.7;75.7;0.3
82;2021-09-10;485;1226;207;184515;171746;990;81.9;76.2;0.4
82;2021-09-11;244;586;53;184759;172332;1043;82.0;76.5;0.5
82;2021-09-12;28;70;0;184787;172402;1043;82.0;76.5;0.5
82;2021-09-13;287;805;249;185074;173207;1292;82.1;76.9;0.6
82;2021-09-14;225;797;177;185299;174004;1469;82.2;77.2;0.7
82;2021-09-15;302;1112;398;185601;175116;1867;82.4;77.7;0.8
82;2021-09-16;226;487;258;185827;175603;2125;82.5;77.9;0.9
82;2021-09-17;214;530;173;186041;176133;2298;82.6;78.2;1.0
82;2021-09-18;298;1032;107;186339;177165;2405;82.7;78.6;1.1
82;2021-09-19;5;38;8;186344;177203;2413;82.7;78.6;1.1
82;2021-09-20;146;391;377;186490;177594;2790;82.8;78.8;1.2
82;2021-09-21;101;383;264;186591;177977;3054;82.8;79.0;1.4
82;2021-09-22;141;464;300;186732;178441;3354;82.9;79.2;1.5
82;2021-09-23;114;379;344;186846;178820;3698;82.9;79.4;1.6
82;2021-09-24;204;563;326;187050;179383;4024;83.0;79.6;1.8
82;2021-09-25;167;634;109;187217;180017;4133;83.1;79.9;1.8
82;2021-09-26;9;36;8;187226;180053;4141;83.1;79.9;1.8
82;2021-09-27;106;444;169;187332;180497;4310;83.1;80.1;1.9
82;2021-09-28;99;235;227;187431;180732;4537;83.2;80.2;2.0
82;2021-09-29;232;473;196;187663;181205;4733;83.3;80.4;2.1
82;2021-09-30;116;221;263;187779;181426;4996;83.3;80.5;2.2
82;2021-10-01;219;379;265;187998;181805;5261;83.4;80.7;2.3
82;2021-10-02;138;298;87;188136;182103;5348;83.5;80.8;2.4
82;2021-10-03;4;5;0;188140;182108;5348;83.5;80.8;2.4
82;2021-10-04;125;380;205;188265;182488;5553;83.5;81.0;2.5
82;2021-10-05;134;279;229;188399;182767;5782;83.6;81.1;2.6
82;2021-10-06;166;337;384;188565;183104;6166;83.7;81.3;2.7
82;2021-10-07;81;143;393;188646;183247;6559;83.7;81.3;2.9
82;2021-10-08;166;307;300;188812;183554;6859;83.8;81.5;3.0
82;2021-10-09;124;269;147;188936;183823;7006;83.8;81.6;3.1
82;2021-10-10;7;17;5;188943;183840;7011;83.8;81.6;3.1
82;2021-10-11;79;203;243;189022;184043;7254;83.9;81.7;3.2
82;2021-10-12;84;158;310;189106;184201;7564;83.9;81.7;3.4
82;2021-10-13;179;286;360;189285;184487;7924;84.0;81.9;3.5
82;2021-10-14;51;88;111;189336;184575;8035;84.0;81.9;3.6
82;2021-10-15;196;241;374;189532;184816;8409;84.1;82.0;3.7
82;2021-10-16;103;133;94;189635;184949;8503;84.2;82.1;3.8
82;2021-10-17;0;5;0;189635;184954;8503;84.2;82.1;3.8
82;2021-10-18;127;129;218;189762;185083;8721;84.2;82.1;3.9
82;2021-10-19;113;151;304;189875;185234;9025;84.3;82.2;4.0
82;2021-10-20;188;272;397;190063;185506;9422;84.3;82.3;4.2
82;2021-10-21;65;79;164;190128;185585;9586;84.4;82.4;4.3
82;2021-10-22;119;252;381;190247;185837;9967;84.4;82.5;4.4
82;2021-10-23;122;171;155;190369;186008;10122;84.5;82.5;4.5
82;2021-10-24;1;6;6;190370;186014;10128;84.5;82.5;4.5
82;2021-10-25;84;119;389;190454;186133;10517;84.5;82.6;4.7
82;2021-10-26;112;157;396;190566;186290;10913;84.6;82.7;4.8
82;2021-10-27;85;168;388;190651;186458;11301;84.6;82.7;5.0
82;2021-10-28;49;62;198;190700;186520;11499;84.6;82.8;5.1
82;2021-10-29;108;212;384;190808;186732;11883;84.7;82.9;5.3
82;2021-10-30;106;136;226;190914;186868;12109;84.7;82.9;5.4
82;2021-10-31;2;0;1;190916;186868;12110;84.7;82.9;5.4
82;2021-11-01;7;3;3;190923;186871;12113;84.7;82.9;5.4
82;2021-11-02;81;112;361;191004;186983;12474;84.8;83.0;5.5
82;2021-11-03;117;112;498;191121;187095;12972;84.8;83.0;5.8
82;2021-11-04;95;94;408;191216;187189;13380;84.9;83.1;5.9
82;2021-11-05;102;137;524;191318;187326;13904;84.9;83.1;6.2
82;2021-11-06;58;77;189;191376;187403;14093;84.9;83.2;6.3
82;2021-11-07;0;5;14;191376;187408;14107;84.9;83.2;6.3
82;2021-11-08;47;94;251;191423;187502;14358;84.9;83.2;6.4
82;2021-11-09;75;93;619;191498;187595;14977;85.0;83.3;6.6
82;2021-11-10;100;273;602;191598;187868;15579;85.0;83.4;6.9
82;2021-11-11;4;6;29;191602;187874;15608;85.0;83.4;6.9
82;2021-11-12;78;92;582;191680;187966;16190;85.1;83.4;7.2
82;2021-11-13;61;153;248;191741;188119;16438;85.1;83.5;7.3
82;2021-11-14;2;2;6;191743;188121;16444;85.1;83.5;7.3
82;2021-11-15;55;58;380;191798;188179;16824;85.1;83.5;7.5
82;2021-11-16;82;81;1083;191880;188260;17907;85.2;83.5;7.9
82;2021-11-17;91;121;951;191971;188381;18858;85.2;83.6;8.4
82;2021-11-18;86;66;815;192057;188447;19673;85.2;83.6;8.7
82;2021-11-19;140;108;955;192197;188555;20628;85.3;83.7;9.2
82;2021-11-20;69;68;273;192266;188623;20901;85.3;83.7;9.3
82;2021-11-21;3;6;25;192269;188629;20926;85.3;83.7;9.3
82;2021-11-22;50;46;605;192319;188675;21531;85.3;83.7;9.6
82;2021-11-23;71;86;1197;192390;188761;22728;85.4;83.8;10.1
82;2021-11-24;123;235;1073;192513;188996;23801;85.4;83.9;10.6
82;2021-11-25;79;79;1366;192592;189075;25167;85.5;83.9;11.2
82;2021-11-26;110;148;1336;192702;189223;26503;85.5;84.0;11.8
82;2021-11-27;98;147;672;192800;189370;27175;85.6;84.0;12.1
82;2021-11-28;4;12;37;192804;189382;27212;85.6;84.0;12.1
82;2021-11-29;59;66;1400;192863;189448;28612;85.6;84.1;12.7
82;2021-11-30;95;86;2172;192958;189534;30784;85.6;84.1;13.7
82;2021-12-01;89;88;2075;193047;189622;32859;85.7;84.2;14.6
82;2021-12-02;99;81;2452;193146;189703;35311;85.7;84.2;15.7
82;2021-12-03;126;96;2430;193272;189799;37741;85.8;84.2;16.7
82;2021-12-04;54;93;1384;193326;189892;39125;85.8;84.3;17.4
82;2021-12-05;14;12;132;193340;189904;39257;85.8;84.3;17.4
82;2021-12-06;84;73;2484;193424;189977;41741;85.8;84.3;18.5
82;2021-12-07;110;104;3576;193534;190081;45317;85.9;84.4;20.1
82;2021-12-08;142;123;2494;193676;190204;47811;85.9;84.4;21.2
82;2021-12-09;100;106;3249;193776;190310;51060;86.0;84.5;22.7
82;2021-12-10;94;139;3581;193870;190449;54641;86.0;84.5;24.2
82;2021-12-11;117;95;1822;193987;190544;56463;86.1;84.6;25.1
82;2021-12-12;3;13;125;193990;190557;56588;86.1;84.6;25.1
82;2021-12-13;103;98;2780;194093;190655;59368;86.1;84.6;26.3
82;2021-12-14;131;132;3545;194224;190787;62913;86.2;84.7;27.9
82;2021-12-15;126;137;2890;194350;190924;65803;86.2;84.7;29.2
82;2021-12-16;132;119;3518;194482;191043;69321;86.3;84.8;30.8
82;2021-12-17;144;171;3551;194626;191214;72872;86.4;84.9;32.3
82;2021-12-18;132;129;1679;194758;191343;74551;86.4;84.9;33.1
82;2021-12-19;11;12;260;194769;191355;74811;86.4;84.9;33.2
83;2020-12-27;4;0;0;4;0;0;0.0;0.0;0.0
83;2020-12-28;6;0;0;10;0;0;0.0;0.0;0.0
83;2020-12-29;3;0;0;13;0;0;0.0;0.0;0.0
83;2020-12-30;4;0;0;17;0;0;0.0;0.0;0.0
83;2020-12-31;1;0;0;18;0;0;0.0;0.0;0.0
83;2021-01-01;3;0;0;21;0;0;0.0;0.0;0.0
83;2021-01-02;1;0;0;22;0;0;0.0;0.0;0.0
83;2021-01-03;0;0;0;22;0;0;0.0;0.0;0.0
83;2021-01-04;3;0;0;25;0;0;0.0;0.0;0.0
83;2021-01-05;6;1;0;31;1;0;0.0;0.0;0.0
83;2021-01-06;86;0;0;117;1;0;0.0;0.0;0.0
83;2021-01-07;317;0;0;434;1;0;0.0;0.0;0.0
83;2021-01-08;426;0;0;860;1;0;0.1;0.0;0.0
83;2021-01-09;57;0;0;917;1;0;0.1;0.0;0.0
83;2021-01-10;5;0;0;922;1;0;0.1;0.0;0.0
83;2021-01-11;503;0;0;1425;1;0;0.2;0.0;0.0
83;2021-01-12;1045;4;0;2470;5;0;0.3;0.0;0.0
83;2021-01-13;967;8;0;3437;13;0;0.4;0.0;0.0
83;2021-01-14;897;6;0;4334;19;0;0.5;0.0;0.0
83;2021-01-15;764;2;0;5098;21;0;0.5;0.0;0.0
83;2021-01-16;66;0;0;5164;21;0;0.5;0.0;0.0
83;2021-01-17;6;0;0;5170;21;0;0.5;0.0;0.0
83;2021-01-18;1288;2;0;6458;23;0;0.7;0.0;0.0
83;2021-01-19;2198;8;0;8656;31;0;0.9;0.0;0.0
83;2021-01-20;1765;10;0;10421;41;0;1.1;0.0;0.0
83;2021-01-21;2267;9;0;12688;50;0;1.3;0.0;0.0
83;2021-01-22;1843;8;0;14531;58;0;1.5;0.0;0.0
83;2021-01-23;278;2;0;14809;60;0;1.6;0.0;0.0
83;2021-01-24;35;1;0;14844;61;0;1.6;0.0;0.0
83;2021-01-25;1574;8;0;16418;69;0;1.7;0.0;0.0
83;2021-01-26;1847;13;0;18265;82;0;1.9;0.0;0.0
83;2021-01-27;2199;96;0;20464;178;0;2.2;0.0;0.0
83;2021-01-28;4970;363;0;25434;541;0;2.7;0.1;0.0
83;2021-01-29;3009;357;0;28443;898;0;3.0;0.1;0.0
83;2021-01-30;261;50;0;28704;948;0;3.0;0.1;0.0
83;2021-01-31;40;0;0;28744;948;0;3.1;0.1;0.0
83;2021-02-01;1297;429;0;30041;1377;0;3.2;0.1;0.0
83;2021-02-02;1464;710;0;31505;2087;0;3.3;0.2;0.0
83;2021-02-03;1568;632;0;33073;2719;0;3.5;0.3;0.0
83;2021-02-04;1535;778;0;34608;3497;0;3.7;0.4;0.0
83;2021-02-05;1309;711;0;35917;4208;0;3.8;0.4;0.0
83;2021-02-06;68;28;0;35985;4236;0;3.8;0.4;0.0
83;2021-02-07;8;4;0;35993;4240;0;3.8;0.5;0.0
83;2021-02-08;1103;638;0;37096;4878;0;3.9;0.5;0.0
83;2021-02-09;1352;985;0;38448;5863;0;4.1;0.6;0.0
83;2021-02-10;1534;853;0;39982;6716;0;4.2;0.7;0.0
83;2021-02-11;1669;1131;0;41651;7847;0;4.4;0.8;0.0
83;2021-02-12;1373;906;0;43024;8753;0;4.6;0.9;0.0
83;2021-02-13;80;49;0;43104;8802;0;4.6;0.9;0.0
83;2021-02-14;6;6;0;43110;8808;0;4.6;0.9;0.0
83;2021-02-15;728;1102;0;43838;9910;0;4.7;1.1;0.0
83;2021-02-16;607;1508;0;44445;11418;0;4.7;1.2;0.0
83;2021-02-17;837;1868;0;45282;13286;0;4.8;1.4;0.0
83;2021-02-18;1541;3820;0;46823;17106;0;5.0;1.8;0.0
83;2021-02-19;1454;2404;0;48277;19510;0;5.1;2.1;0.0
83;2021-02-20;82;200;0;48359;19710;0;5.1;2.1;0.0
83;2021-02-21;21;37;0;48380;19747;0;5.1;2.1;0.0
83;2021-02-22;594;1766;0;48974;21513;0;5.2;2.3;0.0
83;2021-02-23;725;1535;0;49699;23048;0;5.3;2.4;0.0
83;2021-02-24;786;1509;0;50485;24557;0;5.4;2.6;0.0
83;2021-02-25;1294;1478;0;51779;26035;0;5.5;2.8;0.0
83;2021-02-26;1365;1267;0;53144;27302;0;5.6;2.9;0.0
83;2021-02-27;571;91;0;53715;27393;0;5.7;2.9;0.0
83;2021-02-28;18;15;0;53733;27408;0;5.7;2.9;0.0
83;2021-03-01;845;1213;0;54578;28621;0;5.8;3.0;0.0
83;2021-03-02;1044;1337;0;55622;29958;0;5.9;3.2;0.0
83;2021-03-03;1492;1581;0;57114;31539;0;6.1;3.3;0.0
83;2021-03-04;1934;1458;0;59048;32997;0;6.3;3.5;0.0
83;2021-03-05;2299;1288;0;61347;34285;0;6.5;3.6;0.0
83;2021-03-06;3083;162;0;64430;34447;0;6.8;3.7;0.0
83;2021-03-07;2325;70;0;66755;34517;0;7.1;3.7;0.0
83;2021-03-08;968;1318;0;67723;35835;0;7.2;3.8;0.0
83;2021-03-09;2016;1270;0;69739;37105;0;7.4;3.9;0.0
83;2021-03-10;2484;1387;0;72223;38492;0;7.7;4.1;0.0
83;2021-03-11;3764;2139;0;75987;40631;0;8.1;4.3;0.0
83;2021-03-12;3788;1496;0;79775;42127;0;8.5;4.5;0.0
83;2021-03-13;4607;188;0;84382;42315;0;9.0;4.5;0.0
83;2021-03-14;2259;61;0;86641;42376;0;9.2;4.5;0.0
83;2021-03-15;3334;722;0;89975;43098;0;9.6;4.6;0.0
83;2021-03-16;2598;759;0;92573;43857;0;9.8;4.7;0.0
83;2021-03-17;2897;824;0;95470;44681;0;10.1;4.7;0.0
83;2021-03-18;3535;859;0;99005;45540;0;10.5;4.8;0.0
83;2021-03-19;4169;672;0;103174;46212;0;11.0;4.9;0.0
83;2021-03-20;3404;102;0;106578;46314;0;11.3;4.9;0.0
83;2021-03-21;1911;35;0;108489;46349;0;11.5;4.9;0.0
83;2021-03-22;3938;946;0;112427;47295;0;11.9;5.0;0.0
83;2021-03-23;4688;647;0;117115;47942;0;12.4;5.1;0.0
83;2021-03-24;5019;789;0;122134;48731;0;13.0;5.2;0.0
83;2021-03-25;6521;948;0;128655;49679;0;13.7;5.3;0.0
83;2021-03-26;7131;846;0;135786;50525;0;14.4;5.4;0.0
83;2021-03-27;3925;395;0;139711;50920;0;14.8;5.4;0.0
83;2021-03-28;2094;40;0;141805;50960;0;15.1;5.4;0.0
83;2021-03-29;4545;810;0;146350;51770;0;15.5;5.5;0.0
83;2021-03-30;6081;1015;0;152431;52785;0;16.2;5.6;0.0
83;2021-03-31;5681;1084;0;158112;53869;0;16.8;5.7;0.0
83;2021-04-01;6184;1335;0;164296;55204;0;17.4;5.9;0.0
83;2021-04-02;5868;1150;0;170164;56354;0;18.1;6.0;0.0
83;2021-04-03;1916;710;0;172080;57064;0;18.3;6.1;0.0
83;2021-04-04;831;357;0;172911;57421;0;18.4;6.1;0.0
83;2021-04-05;306;78;0;173217;57499;0;18.4;6.1;0.0
83;2021-04-06;4779;1512;0;177996;59011;0;18.9;6.3;0.0
83;2021-04-07;5808;1727;0;183804;60738;0;19.5;6.4;0.0
83;2021-04-08;7767;2128;0;191571;62866;0;20.3;6.7;0.0
83;2021-04-09;7580;2248;0;199151;65114;0;21.1;6.9;0.0
83;2021-04-10;3013;2584;0;202164;67698;0;21.5;7.2;0.0
83;2021-04-11;1632;2009;0;203796;69707;0;21.6;7.4;0.0
83;2021-04-12;4912;2854;0;208708;72561;0;22.2;7.7;0.0
83;2021-04-13;5590;2968;0;214298;75529;0;22.8;8.0;0.0
83;2021-04-14;5975;2990;0;220273;78519;0;23.4;8.3;0.0
83;2021-04-15;6861;3052;0;227134;81571;0;24.1;8.7;0.0
83;2021-04-16;6172;3523;0;233306;85094;0;24.8;9.0;0.0
83;2021-04-17;3377;2107;0;236683;87201;0;25.1;9.3;0.0
83;2021-04-18;2058;1271;0;238741;88472;0;25.3;9.4;0.0
83;2021-04-19;4116;3820;0;242857;92292;0;25.8;9.8;0.0
83;2021-04-20;4430;3922;0;247287;96214;0;26.3;10.2;0.0
83;2021-04-21;4421;4131;0;251708;100345;0;26.7;10.7;0.0
83;2021-04-22;5065;4345;0;256773;104690;0;27.3;11.1;0.0
83;2021-04-23;4524;4505;0;261297;109195;0;27.7;11.6;0.0
83;2021-04-24;2639;2668;0;263936;111863;0;28.0;11.9;0.0
83;2021-04-25;1834;1501;0;265770;113364;0;28.2;12.0;0.0
83;2021-04-26;3543;3862;0;269313;117226;0;28.6;12.4;0.0
83;2021-04-27;4162;4622;0;273475;121848;0;29.0;12.9;0.0
83;2021-04-28;4403;4470;0;277878;126318;0;29.5;13.4;0.0
83;2021-04-29;5884;5198;0;283762;131516;0;30.1;14.0;0.0
83;2021-04-30;5806;4467;0;289568;135983;0;30.7;14.4;0.0
83;2021-05-01;1809;525;0;291377;136508;0;30.9;14.5;0.0
83;2021-05-02;1207;744;0;292584;137252;0;31.1;14.6;0.0
83;2021-05-03;3953;4228;0;296537;141480;0;31.5;15.0;0.0
83;2021-05-04;3628;5166;0;300165;146646;0;31.9;15.6;0.0
83;2021-05-05;3798;5000;0;303963;151646;0;32.3;16.1;0.0
83;2021-05-06;4901;4983;0;308864;156629;0;32.8;16.6;0.0
83;2021-05-07;4288;5348;0;313152;161977;0;33.2;17.2;0.0
83;2021-05-08;2759;1068;0;315911;163045;0;33.5;17.3;0.0
83;2021-05-09;1996;1189;0;317907;164234;0;33.7;17.4;0.0
83;2021-05-10;3284;5437;0;321191;169671;0;34.1;18.0;0.0
83;2021-05-11;5010;5766;0;326201;175437;0;34.6;18.6;0.0
83;2021-05-12;6103;4928;0;332304;180365;0;35.3;19.1;0.0
83;2021-05-13;5928;1299;0;338232;181664;0;35.9;19.3;0.0
83;2021-05-14;6953;3974;0;345185;185638;0;36.6;19.7;0.0
83;2021-05-15;7171;2235;0;352356;187873;0;37.4;19.9;0.0
83;2021-05-16;5988;1150;0;358344;189023;0;38.0;20.1;0.0
83;2021-05-17;4942;4138;0;363286;193161;0;38.6;20.5;0.0
83;2021-05-18;5545;3769;0;368831;196930;0;39.2;20.9;0.0
83;2021-05-19;6178;3480;0;375009;200410;0;39.8;21.3;0.0
83;2021-05-20;6789;3767;0;381798;204177;0;40.5;21.7;0.0
83;2021-05-21;7618;3824;0;389416;208001;0;41.3;22.1;0.0
83;2021-05-22;5493;1699;0;394909;209700;0;41.9;22.3;0.0
83;2021-05-23;4074;619;0;398983;210319;0;42.4;22.3;0.0
83;2021-05-24;5274;895;0;404257;211214;0;42.9;22.4;0.0
83;2021-05-25;5276;4681;0;409533;215895;0;43.5;22.9;0.0
83;2021-05-26;4872;4396;0;414405;220291;0;44.0;23.4;0.0
83;2021-05-27;5044;5164;0;419449;225455;0;44.5;23.9;0.0
83;2021-05-28;4437;5686;0;423886;231141;0;45.0;24.5;0.0
83;2021-05-29;2676;4201;0;426562;235342;0;45.3;25.0;0.0
83;2021-05-30;1140;1282;0;427702;236624;0;45.4;25.1;0.0
83;2021-05-31;5269;4815;0;432971;241439;0;46.0;25.6;0.0
83;2021-06-01;5725;5359;0;438696;246798;0;46.6;26.2;0.0
83;2021-06-02;5170;4706;0;443866;251504;0;47.1;26.7;0.0
83;2021-06-03;5721;5122;0;449587;256626;0;47.7;27.2;0.0
83;2021-06-04;5427;5928;0;455014;262554;0;48.3;27.9;0.0
83;2021-06-05;3776;3176;0;458790;265730;0;48.7;28.2;0.0
83;2021-06-06;1794;1324;0;460584;267054;0;48.9;28.4;0.0
83;2021-06-07;3819;5049;0;464403;272103;0;49.3;28.9;0.0
83;2021-06-08;4135;4788;0;468538;276891;0;49.7;29.4;0.0
83;2021-06-09;4028;4662;0;472566;281553;0;50.2;29.9;0.0
83;2021-06-10;4095;4213;0;476661;285766;0;50.6;30.3;0.0
83;2021-06-11;3638;5442;0;480299;291208;0;51.0;30.9;0.0
83;2021-06-12;2893;2981;0;483192;294189;0;51.3;31.2;0.0
83;2021-06-13;937;1290;0;484129;295479;0;51.4;31.4;0.0
83;2021-06-14;2787;5644;0;486916;301123;0;51.7;32.0;0.0
83;2021-06-15;3154;4993;0;490070;306116;0;52.0;32.5;0.0
83;2021-06-16;3112;4513;0;493182;310629;0;52.4;33.0;0.0
83;2021-06-17;2945;5256;0;496127;315885;0;52.7;33.5;0.0
83;2021-06-18;3195;5828;0;499322;321713;0;53.0;34.2;0.0
83;2021-06-19;2245;3976;0;501567;325689;0;53.2;34.6;0.0
83;2021-06-20;620;1734;0;502187;327423;0;53.3;34.8;0.0
83;2021-06-21;2049;7296;0;504236;334719;0;53.5;35.5;0.0
83;2021-06-22;2088;6942;0;506324;341661;0;53.8;36.3;0.0
83;2021-06-23;2039;6829;0;508363;348490;0;54.0;37.0;0.0
83;2021-06-24;2122;7055;0;510485;355545;0;54.2;37.7;0.0
83;2021-06-25;2157;8085;0;512642;363630;0;54.4;38.6;0.0
83;2021-06-26;1405;6463;0;514047;370093;0;54.6;39.3;0.0
83;2021-06-27;589;2954;0;514636;373047;0;54.6;39.6;0.0
83;2021-06-28;1470;7640;0;516106;380687;0;54.8;40.4;0.0
83;2021-06-29;1877;7590;0;517983;388277;0;55.0;41.2;0.0
83;2021-06-30;2196;7007;0;520179;395284;0;55.2;42.0;0.0
83;2021-07-01;2700;6431;0;522879;401715;0;55.5;42.6;0.0
83;2021-07-02;2433;7492;0;525312;409207;0;55.8;43.4;0.0
83;2021-07-03;1494;5393;0;526806;414600;0;55.9;44.0;0.0
83;2021-07-04;526;2500;0;527332;417100;0;56.0;44.3;0.0
83;2021-07-05;1917;7212;0;529249;424312;0;56.2;45.0;0.0
83;2021-07-06;2505;5817;0;531754;430129;0;56.5;45.7;0.0
83;2021-07-07;2647;4514;0;534401;434643;0;56.7;46.1;0.0
83;2021-07-08;3150;4387;0;537551;439030;0;57.1;46.6;0.0
83;2021-07-09;3033;6595;0;540584;445625;0;57.4;47.3;0.0
83;2021-07-10;1545;4699;0;542129;450324;0;57.6;47.8;0.0
83;2021-07-11;910;1637;0;543039;451961;0;57.7;48.0;0.0
83;2021-07-12;2112;7259;0;545151;459220;0;57.9;48.8;0.0
83;2021-07-13;3913;6815;0;549064;466035;0;58.3;49.5;0.0
83;2021-07-14;1956;1263;0;551020;467298;0;58.5;49.6;0.0
83;2021-07-15;4667;6707;0;555687;474005;0;59.0;50.3;0.0
83;2021-07-16;5240;6798;0;560927;480803;0;59.5;51.0;0.0
83;2021-07-17;3519;4825;0;564446;485628;0;59.9;51.6;0.0
83;2021-07-18;1529;1279;0;565975;486907;0;60.1;51.7;0.0
83;2021-07-19;3924;6106;0;569899;493013;0;60.5;52.3;0.0
83;2021-07-20;5738;5959;0;575637;498972;0;61.1;53.0;0.0
83;2021-07-21;5745;5048;0;581382;504020;0;61.7;53.5;0.0
83;2021-07-22;6902;5346;0;588284;509366;0;62.5;54.1;0.0
83;2021-07-23;6637;5497;0;594921;514863;0;63.2;54.7;0.0
83;2021-07-24;4424;4309;0;599345;519172;0;63.6;55.1;0.0
83;2021-07-25;1298;704;0;600643;519876;0;63.8;55.2;0.0
83;2021-07-26;5346;4403;0;605989;524279;0;64.3;55.7;0.0
83;2021-07-27;6645;4457;0;612634;528736;0;65.0;56.1;0.0
83;2021-07-28;6406;4064;0;619040;532800;0;65.7;56.6;0.0
83;2021-07-29;7381;4504;0;626421;537304;0;66.5;57.0;0.0
83;2021-07-30;6722;4353;0;633143;541657;0;67.2;57.5;0.0
83;2021-07-31;4475;2939;0;637618;544596;0;67.7;57.8;0.0
83;2021-08-01;1121;776;0;638739;545372;0;67.8;57.9;0.0
83;2021-08-02;5820;3210;0;644559;548582;0;68.4;58.2;0.0
83;2021-08-03;6221;3553;0;650780;552135;0;69.1;58.6;0.0
83;2021-08-04;5741;3126;0;656521;555261;0;69.7;58.9;0.0
83;2021-08-05;5970;3561;0;662491;558822;0;70.3;59.3;0.0
83;2021-08-06;5901;4129;0;668392;562951;0;71.0;59.8;0.0
83;2021-08-07;3549;3081;0;671941;566032;0;71.3;60.1;0.0
83;2021-08-08;998;757;0;672939;566789;0;71.4;60.2;0.0
83;2021-08-09;4484;3909;0;677423;570698;0;71.9;60.6;0.0
83;2021-08-10;5097;4452;0;682520;575150;0;72.5;61.1;0.0
83;2021-08-11;4458;4455;0;686978;579605;0;72.9;61.5;0.0
83;2021-08-12;4734;5071;0;691712;584676;0;73.4;62.1;0.0
83;2021-08-13;4563;4905;0;696275;589581;0;73.9;62.6;0.0
83;2021-08-14;3027;3597;0;699302;593178;0;74.2;63.0;0.0
83;2021-08-15;227;355;0;699529;593533;0;74.3;63.0;0.0
83;2021-08-16;3611;5004;0;703140;598537;0;74.6;63.5;0.0
83;2021-08-17;3594;5034;0;706734;603571;0;75.0;64.1;0.0
83;2021-08-18;3431;4799;0;710165;608370;0;75.4;64.6;0.0
83;2021-08-19;4035;5705;0;714200;614075;0;75.8;65.2;0.0
83;2021-08-20;3512;5945;0;717712;620020;0;76.2;65.8;0.0
83;2021-08-21;2174;4187;0;719886;624207;0;76.4;66.3;0.0
83;2021-08-22;584;978;0;720470;625185;0;76.5;66.4;0.0
83;2021-08-23;2442;5549;0;722912;630734;0;76.7;67.0;0.0
83;2021-08-24;2782;5696;0;725694;636430;0;77.0;67.6;0.0
83;2021-08-25;2488;5152;0;728182;641582;0;77.3;68.1;0.0
83;2021-08-26;2834;5749;0;731016;647331;0;77.6;68.7;0.0
83;2021-08-27;2846;5805;0;733862;653136;0;77.9;69.3;0.0
83;2021-08-28;1814;4296;0;735676;657432;0;78.1;69.8;0.0
83;2021-08-29;468;1189;0;736144;658621;0;78.2;69.9;0.0
83;2021-08-30;2285;5041;75;738429;663662;75;78.4;70.5;0.0
83;2021-08-31;2438;5392;171;740867;669054;246;78.7;71.0;0.0
83;2021-09-01;2811;4752;463;743678;673806;709;79.0;71.5;0.1
83;2021-09-02;2460;4388;467;746138;678194;1176;79.2;72.0;0.1
83;2021-09-03;2296;4712;546;748434;682906;1722;79.5;72.5;0.2
83;2021-09-04;1816;4322;227;750250;687228;1949;79.6;73.0;0.2
83;2021-09-05;533;433;110;750783;687661;2059;79.7;73.0;0.2
83;2021-09-06;1865;3358;704;752648;691019;2763;79.9;73.4;0.3
83;2021-09-07;1663;3257;674;754311;694276;3437;80.1;73.7;0.4
83;2021-09-08;1982;3498;516;756293;697774;3953;80.3;74.1;0.4
83;2021-09-09;1552;3324;636;757845;701098;4589;80.5;74.4;0.5
83;2021-09-10;1818;3675;745;759663;704773;5334;80.6;74.8;0.6
83;2021-09-11;1374;3568;262;761037;708341;5596;80.8;75.2;0.6
83;2021-09-12;219;454;43;761256;708795;5639;80.8;75.2;0.6
83;2021-09-13;1280;2499;907;762536;711294;6546;81.0;75.5;0.7
83;2021-09-14;1397;2487;1065;763933;713781;7611;81.1;75.8;0.8
83;2021-09-15;1437;2626;821;765370;716407;8432;81.3;76.1;0.9
83;2021-09-16;1066;2199;964;766436;718606;9396;81.4;76.3;1.0
83;2021-09-17;1059;2610;904;767495;721216;10300;81.5;76.6;1.1
83;2021-09-18;994;2912;289;768489;724128;10589;81.6;76.9;1.1
83;2021-09-19;111;407;51;768600;724535;10640;81.6;76.9;1.1
83;2021-09-20;755;2063;790;769355;726598;11430;81.7;77.1;1.2
83;2021-09-21;694;1796;795;770049;728394;12225;81.8;77.3;1.3
83;2021-09-22;774;2518;701;770823;730912;12926;81.8;77.6;1.4
83;2021-09-23;709;2068;749;771532;732980;13675;81.9;77.8;1.5
83;2021-09-24;789;2249;838;772321;735229;14513;82.0;78.1;1.5
83;2021-09-25;755;2606;281;773076;737835;14794;82.1;78.3;1.6
83;2021-09-26;76;441;30;773152;738276;14824;82.1;78.4;1.6
83;2021-09-27;582;1726;625;773734;740002;15449;82.1;78.6;1.6
83;2021-09-28;539;1482;643;774273;741484;16092;82.2;78.7;1.7
83;2021-09-29;721;1934;575;774994;743418;16667;82.3;78.9;1.8
83;2021-09-30;635;1509;806;775629;744927;17473;82.3;79.1;1.9
83;2021-10-01;1033;1552;844;776662;746479;18317;82.5;79.2;1.9
83;2021-10-02;702;1633;295;777364;748112;18612;82.5;79.4;2.0
83;2021-10-03;115;263;70;777479;748375;18682;82.5;79.4;2.0
83;2021-10-04;636;898;747;778115;749273;19429;82.6;79.5;2.1
83;2021-10-05;646;1143;1090;778761;750416;20519;82.7;79.7;2.2
83;2021-10-06;873;1638;1047;779634;752054;21566;82.8;79.8;2.3
83;2021-10-07;513;1087;1076;780147;753141;22642;82.8;80.0;2.4
83;2021-10-08;820;1423;1292;780967;754564;23934;82.9;80.1;2.5
83;2021-10-09;534;1030;402;781501;755594;24336;83.0;80.2;2.6
83;2021-10-10;26;67;7;781527;755661;24343;83.0;80.2;2.6
83;2021-10-11;657;1073;1333;782184;756734;25676;83.0;80.3;2.7
83;2021-10-12;530;831;1313;782714;757565;26989;83.1;80.4;2.9
83;2021-10-13;710;1101;1292;783424;758666;28281;83.2;80.5;3.0
83;2021-10-14;528;868;1494;783952;759534;29775;83.2;80.6;3.2
83;2021-10-15;761;1125;1826;784713;760659;31601;83.3;80.8;3.4
83;2021-10-16;567;886;550;785280;761545;32151;83.4;80.8;3.4
83;2021-10-17;31;45;16;785311;761590;32167;83.4;80.9;3.4
83;2021-10-18;565;813;1629;785876;762403;33796;83.4;80.9;3.6
83;2021-10-19;416;616;1266;786292;763019;35062;83.5;81.0;3.7
83;2021-10-20;607;905;1970;786899;763924;37032;83.5;81.1;3.9
83;2021-10-21;499;711;1793;787398;764635;38825;83.6;81.2;4.1
83;2021-10-22;546;793;1653;787944;765428;40478;83.7;81.3;4.3
83;2021-10-23;433;566;661;788377;765994;41139;83.7;81.3;4.4
83;2021-10-24;16;58;39;788393;766052;41178;83.7;81.3;4.4
83;2021-10-25;458;731;1949;788851;766783;43127;83.7;81.4;4.6
83;2021-10-26;437;619;2056;789288;767402;45183;83.8;81.5;4.8
83;2021-10-27;495;740;2486;789783;768142;47669;83.8;81.5;5.1
83;2021-10-28;420;598;2381;790203;768740;50050;83.9;81.6;5.3
83;2021-10-29;404;654;2075;790607;769394;52125;83.9;81.7;5.5
83;2021-10-30;368;486;894;790975;769880;53019;84.0;81.7;5.6
83;2021-10-31;21;45;36;790996;769925;53055;84.0;81.7;5.6
83;2021-11-01;81;49;77;791077;769974;53132;84.0;81.7;5.6
83;2021-11-02;383;635;1760;791460;770609;54892;84.0;81.8;5.8
83;2021-11-03;516;792;2922;791976;771401;57814;84.1;81.9;6.1
83;2021-11-04;372;596;2326;792348;771997;60140;84.1;82.0;6.4
83;2021-11-05;452;702;2674;792800;772699;62814;84.2;82.0;6.7
83;2021-11-06;317;552;1178;793117;773251;63992;84.2;82.1;6.8
83;2021-11-07;18;62;46;793135;773313;64038;84.2;82.1;6.8
83;2021-11-08;369;680;3417;793504;773993;67455;84.2;82.2;7.2
83;2021-11-09;368;519;3414;793872;774512;70869;84.3;82.2;7.5
83;2021-11-10;535;863;4532;794407;775375;75401;84.3;82.3;8.0
83;2021-11-11;52;98;111;794459;775473;75512;84.3;82.3;8.0
83;2021-11-12;416;649;3872;794875;776122;79384;84.4;82.4;8.4
83;2021-11-13;301;459;1528;795176;776581;80912;84.4;82.4;8.6
83;2021-11-14;13;64;91;795189;776645;81003;84.4;82.5;8.6
83;2021-11-15;370;572;4364;795559;777217;85367;84.5;82.5;9.1
83;2021-11-16;352;455;4051;795911;777672;89418;84.5;82.6;9.5
83;2021-11-17;514;740;4814;796425;778412;94232;84.6;82.6;10.0
83;2021-11-18;442;614;4598;796867;779026;98830;84.6;82.7;10.5
83;2021-11-19;571;633;4567;797438;779659;103397;84.7;82.8;11.0
83;2021-11-20;365;462;1882;797803;780121;105279;84.7;82.8;11.2
83;2021-11-21;27;55;68;797830;780176;105347;84.7;82.8;11.2
83;2021-11-22;471;390;4970;798301;780566;110317;84.7;82.9;11.7
83;2021-11-23;388;461;4603;798689;781027;114920;84.8;82.9;12.2
83;2021-11-24;640;690;5487;799329;781717;120407;84.9;83.0;12.8
83;2021-11-25;506;494;5925;799835;782211;126332;84.9;83.0;13.4
83;2021-11-26;587;596;7070;800422;782807;133402;85.0;83.1;14.2
83;2021-11-27;464;470;3648;800886;783277;137050;85.0;83.2;14.5
83;2021-11-28;40;60;186;800926;783337;137236;85.0;83.2;14.6
83;2021-11-29;445;506;7990;801371;783843;145226;85.1;83.2;15.4
83;2021-11-30;479;501;8310;801850;784344;153536;85.1;83.3;16.3
83;2021-12-01;484;626;9798;802334;784970;163334;85.2;83.3;17.3
83;2021-12-02;422;413;9974;802756;785383;173308;85.2;83.4;18.4
83;2021-12-03;530;611;10484;803286;785994;183792;85.3;83.4;19.5
83;2021-12-04;396;440;5492;803682;786434;189284;85.3;83.5;20.1
83;2021-12-05;40;100;1783;803722;786534;191067;85.3;83.5;20.3
83;2021-12-06;387;550;10355;804109;787084;201422;85.4;83.6;21.4
83;2021-12-07;491;572;11506;804600;787656;212928;85.4;83.6;22.6
83;2021-12-08;467;654;10853;805067;788310;223781;85.5;83.7;23.8
83;2021-12-09;487;610;11388;805554;788920;235169;85.5;83.8;25.0
83;2021-12-10;527;613;12052;806081;789533;247221;85.6;83.8;26.2
83;2021-12-11;419;488;5892;806500;790021;253113;85.6;83.9;26.9
83;2021-12-12;88;76;1063;806588;790097;254176;85.6;83.9;27.0
83;2021-12-13;426;539;11132;807014;790636;265308;85.7;83.9;28.2
83;2021-12-14;522;550;13129;807536;791186;278437;85.7;84.0;29.6
83;2021-12-15;545;697;12332;808081;791883;290769;85.8;84.1;30.9
83;2021-12-16;533;639;12718;808614;792522;303487;85.8;84.1;32.2
83;2021-12-17;577;789;12642;809191;793311;316129;85.9;84.2;33.6
83;2021-12-18;517;553;6280;809708;793864;322409;86.0;84.3;34.2
83;2021-12-19;96;92;1080;809804;793956;323489;86.0;84.3;34.3
84;2020-12-27;0;0;0;0;0;0;0.0;0.0;0.0
84;2020-12-28;3;0;0;3;0;0;0.0;0.0;0.0
84;2020-12-29;3;0;0;6;0;0;0.0;0.0;0.0
84;2020-12-30;3;0;0;9;0;0;0.0;0.0;0.0
84;2020-12-31;0;0;0;9;0;0;0.0;0.0;0.0
84;2021-01-01;0;0;0;9;0;0;0.0;0.0;0.0
84;2021-01-02;0;0;0;9;0;0;0.0;0.0;0.0
84;2021-01-03;0;0;0;9;0;0;0.0;0.0;0.0
84;2021-01-04;5;0;0;14;0;0;0.0;0.0;0.0
84;2021-01-05;4;0;0;18;0;0;0.0;0.0;0.0
84;2021-01-06;8;0;0;26;0;0;0.0;0.0;0.0
84;2021-01-07;62;0;0;88;0;0;0.0;0.0;0.0
84;2021-01-08;71;0;0;159;0;0;0.0;0.0;0.0
84;2021-01-09;21;0;0;180;0;0;0.0;0.0;0.0
84;2021-01-10;1;0;0;181;0;0;0.0;0.0;0.0
84;2021-01-11;174;1;0;355;1;0;0.1;0.0;0.0
84;2021-01-12;561;3;0;916;4;0;0.2;0.0;0.0
84;2021-01-13;294;0;0;1210;4;0;0.3;0.0;0.0
84;2021-01-14;790;13;0;2000;17;0;0.4;0.0;0.0
84;2021-01-15;514;9;0;2514;26;0;0.5;0.0;0.0
84;2021-01-16;114;1;0;2628;27;0;0.5;0.0;0.0
84;2021-01-17;29;1;0;2657;28;0;0.6;0.0;0.0
84;2021-01-18;593;3;0;3250;31;0;0.7;0.0;0.0
84;2021-01-19;849;2;0;4099;33;0;0.8;0.0;0.0
84;2021-01-20;949;6;0;5048;39;0;1.0;0.0;0.0
84;2021-01-21;961;6;0;6009;45;0;1.2;0.0;0.0
84;2021-01-22;1006;0;0;7015;45;0;1.5;0.0;0.0
84;2021-01-23;215;0;0;7230;45;0;1.5;0.0;0.0
84;2021-01-24;6;0;0;7236;45;0;1.5;0.0;0.0
84;2021-01-25;701;5;0;7937;50;0;1.6;0.0;0.0
84;2021-01-26;876;9;0;8813;59;0;1.8;0.0;0.0
84;2021-01-27;980;6;0;9793;65;0;2.0;0.0;0.0
84;2021-01-28;1428;20;0;11221;85;0;2.3;0.0;0.0
84;2021-01-29;1077;48;0;12298;133;0;2.5;0.0;0.0
84;2021-01-30;125;19;0;12423;152;0;2.6;0.0;0.0
84;2021-01-31;13;0;0;12436;152;0;2.6;0.0;0.0
84;2021-02-01;607;150;0;13043;302;0;2.7;0.1;0.0
84;2021-02-02;745;223;0;13788;525;0;2.9;0.1;0.0
84;2021-02-03;626;225;0;14414;750;0;3.0;0.2;0.0
84;2021-02-04;799;359;0;15213;1109;0;3.2;0.2;0.0
84;2021-02-05;647;377;0;15860;1486;0;3.3;0.3;0.0
84;2021-02-06;109;43;0;15969;1529;0;3.3;0.3;0.0
84;2021-02-07;2;0;0;15971;1529;0;3.3;0.3;0.0
84;2021-02-08;543;259;0;16514;1788;0;3.4;0.4;0.0
84;2021-02-09;648;638;0;17162;2426;0;3.6;0.5;0.0
84;2021-02-10;525;568;0;17687;2994;0;3.7;0.6;0.0
84;2021-02-11;556;561;0;18243;3555;0;3.8;0.7;0.0
84;2021-02-12;534;614;0;18777;4169;0;3.9;0.9;0.0
84;2021-02-13;54;114;0;18831;4283;0;3.9;0.9;0.0
84;2021-02-14;4;8;0;18835;4291;0;3.9;0.9;0.0
84;2021-02-15;200;734;0;19035;5025;0;3.9;1.0;0.0
84;2021-02-16;223;724;0;19258;5749;0;4.0;1.2;0.0
84;2021-02-17;415;766;0;19673;6515;0;4.1;1.3;0.0
84;2021-02-18;503;1029;0;20176;7544;0;4.2;1.6;0.0
84;2021-02-19;711;1052;0;20887;8596;0;4.3;1.8;0.0
84;2021-02-20;68;116;0;20955;8712;0;4.3;1.8;0.0
84;2021-02-21;5;35;0;20960;8747;0;4.3;1.8;0.0
84;2021-02-22;306;644;0;21266;9391;0;4.4;1.9;0.0
84;2021-02-23;274;664;0;21540;10055;0;4.5;2.1;0.0
84;2021-02-24;378;689;0;21918;10744;0;4.5;2.2;0.0
84;2021-02-25;697;756;0;22615;11500;0;4.7;2.4;0.0
84;2021-02-26;812;610;0;23427;12110;0;4.9;2.5;0.0
84;2021-02-27;142;106;0;23569;12216;0;4.9;2.5;0.0
84;2021-02-28;13;2;0;23582;12218;0;4.9;2.5;0.0
84;2021-03-01;461;566;0;24043;12784;0;5.0;2.6;0.0
84;2021-03-02;632;711;0;24675;13495;0;5.1;2.8;0.0
84;2021-03-03;874;809;0;25549;14304;0;5.3;3.0;0.0
84;2021-03-04;1130;607;0;26679;14911;0;5.5;3.1;0.0
84;2021-03-05;1315;505;0;27994;15416;0;5.8;3.2;0.0
84;2021-03-06;1378;68;0;29372;15484;0;6.1;3.2;0.0
84;2021-03-07;557;28;0;29929;15512;0;6.2;3.2;0.0
84;2021-03-08;748;586;0;30677;16098;0;6.4;3.3;0.0
84;2021-03-09;1345;656;0;32022;16754;0;6.6;3.5;0.0
84;2021-03-10;1444;604;0;33466;17358;0;6.9;3.6;0.0
84;2021-03-11;1939;613;0;35405;17971;0;7.3;3.7;0.0
84;2021-03-12;2057;608;0;37462;18579;0;7.8;3.8;0.0
84;2021-03-13;833;47;0;38295;18626;0;7.9;3.9;0.0
84;2021-03-14;287;47;0;38582;18673;0;8.0;3.9;0.0
84;2021-03-15;1067;306;0;39649;18979;0;8.2;3.9;0.0
84;2021-03-16;1160;318;0;40809;19297;0;8.5;4.0;0.0
84;2021-03-17;1169;464;0;41978;19761;0;8.7;4.1;0.0
84;2021-03-18;1450;399;0;43428;20160;0;9.0;4.2;0.0
84;2021-03-19;2101;471;0;45529;20631;0;9.4;4.3;0.0
84;2021-03-20;880;48;0;46409;20679;0;9.6;4.3;0.0
84;2021-03-21;148;9;0;46557;20688;0;9.6;4.3;0.0
84;2021-03-22;1218;445;0;47775;21133;0;9.9;4.4;0.0
84;2021-03-23;1951;429;0;49726;21562;0;10.3;4.5;0.0
84;2021-03-24;2116;391;0;51842;21953;0;10.7;4.5;0.0
84;2021-03-25;3546;401;0;55388;22354;0;11.5;4.6;0.0
84;2021-03-26;3280;485;0;58668;22839;0;12.2;4.7;0.0
84;2021-03-27;944;83;0;59612;22922;0;12.4;4.7;0.0
84;2021-03-28;86;2;0;59698;22924;0;12.4;4.7;0.0
84;2021-03-29;1707;558;0;61405;23482;0;12.7;4.9;0.0
84;2021-03-30;2627;723;0;64032;24205;0;13.3;5.0;0.0
84;2021-03-31;2313;679;0;66345;24884;0;13.7;5.2;0.0
84;2021-04-01;2980;598;0;69325;25482;0;14.4;5.3;0.0
84;2021-04-02;2370;562;0;71695;26044;0;14.9;5.4;0.0
84;2021-04-03;528;83;0;72223;26127;0;15.0;5.4;0.0
84;2021-04-04;24;8;0;72247;26135;0;15.0;5.4;0.0
84;2021-04-05;811;111;0;73058;26246;0;15.1;5.4;0.0
84;2021-04-06;2045;861;0;75103;27107;0;15.6;5.6;0.0
84;2021-04-07;2344;916;0;77447;28023;0;16.0;5.8;0.0
84;2021-04-08;3523;1043;0;80970;29066;0;16.8;6.0;0.0
84;2021-04-09;3950;915;0;84920;29981;0;17.6;6.2;0.0
84;2021-04-10;1411;185;0;86331;30166;0;17.9;6.2;0.0
84;2021-04-11;61;26;0;86392;30192;0;17.9;6.3;0.0
84;2021-04-12;2125;850;0;88517;31042;0;18.3;6.4;0.0
84;2021-04-13;2855;1377;0;91372;32419;0;18.9;6.7;0.0
84;2021-04-14;2669;1331;0;94041;33750;0;19.5;7.0;0.0
84;2021-04-15;3162;1376;0;97203;35126;0;20.1;7.3;0.0
84;2021-04-16;3307;1466;0;100510;36592;0;20.8;7.6;0.0
84;2021-04-17;1504;252;0;102014;36844;0;21.1;7.6;0.0
84;2021-04-18;72;23;0;102086;36867;0;21.1;7.6;0.0
84;2021-04-19;2316;1040;0;104402;37907;0;21.6;7.9;0.0
84;2021-04-20;2519;1586;0;106921;39493;0;22.2;8.2;0.0
84;2021-04-21;2481;1534;0;109402;41027;0;22.7;8.5;0.0
84;2021-04-22;2805;1686;0;112207;42713;0;23.2;8.8;0.0
84;2021-04-23;2737;1809;0;114944;44522;0;23.8;9.2;0.0
84;2021-04-24;1388;354;0;116332;44876;0;24.1;9.3;0.0
84;2021-04-25;88;27;0;116420;44903;0;24.1;9.3;0.0
84;2021-04-26;2086;1398;0;118506;46301;0;24.6;9.6;0.0
84;2021-04-27;2458;1950;0;120964;48251;0;25.1;10.0;0.0
84;2021-04-28;2615;1786;0;123579;50037;0;25.6;10.4;0.0
84;2021-04-29;3142;1989;0;126721;52026;0;26.3;10.8;0.0
84;2021-04-30;2907;2226;0;129628;54252;0;26.9;11.2;0.0
84;2021-05-01;531;275;0;130159;54527;0;27.0;11.3;0.0
84;2021-05-02;134;29;0;130293;54556;0;27.0;11.3;0.0
84;2021-05-03;2081;1694;0;132374;56250;0;27.4;11.7;0.0
84;2021-05-04;2427;2423;0;134801;58673;0;27.9;12.2;0.0
84;2021-05-05;2270;2226;0;137071;60899;0;28.4;12.6;0.0
84;2021-05-06;3106;2211;0;140177;63110;0;29.0;13.1;0.0
84;2021-05-07;2621;2467;0;142798;65577;0;29.6;13.6;0.0
84;2021-05-08;1142;557;0;143940;66134;0;29.8;13.7;0.0
84;2021-05-09;90;82;0;144030;66216;0;29.8;13.7;0.0
84;2021-05-10;2016;2390;0;146046;68606;0;30.3;14.2;0.0
84;2021-05-11;2882;3033;0;148928;71639;0;30.9;14.8;0.0
84;2021-05-12;2800;2730;0;151728;74369;0;31.4;15.4;0.0
84;2021-05-13;2137;832;0;153865;75201;0;31.9;15.6;0.0
84;2021-05-14;2763;1984;0;156628;77185;0;32.4;16.0;0.0
84;2021-05-15;2160;982;0;158788;78167;0;32.9;16.2;0.0
84;2021-05-16;1381;193;0;160169;78360;0;33.2;16.2;0.0
84;2021-05-17;2286;2023;0;162455;80383;0;33.7;16.7;0.0
84;2021-05-18;2918;2016;0;165373;82399;0;34.3;17.1;0.0
84;2021-05-19;3245;1636;0;168618;84035;0;34.9;17.4;0.0
84;2021-05-20;3725;2119;0;172343;86154;0;35.7;17.8;0.0
84;2021-05-21;3502;2214;0;175845;88368;0;36.4;18.3;0.0
84;2021-05-22;1631;648;0;177476;89016;0;36.8;18.4;0.0
84;2021-05-23;178;31;0;177654;89047;0;36.8;18.4;0.0
84;2021-05-24;1895;421;0;179549;89468;0;37.2;18.5;0.0
84;2021-05-25;2954;2145;0;182503;91613;0;37.8;19.0;0.0
84;2021-05-26;3003;2046;0;185506;93659;0;38.4;19.4;0.0
84;2021-05-27;3653;2217;0;189159;95876;0;39.2;19.9;0.0
84;2021-05-28;3022;3083;0;192181;98959;0;39.8;20.5;0.0
84;2021-05-29;1214;1541;0;193395;100500;0;40.1;20.8;0.0
84;2021-05-30;67;108;0;193462;100608;0;40.1;20.8;0.0
84;2021-05-31;2140;2494;0;195602;103102;0;40.5;21.4;0.0
84;2021-06-01;3083;3005;0;198685;106107;0;41.2;22.0;0.0
84;2021-06-02;3005;2412;0;201690;108519;0;41.8;22.5;0.0
84;2021-06-03;3954;2829;0;205644;111348;0;42.6;23.1;0.0
84;2021-06-04;3502;2888;0;209146;114236;0;43.3;23.7;0.0
84;2021-06-05;1666;1384;0;210812;115620;0;43.7;24.0;0.0
84;2021-06-06;881;195;0;211693;115815;0;43.9;24.0;0.0
84;2021-06-07;2342;2646;0;214035;118461;0;44.3;24.5;0.0
84;2021-06-08;3114;2912;0;217149;121373;0;45.0;25.1;0.0
84;2021-06-09;2784;2509;0;219933;123882;0;45.6;25.7;0.0
84;2021-06-10;3280;2693;0;223213;126575;0;46.2;26.2;0.0
84;2021-06-11;2872;2951;0;226085;129526;0;46.8;26.8;0.0
84;2021-06-12;1769;1286;0;227854;130812;0;47.2;27.1;0.0
84;2021-06-13;390;199;0;228244;131011;0;47.3;27.1;0.0
84;2021-06-14;1786;3121;0;230030;134132;0;47.7;27.8;0.0
84;2021-06-15;2313;3301;0;232343;137433;0;48.1;28.5;0.0
84;2021-06-16;2434;2853;0;234777;140286;0;48.6;29.1;0.0
84;2021-06-17;2672;3330;0;237449;143616;0;49.2;29.8;0.0
84;2021-06-18;2240;3418;0;239689;147034;0;49.7;30.5;0.0
84;2021-06-19;1192;1581;0;240881;148615;0;49.9;30.8;0.0
84;2021-06-20;426;329;0;241307;148944;0;50.0;30.9;0.0
84;2021-06-21;1475;3080;0;242782;152024;0;50.3;31.5;0.0
84;2021-06-22;2034;3861;0;244816;155885;0;50.7;32.3;0.0
84;2021-06-23;1945;3243;0;246761;159128;0;51.1;33.0;0.0
84;2021-06-24;1996;3443;0;248757;162571;0;51.5;33.7;0.0
84;2021-06-25;1716;3844;0;250473;166415;0;51.9;34.5;0.0
84;2021-06-26;1048;1739;0;251521;168154;0;52.1;34.8;0.0
84;2021-06-27;243;379;0;251764;168533;0;52.2;34.9;0.0
84;2021-06-28;1079;3175;0;252843;171708;0;52.4;35.6;0.0
84;2021-06-29;1281;3853;0;254124;175561;0;52.6;36.4;0.0
84;2021-06-30;1643;3828;0;255767;179389;0;53.0;37.2;0.0
84;2021-07-01;1838;3721;0;257605;183110;0;53.4;37.9;0.0
84;2021-07-02;1771;3840;0;259376;186950;0;53.7;38.7;0.0
84;2021-07-03;1027;1949;0;260403;188899;0;53.9;39.1;0.0
84;2021-07-04;323;481;0;260726;189380;0;54.0;39.2;0.0
84;2021-07-05;1329;3332;0;262055;192712;0;54.3;39.9;0.0
84;2021-07-06;1515;3908;0;263570;196620;0;54.6;40.7;0.0
84;2021-07-07;1573;2835;0;265143;199455;0;54.9;41.3;0.0
84;2021-07-08;1961;3463;0;267104;202918;0;55.3;42.0;0.0
84;2021-07-09;1818;3782;0;268922;206700;0;55.7;42.8;0.0
84;2021-07-10;1116;2107;0;270038;208807;0;55.9;43.3;0.0
84;2021-07-11;307;285;0;270345;209092;0;56.0;43.3;0.0
84;2021-07-12;1316;3598;0;271661;212690;0;56.3;44.1;0.0
84;2021-07-13;2138;4657;0;273799;217347;0;56.7;45.0;0.0
84;2021-07-14;1685;1171;0;275484;218518;0;57.1;45.3;0.0
84;2021-07-15;2583;4272;0;278067;222790;0;57.6;46.2;0.0
84;2021-07-16;2708;4261;0;280775;227051;0;58.2;47.0;0.0
84;2021-07-17;1462;2266;0;282237;229317;0;58.5;47.5;0.0
84;2021-07-18;816;480;0;283053;229797;0;58.6;47.6;0.0
84;2021-07-19;2212;3488;0;285265;233285;0;59.1;48.3;0.0
84;2021-07-20;2942;3912;0;288207;237197;0;59.7;49.1;0.0
84;2021-07-21;3025;3482;0;291232;240679;0;60.3;49.9;0.0
84;2021-07-22;3567;3508;0;294799;244187;0;61.1;50.6;0.0
84;2021-07-23;3386;3436;0;298185;247623;0;61.8;51.3;0.0
84;2021-07-24;1524;2100;0;299709;249723;0;62.1;51.7;0.0
84;2021-07-25;877;432;0;300586;250155;0;62.3;51.8;0.0
84;2021-07-26;2505;2817;0;303091;252972;0;62.8;52.4;0.0
84;2021-07-27;3277;3222;0;306368;256194;0;63.5;53.1;0.0
84;2021-07-28;3430;2929;0;309798;259123;0;64.2;53.7;0.0
84;2021-07-29;3855;2927;0;313653;262050;0;65.0;54.3;0.0
84;2021-07-30;3744;3053;0;317397;265103;0;65.8;54.9;0.0
84;2021-07-31;1884;1565;0;319281;266668;0;66.1;55.2;0.0
84;2021-08-01;749;402;0;320030;267070;0;66.3;55.3;0.0
84;2021-08-02;2851;2464;0;322881;269534;0;66.9;55.8;0.0
84;2021-08-03;3727;2458;0;326608;271992;0;67.7;56.4;0.0
84;2021-08-04;3368;2236;0;329976;274228;0;68.4;56.8;0.0
84;2021-08-05;3481;2363;0;333457;276591;0;69.1;57.3;0.0
84;2021-08-06;3308;2591;0;336765;279182;0;69.8;57.8;0.0
84;2021-08-07;1751;1545;0;338516;280727;0;70.1;58.2;0.0
84;2021-08-08;321;607;0;338837;281334;0;70.2;58.3;0.0
84;2021-08-09;2547;2365;0;341384;283699;0;70.7;58.8;0.0
84;2021-08-10;3267;2564;0;344651;286263;0;71.4;59.3;0.0
84;2021-08-11;2825;2327;0;347476;288590;0;72.0;59.8;0.0
84;2021-08-12;2805;2675;0;350281;291265;0;72.6;60.3;0.0
84;2021-08-13;2655;2411;0;352936;293676;0;73.1;60.8;0.0
84;2021-08-14;1360;1641;0;354296;295317;0;73.4;61.2;0.0
84;2021-08-15;236;209;0;354532;295526;0;73.5;61.2;0.0
84;2021-08-16;2106;2850;0;356638;298376;0;73.9;61.8;0.0
84;2021-08-17;2342;2907;0;358980;301283;0;74.4;62.4;0.0
84;2021-08-18;2018;2581;0;360998;303864;0;74.8;63.0;0.0
84;2021-08-19;2094;2825;0;363092;306689;0;75.2;63.5;0.0
84;2021-08-20;1865;3014;0;364957;309703;0;75.6;64.2;0.0
84;2021-08-21;986;1719;0;365943;311422;0;75.8;64.5;0.0
84;2021-08-22;117;574;0;366060;311996;0;75.8;64.6;0.0
84;2021-08-23;1565;3037;0;367625;315033;0;76.2;65.3;0.0
84;2021-08-24;1757;3133;0;369382;318166;0;76.5;65.9;0.0
84;2021-08-25;1675;2998;0;371057;321164;0;76.9;66.5;0.0
84;2021-08-26;1441;3300;0;372498;324464;0;77.2;67.2;0.0
84;2021-08-27;1474;3436;0;373972;327900;0;77.5;67.9;0.0
84;2021-08-28;761;1981;0;374733;329881;0;77.6;68.3;0.0
84;2021-08-29;111;508;0;374844;330389;0;77.7;68.4;0.0
84;2021-08-30;1261;2889;41;376105;333278;41;77.9;69.0;0.0
84;2021-08-31;1238;3575;72;377343;336853;113;78.2;69.8;0.0
84;2021-09-01;1298;2993;143;378641;339846;256;78.4;70.4;0.1
84;2021-09-02;1121;2611;292;379762;342457;548;78.7;70.9;0.1
84;2021-09-03;1233;3154;227;380995;345611;775;78.9;71.6;0.2
84;2021-09-04;674;1725;75;381669;347336;850;79.1;72.0;0.2
84;2021-09-05;104;336;6;381773;347672;856;79.1;72.0;0.2
84;2021-09-06;785;2007;268;382558;349679;1124;79.3;72.4;0.2
84;2021-09-07;882;2154;372;383440;351833;1496;79.4;72.9;0.3
84;2021-09-08;831;2341;241;384271;354174;1737;79.6;73.4;0.4
84;2021-09-09;848;1906;389;385119;356080;2126;79.8;73.8;0.4
84;2021-09-10;873;2246;338;385992;358326;2464;80.0;74.2;0.5
84;2021-09-11;527;1556;120;386519;359882;2584;80.1;74.6;0.5
84;2021-09-12;86;192;5;386605;360074;2589;80.1;74.6;0.5
84;2021-09-13;654;1367;491;387259;361441;3080;80.2;74.9;0.6
84;2021-09-14;779;1393;527;388038;362834;3607;80.4;75.2;0.7
84;2021-09-15;775;1747;406;388813;364581;4013;80.6;75.5;0.8
84;2021-09-16;532;1147;500;389345;365728;4513;80.7;75.8;0.9
84;2021-09-17;575;1462;518;389920;367190;5031;80.8;76.1;1.0
84;2021-09-18;413;1252;141;390333;368442;5172;80.9;76.3;1.1
84;2021-09-19;43;140;0;390376;368582;5172;80.9;76.4;1.1
84;2021-09-20;310;815;317;390686;369397;5489;80.9;76.5;1.1
84;2021-09-21;361;1058;453;391047;370455;5942;81.0;76.7;1.2
84;2021-09-22;412;1434;488;391459;371889;6430;81.1;77.0;1.3
84;2021-09-23;358;1035;483;391817;372924;6913;81.2;77.3;1.4
84;2021-09-24;397;1141;348;392214;374065;7261;81.3;77.5;1.5
84;2021-09-25;286;1027;161;392500;375092;7422;81.3;77.7;1.5
84;2021-09-26;38;114;7;392538;375206;7429;81.3;77.7;1.5
84;2021-09-27;275;714;337;392813;375920;7766;81.4;77.9;1.6
84;2021-09-28;319;682;419;393132;376602;8185;81.4;78.0;1.7
84;2021-09-29;319;1065;430;393451;377667;8615;81.5;78.2;1.8
84;2021-09-30;337;813;533;393788;378480;9148;81.6;78.4;1.9
84;2021-10-01;573;799;398;394361;379279;9546;81.7;78.6;2.0
84;2021-10-02;265;707;183;394626;379986;9729;81.8;78.7;2.0
84;2021-10-03;34;72;2;394660;380058;9731;81.8;78.7;2.0
84;2021-10-04;364;505;415;395024;380563;10146;81.8;78.8;2.1
84;2021-10-05;349;481;468;395373;381044;10614;81.9;78.9;2.2
84;2021-10-06;360;733;498;395733;381777;11112;82.0;79.1;2.3
84;2021-10-07;352;598;569;396085;382375;11681;82.1;79.2;2.4
84;2021-10-08;441;719;680;396526;383094;12361;82.2;79.4;2.6
84;2021-10-09;216;547;209;396742;383641;12570;82.2;79.5;2.6
84;2021-10-10;25;91;6;396767;383732;12576;82.2;79.5;2.6
84;2021-10-11;283;362;322;397050;384094;12898;82.3;79.6;2.7
84;2021-10-12;334;402;637;397384;384496;13535;82.3;79.7;2.8
84;2021-10-13;390;567;609;397774;385063;14144;82.4;79.8;2.9
84;2021-10-14;277;396;555;398051;385459;14699;82.5;79.9;3.0
84;2021-10-15;300;556;665;398351;386015;15364;82.5;80.0;3.2
84;2021-10-16;286;373;225;398637;386388;15589;82.6;80.1;3.2
84;2021-10-17;23;47;7;398660;386435;15596;82.6;80.1;3.2
84;2021-10-18;252;352;553;398912;386787;16149;82.6;80.1;3.3
84;2021-10-19;221;377;787;399133;387164;16936;82.7;80.2;3.5
84;2021-10-20;316;459;934;399449;387623;17870;82.8;80.3;3.7
84;2021-10-21;219;361;680;399668;387984;18550;82.8;80.4;3.8
84;2021-10-22;247;481;830;399915;388465;19380;82.9;80.5;4.0
84;2021-10-23;209;285;222;400124;388750;19602;82.9;80.5;4.1
84;2021-10-24;19;28;4;400143;388778;19606;82.9;80.5;4.1
84;2021-10-25;252;356;613;400395;389134;20219;83.0;80.6;4.2
84;2021-10-26;243;323;758;400638;389457;20977;83.0;80.7;4.3
84;2021-10-27;223;396;1140;400861;389853;22117;83.0;80.8;4.6
84;2021-10-28;167;242;672;401028;390095;22789;83.1;80.8;4.7
84;2021-10-29;234;443;984;401262;390538;23773;83.1;80.9;4.9
84;2021-10-30;148;211;379;401410;390749;24152;83.2;81.0;5.0
84;2021-10-31;13;24;9;401423;390773;24161;83.2;81.0;5.0
84;2021-11-01;39;41;42;401462;390814;24203;83.2;81.0;5.0
84;2021-11-02;234;277;804;401696;391091;25007;83.2;81.0;5.2
84;2021-11-03;268;434;1050;401964;391525;26057;83.3;81.1;5.4
84;2021-11-04;170;249;920;402134;391774;26977;83.3;81.2;5.6
84;2021-11-05;236;346;1203;402370;392120;28180;83.4;81.2;5.8
84;2021-11-06;191;307;591;402561;392427;28771;83.4;81.3;6.0
84;2021-11-07;27;42;37;402588;392469;28808;83.4;81.3;6.0
84;2021-11-08;146;237;1054;402734;392706;29862;83.4;81.4;6.2
84;2021-11-09;183;340;1409;402917;393046;31271;83.5;81.4;6.5
84;2021-11-10;248;417;1539;403165;393463;32810;83.5;81.5;6.8
84;2021-11-11;45;45;156;403210;393508;32966;83.5;81.5;6.8
84;2021-11-12;207;242;1409;403417;393750;34375;83.6;81.6;7.1
84;2021-11-13;140;212;552;403557;393962;34927;83.6;81.6;7.2
84;2021-11-14;28;34;46;403585;393996;34973;83.6;81.6;7.2
84;2021-11-15;166;232;1241;403751;394228;36214;83.6;81.7;7.5
84;2021-11-16;178;270;1784;403929;394498;37998;83.7;81.7;7.9
84;2021-11-17;247;338;2049;404176;394836;40047;83.7;81.8;8.3
84;2021-11-18;185;243;1470;404361;395079;41517;83.8;81.9;8.6
84;2021-11-19;269;358;2016;404630;395437;43533;83.8;81.9;9.0
84;2021-11-20;185;205;771;404815;395642;44304;83.9;82.0;9.2
84;2021-11-21;18;32;85;404833;395674;44389;83.9;82.0;9.2
84;2021-11-22;177;221;1443;405010;395895;45832;83.9;82.0;9.5
84;2021-11-23;207;278;2333;405217;396173;48165;84.0;82.1;10.0
84;2021-11-24;252;312;2011;405469;396485;50176;84.0;82.1;10.4
84;2021-11-25;247;214;2225;405716;396699;52401;84.1;82.2;10.9
84;2021-11-26;253;331;3231;405969;397030;55632;84.1;82.3;11.5
84;2021-11-27;173;247;1762;406142;397277;57394;84.1;82.3;11.9
84;2021-11-28;38;49;412;406180;397326;57806;84.2;82.3;12.0
84;2021-11-29;126;194;2646;406306;397520;60452;84.2;82.4;12.5
84;2021-11-30;219;248;4043;406525;397768;64495;84.2;82.4;13.4
84;2021-12-01;236;281;3863;406761;398049;68358;84.3;82.5;14.2
84;2021-12-02;193;185;4786;406954;398234;73144;84.3;82.5;15.2
84;2021-12-03;239;263;5328;407193;398497;78472;84.4;82.6;16.3
84;2021-12-04;155;171;2567;407348;398668;81039;84.4;82.6;16.8
84;2021-12-05;51;49;753;407399;398717;81792;84.4;82.6;16.9
84;2021-12-06;138;180;3898;407537;398897;85690;84.4;82.6;17.8
84;2021-12-07;225;298;6390;407762;399195;92080;84.5;82.7;19.1
84;2021-12-08;224;306;5341;407986;399501;97421;84.5;82.8;20.2
84;2021-12-09;194;276;5982;408180;399777;103403;84.6;82.8;21.4
84;2021-12-10;207;345;5794;408387;400122;109197;84.6;82.9;22.6
84;2021-12-11;194;222;3025;408581;400344;112222;84.6;82.9;23.2
84;2021-12-12;69;52;1004;408650;400396;113226;84.7;83.0;23.5
84;2021-12-13;188;229;4344;408838;400625;117570;84.7;83.0;24.4
84;2021-12-14;275;326;6768;409113;400951;124338;84.8;83.1;25.8
84;2021-12-15;259;292;5911;409372;401243;130249;84.8;83.1;27.0
84;2021-12-16;264;328;7038;409636;401571;137287;84.9;83.2;28.4
84;2021-12-17;303;330;6502;409939;401901;143789;84.9;83.3;29.8
84;2021-12-18;224;264;3406;410163;402165;147195;85.0;83.3;30.5
84;2021-12-19;59;65;1042;410222;402230;148237;85.0;83.3;30.7
85;2020-12-27;0;0;0;0;0;0;0.0;0.0;0.0
85;2020-12-28;0;0;0;0;0;0;0.0;0.0;0.0
85;2020-12-29;0;0;0;0;0;0;0.0;0.0;0.0
85;2020-12-30;0;0;0;0;0;0;0.0;0.0;0.0
85;2020-12-31;0;0;0;0;0;0;0.0;0.0;0.0
85;2021-01-01;0;0;0;0;0;0;0.0;0.0;0.0
85;2021-01-02;0;0;0;0;0;0;0.0;0.0;0.0
85;2021-01-03;0;0;0;0;0;0;0.0;0.0;0.0
85;2021-01-04;22;0;0;22;0;0;0.0;0.0;0.0
85;2021-01-05;57;0;0;79;0;0;0.0;0.0;0.0
85;2021-01-06;94;1;0;173;1;0;0.0;0.0;0.0
85;2021-01-07;164;0;0;337;1;0;0.1;0.0;0.0
85;2021-01-08;289;2;0;626;3;0;0.1;0.0;0.0
85;2021-01-09;284;1;0;910;4;0;0.2;0.0;0.0
85;2021-01-10;66;0;0;976;4;0;0.2;0.0;0.0
85;2021-01-11;453;0;0;1429;4;0;0.2;0.0;0.0
85;2021-01-12;568;1;0;1997;5;0;0.3;0.0;0.0
85;2021-01-13;567;2;0;2564;7;0;0.4;0.0;0.0
85;2021-01-14;701;6;0;3265;13;0;0.5;0.0;0.0
85;2021-01-15;447;3;0;3712;16;0;0.6;0.0;0.0
85;2021-01-16;264;3;0;3976;19;0;0.7;0.0;0.0
85;2021-01-17;39;0;0;4015;19;0;0.7;0.0;0.0
85;2021-01-18;1010;3;0;5025;22;0;0.8;0.0;0.0
85;2021-01-19;1402;18;0;6427;40;0;1.1;0.0;0.0
85;2021-01-20;1917;6;0;8344;46;0;1.4;0.0;0.0
85;2021-01-21;3171;14;0;11515;60;0;1.9;0.0;0.0
85;2021-01-22;1685;20;0;13200;80;0;2.2;0.0;0.0
85;2021-01-23;458;1;0;13658;81;0;2.3;0.0;0.0
85;2021-01-24;46;0;0;13704;81;0;2.3;0.0;0.0
85;2021-01-25;581;1;0;14285;82;0;2.4;0.0;0.0
85;2021-01-26;928;31;0;15213;113;0;2.6;0.0;0.0
85;2021-01-27;1810;30;0;17023;143;0;2.9;0.0;0.0
85;2021-01-28;1733;25;0;18756;168;0;3.2;0.0;0.0
85;2021-01-29;892;72;0;19648;240;0;3.3;0.0;0.0
85;2021-01-30;155;9;0;19803;249;0;3.3;0.0;0.0
85;2021-01-31;4;51;0;19807;300;0;3.3;0.1;0.0
85;2021-02-01;481;118;0;20288;418;0;3.4;0.1;0.0
85;2021-02-02;548;172;0;20836;590;0;3.5;0.1;0.0
85;2021-02-03;427;283;0;21263;873;0;3.6;0.1;0.0
85;2021-02-04;622;280;0;21885;1153;0;3.7;0.2;0.0
85;2021-02-05;647;281;0;22532;1434;0;3.8;0.2;0.0
85;2021-02-06;158;238;0;22690;1672;0;3.8;0.3;0.0
85;2021-02-07;4;5;0;22694;1677;0;3.8;0.3;0.0
85;2021-02-08;380;649;0;23074;2326;0;3.9;0.4;0.0
85;2021-02-09;655;1029;0;23729;3355;0;4.0;0.6;0.0
85;2021-02-10;596;1134;0;24325;4489;0;4.1;0.8;0.0
85;2021-02-11;1507;2925;0;25832;7414;0;4.4;1.2;0.0
85;2021-02-12;1024;1289;0;26856;8703;0;4.5;1.5;0.0
85;2021-02-13;241;470;0;27097;9173;0;4.6;1.5;0.0
85;2021-02-14;3;127;0;27100;9300;0;4.6;1.6;0.0
85;2021-02-15;349;829;0;27449;10129;0;4.6;1.7;0.0
85;2021-02-16;586;1198;0;28035;11327;0;4.7;1.9;0.0
85;2021-02-17;760;1600;0;28795;12927;0;4.9;2.2;0.0
85;2021-02-18;1222;1948;0;30017;14875;0;5.1;2.5;0.0
85;2021-02-19;938;1210;0;30955;16085;0;5.2;2.7;0.0
85;2021-02-20;186;262;0;31141;16347;0;5.2;2.8;0.0
85;2021-02-21;3;13;0;31144;16360;0;5.2;2.8;0.0
85;2021-02-22;797;870;0;31941;17230;0;5.4;2.9;0.0
85;2021-02-23;825;520;0;32766;17750;0;5.5;3.0;0.0
85;2021-02-24;765;343;0;33531;18093;0;5.6;3.0;0.0
85;2021-02-25;1313;432;0;34844;18525;0;5.9;3.1;0.0
85;2021-02-26;1264;369;0;36108;18894;0;6.1;3.2;0.0
85;2021-02-27;421;105;0;36529;18999;0;6.2;3.2;0.0
85;2021-02-28;9;2;0;36538;19001;0;6.2;3.2;0.0
85;2021-03-01;768;435;0;37306;19436;0;6.3;3.3;0.0
85;2021-03-02;1098;767;0;38404;20203;0;6.5;3.4;0.0
85;2021-03-03;886;532;0;39290;20735;0;6.6;3.5;0.0
85;2021-03-04;1600;1165;0;40890;21900;0;6.9;3.7;0.0
85;2021-03-05;1793;877;0;42683;22777;0;7.2;3.8;0.0
85;2021-03-06;1202;137;0;43885;22914;0;7.4;3.9;0.0
85;2021-03-07;333;30;0;44218;22944;0;7.4;3.9;0.0
85;2021-03-08;1743;449;0;45961;23393;0;7.7;3.9;0.0
85;2021-03-09;2237;593;0;48198;23986;0;8.1;4.0;0.0
85;2021-03-10;1883;651;0;50081;24637;0;8.4;4.1;0.0
85;2021-03-11;3168;1080;0;53249;25717;0;9.0;4.3;0.0
85;2021-03-12;2781;854;0;56030;26571;0;9.4;4.5;0.0
85;2021-03-13;1393;173;0;57423;26744;0;9.7;4.5;0.0
85;2021-03-14;175;4;0;57598;26748;0;9.7;4.5;0.0
85;2021-03-15;1939;508;0;59537;27256;0;10.0;4.6;0.0
85;2021-03-16;1620;483;0;61157;27739;0;10.3;4.7;0.0
85;2021-03-17;985;514;0;62142;28253;0;10.5;4.8;0.0
85;2021-03-18;1869;452;0;64011;28705;0;10.8;4.8;0.0
85;2021-03-19;2249;362;0;66260;29067;0;11.2;4.9;0.0
85;2021-03-20;1085;174;0;67345;29241;0;11.3;4.9;0.0
85;2021-03-21;276;5;0;67621;29246;0;11.4;4.9;0.0
85;2021-03-22;1810;541;0;69431;29787;0;11.7;5.0;0.0
85;2021-03-23;2488;749;0;71919;30536;0;12.1;5.1;0.0
85;2021-03-24;2239;521;0;74158;31057;0;12.5;5.2;0.0
85;2021-03-25;3711;613;0;77869;31670;0;13.1;5.3;0.0
85;2021-03-26;3380;673;0;81249;32343;0;13.7;5.4;0.0
85;2021-03-27;1737;124;0;82986;32467;0;14.0;5.5;0.0
85;2021-03-28;548;6;0;83534;32473;0;14.1;5.5;0.0
85;2021-03-29;2422;760;0;85956;33233;0;14.5;5.6;0.0
85;2021-03-30;2884;1009;0;88840;34242;0;15.0;5.8;0.0
85;2021-03-31;2323;674;0;91163;34916;0;15.4;5.9;0.0
85;2021-04-01;3826;926;0;94989;35842;0;16.0;6.0;0.0
85;2021-04-02;2832;1127;0;97821;36969;0;16.5;6.2;0.0
85;2021-04-03;1395;321;0;99216;37290;0;16.7;6.3;0.0
85;2021-04-04;324;34;0;99540;37324;0;16.8;6.3;0.0
85;2021-04-05;140;172;0;99680;37496;0;16.8;6.3;0.0
85;2021-04-06;2169;1589;0;101849;39085;0;17.2;6.6;0.0
85;2021-04-07;3094;1193;0;104943;40278;0;17.7;6.8;0.0
85;2021-04-08;4570;1595;0;109513;41873;0;18.4;7.1;0.0
85;2021-04-09;4600;1213;0;114113;43086;0;19.2;7.3;0.0
85;2021-04-10;1799;400;0;115912;43486;0;19.5;7.3;0.0
85;2021-04-11;44;17;0;115956;43503;0;19.5;7.3;0.0
85;2021-04-12;4178;1437;0;120134;44940;0;20.2;7.6;0.0
85;2021-04-13;4652;1854;0;124786;46794;0;21.0;7.9;0.0
85;2021-04-14;4026;1050;0;128812;47844;0;21.7;8.1;0.0
85;2021-04-15;5361;1758;0;134173;49602;0;22.6;8.4;0.0
85;2021-04-16;5072;1577;0;139245;51179;0;23.5;8.6;0.0
85;2021-04-17;1407;433;0;140652;51612;0;23.7;8.7;0.0
85;2021-04-18;368;31;0;141020;51643;0;23.8;8.7;0.0
85;2021-04-19;3305;1689;0;144325;53332;0;24.3;9.0;0.0
85;2021-04-20;3719;1934;0;148044;55266;0;24.9;9.3;0.0
85;2021-04-21;2747;1685;0;150791;56951;0;25.4;9.6;0.0
85;2021-04-22;3766;2176;0;154557;59127;0;26.0;10.0;0.0
85;2021-04-23;4010;2112;0;158567;61239;0;26.7;10.3;0.0
85;2021-04-24;1653;1497;0;160220;62736;0;27.0;10.6;0.0
85;2021-04-25;953;569;0;161173;63305;0;27.1;10.7;0.0
85;2021-04-26;3630;2290;0;164803;65595;0;27.8;11.0;0.0
85;2021-04-27;4369;2203;0;169172;67798;0;28.5;11.4;0.0
85;2021-04-28;5711;1414;0;174883;69212;0;29.5;11.7;0.0
85;2021-04-29;5538;2025;0;180421;71237;0;30.4;12.0;0.0
85;2021-04-30;5569;1805;0;185990;73042;0;31.3;12.3;0.0
85;2021-05-01;1587;667;0;187577;73709;0;31.6;12.4;0.0
85;2021-05-02;721;443;0;188298;74152;0;31.7;12.5;0.0
85;2021-05-03;3535;2268;0;191833;76420;0;32.3;12.9;0.0
85;2021-05-04;3477;2964;0;195310;79384;0;32.9;13.4;0.0
85;2021-05-05;4565;2178;0;199875;81562;0;33.7;13.7;0.0
85;2021-05-06;4809;2625;0;204684;84187;0;34.5;14.2;0.0
85;2021-05-07;3975;3750;0;208659;87937;0;35.1;14.8;0.0
85;2021-05-08;2066;243;0;210725;88180;0;35.5;14.9;0.0
85;2021-05-09;1375;170;0;212100;88350;0;35.7;14.9;0.0
85;2021-05-10;3333;4759;0;215433;93109;0;36.3;15.7;0.0
85;2021-05-11;4109;4839;0;219542;97948;0;37.0;16.5;0.0
85;2021-05-12;5049;3964;0;224591;101912;0;37.8;17.2;0.0
85;2021-05-13;4539;571;0;229130;102483;0;38.6;17.3;0.0
85;2021-05-14;4191;3022;0;233321;105505;0;39.3;17.8;0.0
85;2021-05-15;2204;739;0;235525;106244;0;39.7;17.9;0.0
85;2021-05-16;1952;134;0;237477;106378;0;40.0;17.9;0.0
85;2021-05-17;4020;3280;0;241497;109658;0;40.7;18.5;0.0
85;2021-05-18;5069;2819;0;246566;112477;0;41.5;18.9;0.0
85;2021-05-19;6238;1771;0;252804;114248;0;42.6;19.2;0.0
85;2021-05-20;6405;2185;0;259209;116433;0;43.7;19.6;0.0
85;2021-05-21;5282;2770;0;264491;119203;0;44.5;20.1;0.0
85;2021-05-22;2287;728;0;266778;119931;0;44.9;20.2;0.0
85;2021-05-23;956;125;0;267734;120056;0;45.1;20.2;0.0
85;2021-05-24;3825;399;0;271559;120455;0;45.7;20.3;0.0
85;2021-05-25;4151;3540;0;275710;123995;0;46.4;20.9;0.0
85;2021-05-26;4893;2670;0;280603;126665;0;47.3;21.3;0.0
85;2021-05-27;4771;3593;0;285374;130258;0;48.1;21.9;0.0
85;2021-05-28;5144;4003;0;290518;134261;0;48.9;22.6;0.0
85;2021-05-29;3539;1499;0;294057;135760;0;49.5;22.9;0.0
85;2021-05-30;754;101;0;294811;135861;0;49.7;22.9;0.0
85;2021-05-31;4464;3384;0;299275;139245;0;50.4;23.5;0.0
85;2021-06-01;5082;3428;0;304357;142673;0;51.3;24.0;0.0
85;2021-06-02;5522;2582;0;309879;145255;0;52.2;24.5;0.0
85;2021-06-03;5868;3270;0;315747;148525;0;53.2;25.0;0.0
85;2021-06-04;5845;3844;0;321592;152369;0;54.2;25.7;0.0
85;2021-06-05;2594;1890;0;324186;154259;0;54.6;26.0;0.0
85;2021-06-06;1250;827;0;325436;155086;0;54.8;26.1;0.0
85;2021-06-07;3268;4802;0;328704;159888;0;55.4;26.9;0.0
85;2021-06-08;4030;4539;0;332734;164427;0;56.0;27.7;0.0
85;2021-06-09;5115;3593;0;337849;168020;0;56.9;28.3;0.0
85;2021-06-10;5224;3632;0;343073;171652;0;57.8;28.9;0.0
85;2021-06-11;4795;4582;0;347868;176234;0;58.6;29.7;0.0
85;2021-06-12;1654;1793;0;349522;178027;0;58.9;30.0;0.0
85;2021-06-13;762;617;0;350284;178644;0;59.0;30.1;0.0
85;2021-06-14;2648;5034;0;352932;183678;0;59.4;30.9;0.0
85;2021-06-15;3761;4985;0;356693;188663;0;60.1;31.8;0.0
85;2021-06-16;4280;3847;0;360973;192510;0;60.8;32.4;0.0
85;2021-06-17;4086;3759;0;365059;196269;0;61.5;33.1;0.0
85;2021-06-18;3731;5609;0;368790;201878;0;62.1;34.0;0.0
85;2021-06-19;1287;1938;0;370077;203816;0;62.3;34.3;0.0
85;2021-06-20;117;471;0;370194;204287;0;62.4;34.4;0.0
85;2021-06-21;2426;5757;0;372620;210044;0;62.8;35.4;0.0
85;2021-06-22;2915;5647;0;375535;215691;0;63.3;36.3;0.0
85;2021-06-23;3576;4442;0;379111;220133;0;63.9;37.1;0.0
85;2021-06-24;3818;4376;0;382929;224509;0;64.5;37.8;0.0
85;2021-06-25;2578;6106;0;385507;230615;0;64.9;38.8;0.0
85;2021-06-26;889;3593;0;386396;234208;0;65.1;39.4;0.0
85;2021-06-27;111;1284;0;386507;235492;0;65.1;39.7;0.0
85;2021-06-28;1336;6589;0;387843;242081;0;65.3;40.8;0.0
85;2021-06-29;1964;6707;0;389807;248788;0;65.7;41.9;0.0
85;2021-06-30;2389;6038;0;392196;254826;0;66.1;42.9;0.0
85;2021-07-01;3062;5795;0;395258;260621;0;66.6;43.9;0.0
85;2021-07-02;2510;6763;0;397768;267384;0;67.0;45.0;0.0
85;2021-07-03;647;3001;0;398415;270385;0;67.1;45.5;0.0
85;2021-07-04;125;977;0;398540;271362;0;67.1;45.7;0.0
85;2021-07-05;1103;6327;2;399643;277689;2;67.3;46.8;0.0
85;2021-07-06;1651;6212;0;401294;283901;2;67.6;47.8;0.0
85;2021-07-07;1685;5760;0;402979;289661;2;67.9;48.8;0.0
85;2021-07-08;2268;5343;0;405247;295004;2;68.3;49.7;0.0
85;2021-07-09;1748;6971;0;406995;301975;2;68.6;50.9;0.0
85;2021-07-10;563;2647;0;407558;304622;2;68.6;51.3;0.0
85;2021-07-11;426;896;0;407984;305518;2;68.7;51.5;0.0
85;2021-07-12;1348;6739;0;409332;312257;2;68.9;52.6;0.0
85;2021-07-13;2042;7366;0;411374;319623;2;69.3;53.8;0.0
85;2021-07-14;1301;1657;0;412675;321280;2;69.5;54.1;0.0
85;2021-07-15;2605;6813;0;415280;328093;2;69.9;55.3;0.0
85;2021-07-16;3351;6816;0;418631;334909;2;70.5;56.4;0.0
85;2021-07-17;1573;2133;0;420204;337042;2;70.8;56.8;0.0
85;2021-07-18;842;822;0;421046;337864;2;70.9;56.9;0.0
85;2021-07-19;3144;6044;0;424190;343908;2;71.4;57.9;0.0
85;2021-07-20;3775;6093;0;427965;350001;2;72.1;59.0;0.0
85;2021-07-21;3604;6064;0;431569;356065;2;72.7;60.0;0.0
85;2021-07-22;3735;6028;0;435304;362093;2;73.3;61.0;0.0
85;2021-07-23;4234;6553;0;439538;368646;2;74.0;62.1;0.0
85;2021-07-24;1410;2296;0;440948;370942;2;74.3;62.5;0.0
85;2021-07-25;441;278;0;441389;371220;2;74.3;62.5;0.0
85;2021-07-26;4105;5127;0;445494;376347;2;75.0;63.4;0.0
85;2021-07-27;4754;5332;0;450248;381679;2;75.8;64.3;0.0
85;2021-07-28;4775;4874;0;455023;386553;2;76.6;65.1;0.0
85;2021-07-29;5609;4664;0;460632;391217;2;77.6;65.9;0.0
85;2021-07-30;5665;4810;0;466297;396027;2;78.5;66.7;0.0
85;2021-07-31;1302;1572;0;467599;397599;2;78.8;67.0;0.0
85;2021-08-01;377;128;0;467976;397727;2;78.8;67.0;0.0
85;2021-08-02;4418;3616;0;472394;401343;2;79.6;67.6;0.0
85;2021-08-03;5888;3337;0;478282;404680;2;80.6;68.2;0.0
85;2021-08-04;6189;3297;1;484471;407977;3;81.6;68.7;0.0
85;2021-08-05;5780;3310;0;490251;411287;3;82.6;69.3;0.0
85;2021-08-06;5366;4139;0;495617;415426;3;83.5;70.0;0.0
85;2021-08-07;1448;1065;0;497065;416491;3;83.7;70.2;0.0
85;2021-08-08;285;176;0;497350;416667;3;83.8;70.2;0.0
85;2021-08-09;4041;2990;0;501391;419657;3;84.5;70.7;0.0
85;2021-08-10;4772;2970;0;506163;422627;3;85.3;71.2;0.0
85;2021-08-11;4570;3675;0;510733;426302;3;86.0;71.8;0.0
85;2021-08-12;4242;3564;0;514975;429866;3;86.7;72.4;0.0
85;2021-08-13;3869;3266;0;518844;433132;3;87.4;73.0;0.0
85;2021-08-14;1016;922;0;519860;434054;3;87.6;73.1;0.0
85;2021-08-15;122;178;0;519982;434232;3;87.6;73.1;0.0
85;2021-08-16;2835;4122;0;522817;438354;3;88.1;73.8;0.0
85;2021-08-17;2982;3716;0;525799;442070;3;88.6;74.5;0.0
85;2021-08-18;3130;3583;0;528929;445653;3;89.1;75.1;0.0
85;2021-08-19;2586;3756;1;531515;449409;4;89.5;75.7;0.0
85;2021-08-20;2452;4819;0;533967;454228;4;89.9;76.5;0.0
85;2021-08-21;638;1279;0;534605;455507;4;90.0;76.7;0.0
85;2021-08-22;265;734;0;534870;456241;4;90.1;76.8;0.0
85;2021-08-23;1875;4919;1;536745;461160;5;90.4;77.7;0.0
85;2021-08-24;1885;4561;1;538630;465721;6;90.7;78.4;0.0
85;2021-08-25;1669;4631;0;540299;470352;6;91.0;79.2;0.0
85;2021-08-26;1539;4542;1;541838;474894;7;91.3;80.0;0.0
85;2021-08-27;1758;5182;1;543596;480076;8;91.6;80.9;0.0
85;2021-08-28;554;1313;0;544150;481389;8;91.7;81.1;0.0
85;2021-08-29;103;731;0;544253;482120;8;91.7;81.2;0.0
85;2021-08-30;1097;4913;26;545350;487033;34;91.9;82.0;0.0
85;2021-08-31;1184;5403;73;546534;492436;107;92.1;82.9;0.0
85;2021-09-01;1187;4962;162;547721;497398;269;92.3;83.8;0.0
85;2021-09-02;974;4009;235;548695;501407;504;92.4;84.5;0.1
85;2021-09-03;1247;4267;301;549942;505674;805;92.6;85.2;0.1
85;2021-09-04;389;1422;81;550331;507096;886;92.7;85.4;0.1
85;2021-09-05;30;164;15;550361;507260;901;92.7;85.4;0.2
85;2021-09-06;841;3458;407;551202;510718;1308;92.8;86.0;0.2
85;2021-09-07;860;2973;404;552062;513691;1712;93.0;86.5;0.3
85;2021-09-08;889;3528;265;552951;517219;1977;93.1;87.1;0.3
85;2021-09-09;638;2498;412;553589;519717;2389;93.2;87.5;0.4
85;2021-09-10;798;3458;339;554387;523175;2728;93.4;88.1;0.5
85;2021-09-11;284;1354;74;554671;524529;2802;93.4;88.3;0.5
85;2021-09-12;17;45;25;554688;524574;2827;93.4;88.4;0.5
85;2021-09-13;560;2219;479;555248;526793;3306;93.5;88.7;0.6
85;2021-09-14;564;1697;789;555812;528490;4095;93.6;89.0;0.7
85;2021-09-15;630;2647;588;556442;531137;4683;93.7;89.5;0.8
85;2021-09-16;405;1370;618;556847;532507;5301;93.8;89.7;0.9
85;2021-09-17;729;2482;607;557576;534989;5908;93.9;90.1;1.0
85;2021-09-18;201;955;89;557777;535944;5997;93.9;90.3;1.0
85;2021-09-19;10;35;6;557787;535979;6003;94.0;90.3;1.0
85;2021-09-20;342;1366;631;558129;537345;6634;94.0;90.5;1.1
85;2021-09-21;428;1106;952;558557;538451;7586;94.1;90.7;1.3
85;2021-09-22;429;2014;846;558986;540465;8432;94.2;91.0;1.4
85;2021-09-23;767;1003;1018;559753;541468;9450;94.3;91.2;1.6
85;2021-09-24;602;2037;686;560355;543505;10136;94.4;91.5;1.7
85;2021-09-25;155;887;150;560510;544392;10286;94.4;91.7;1.7
85;2021-09-26;6;8;0;560516;544400;10286;94.4;91.7;1.7
85;2021-09-27;367;949;973;560883;545349;11259;94.5;91.9;1.9
85;2021-09-28;242;612;758;561125;545961;12017;94.5;92.0;2.0
85;2021-09-29;400;1325;653;561525;547286;12670;94.6;92.2;2.1
85;2021-09-30;335;770;1184;561860;548056;13854;94.6;92.3;2.3
85;2021-10-01;453;958;728;562313;549014;14582;94.7;92.5;2.5
85;2021-10-02;187;538;159;562500;549552;14741;94.7;92.6;2.5
85;2021-10-03;8;18;12;562508;549570;14753;94.7;92.6;2.5
85;2021-10-04;216;698;758;562724;550268;15511;94.8;92.7;2.6
85;2021-10-05;302;455;674;563026;550723;16185;94.8;92.8;2.7
85;2021-10-06;394;882;761;563420;551605;16946;94.9;92.9;2.9
85;2021-10-07;244;414;1063;563664;552019;18009;94.9;93.0;3.0
85;2021-10-08;366;1023;884;564030;553042;18893;95.0;93.2;3.2
85;2021-10-09;124;330;155;564154;553372;19048;95.0;93.2;3.2
85;2021-10-10;14;17;5;564168;553389;19053;95.0;93.2;3.2
85;2021-10-11;226;488;957;564394;553877;20010;95.1;93.3;3.4
85;2021-10-12;170;328;593;564564;554205;20603;95.1;93.3;3.5
85;2021-10-13;342;667;861;564906;554872;21464;95.1;93.5;3.6
85;2021-10-14;203;578;790;565109;555450;22254;95.2;93.6;3.7
85;2021-10-15;262;838;919;565371;556288;23173;95.2;93.7;3.9
85;2021-10-16;108;166;160;565479;556454;23333;95.2;93.7;3.9
85;2021-10-17;2;10;7;565481;556464;23340;95.2;93.7;3.9
85;2021-10-18;238;357;900;565719;556821;24240;95.3;93.8;4.1
85;2021-10-19;75;196;619;565794;557017;24859;95.3;93.8;4.2
85;2021-10-20;177;591;1187;565971;557608;26046;95.3;93.9;4.4
85;2021-10-21;125;358;1488;566096;557966;27534;95.4;94.0;4.6
85;2021-10-22;172;652;1301;566268;558618;28835;95.4;94.1;4.9
85;2021-10-23;44;156;186;566312;558774;29021;95.4;94.1;4.9
85;2021-10-24;1;2;1;566313;558776;29022;95.4;94.1;4.9
85;2021-10-25;166;243;1133;566479;559019;30155;95.4;94.2;5.1
85;2021-10-26;60;139;543;566539;559158;30698;95.4;94.2;5.2
85;2021-10-27;173;453;1373;566712;559611;32071;95.5;94.3;5.4
85;2021-10-28;126;186;1057;566838;559797;33128;95.5;94.3;5.6
85;2021-10-29;132;373;1578;566970;560170;34706;95.5;94.4;5.8
85;2021-10-30;31;105;241;567001;560275;34947;95.5;94.4;5.9
85;2021-10-31;0;1;0;567001;560276;34947;95.5;94.4;5.9
85;2021-11-01;1;2;4;567002;560278;34951;95.5;94.4;5.9
85;2021-11-02;120;302;1255;567122;560580;36206;95.5;94.4;6.1
85;2021-11-03;186;364;1911;567308;560944;38117;95.6;94.5;6.4
85;2021-11-04;109;222;1704;567417;561166;39821;95.6;94.5;6.7
85;2021-11-05;133;323;1812;567550;561489;41633;95.6;94.6;7.0
85;2021-11-06;34;109;444;567584;561598;42077;95.6;94.6;7.1
85;2021-11-07;2;8;19;567586;561606;42096;95.6;94.6;7.1
85;2021-11-08;103;273;1945;567689;561879;44041;95.6;94.6;7.4
85;2021-11-09;85;165;1802;567774;562044;45843;95.6;94.7;7.7
85;2021-11-10;158;259;2715;567932;562303;48558;95.7;94.7;8.2
85;2021-11-11;2;3;59;567934;562306;48617;95.7;94.7;8.2
85;2021-11-12;86;157;1791;568020;562463;50408;95.7;94.7;8.5
85;2021-11-13;24;64;471;568044;562527;50879;95.7;94.7;8.6
85;2021-11-14;2;2;10;568046;562529;50889;95.7;94.7;8.6
85;2021-11-15;76;188;2474;568122;562717;53363;95.7;94.8;9.0
85;2021-11-16;96;127;2661;568218;562844;56024;95.7;94.8;9.4
85;2021-11-17;152;261;2944;568370;563105;58968;95.7;94.8;9.9
85;2021-11-18;99;131;2708;568469;563236;61676;95.7;94.9;10.4
85;2021-11-19;123;203;3081;568592;563439;64757;95.8;94.9;10.9
85;2021-11-20;48;80;556;568640;563519;65313;95.8;94.9;11.0
85;2021-11-21;1;2;2;568641;563521;65315;95.8;94.9;11.0
85;2021-11-22;140;110;3186;568781;563631;68501;95.8;94.9;11.5
85;2021-11-23;135;81;3582;568916;563712;72083;95.8;94.9;12.1
85;2021-11-24;181;257;3143;569097;563969;75226;95.9;95.0;12.7
85;2021-11-25;130;146;3544;569227;564115;78770;95.9;95.0;13.3
85;2021-11-26;129;188;4306;569356;564303;83076;95.9;95.0;14.0
85;2021-11-27;47;83;1634;569403;564386;84710;95.9;95.1;14.3
85;2021-11-28;18;10;909;569421;564396;85619;95.9;95.1;14.4
85;2021-11-29;116;152;4710;569537;564548;90329;95.9;95.1;15.2
85;2021-11-30;147;107;5447;569684;564655;95776;96.0;95.1;16.1
85;2021-12-01;143;152;6095;569827;564807;101871;96.0;95.1;17.2
85;2021-12-02;80;63;5845;569907;564870;107716;96.0;95.1;18.1
85;2021-12-03;95;125;7182;570002;564995;114898;96.0;95.2;19.4
85;2021-12-04;40;41;2559;570042;565036;117457;96.0;95.2;19.8
85;2021-12-05;7;2;428;570049;565038;117885;96.0;95.2;19.9
85;2021-12-06;70;103;6729;570119;565141;124614;96.0;95.2;21.0
85;2021-12-07;71;99;6728;570190;565240;131342;96.0;95.2;22.1
85;2021-12-08;99;156;7372;570289;565396;138714;96.1;95.2;23.4
85;2021-12-09;77;116;7351;570366;565512;146065;96.1;95.3;24.6
85;2021-12-10;121;163;9103;570487;565675;155168;96.1;95.3;26.1
85;2021-12-11;69;56;2787;570556;565731;157955;96.1;95.3;26.6
85;2021-12-12;6;10;1040;570562;565741;158995;96.1;95.3;26.8
85;2021-12-13;85;126;9113;570647;565867;168108;96.1;95.3;28.3
85;2021-12-14;102;150;10188;570749;566017;178296;96.1;95.3;30.0
85;2021-12-15;120;214;9290;570869;566231;187586;96.2;95.4;31.6
85;2021-12-16;115;161;10542;570984;566392;198128;96.2;95.4;33.4
85;2021-12-17;121;199;10919;571105;566591;209047;96.2;95.4;35.2
85;2021-12-18;60;70;2805;571165;566661;211852;96.2;95.4;35.7
85;2021-12-19;24;22;2429;571189;566683;214281;96.2;95.4;36.1
86;2020-12-27;0;0;0;0;0;0;0.0;0.0;0.0
86;2020-12-28;0;0;0;0;0;0;0.0;0.0;0.0
86;2020-12-29;1;0;0;1;0;0;0.0;0.0;0.0
86;2020-12-30;0;0;0;1;0;0;0.0;0.0;0.0
86;2020-12-31;0;0;0;1;0;0;0.0;0.0;0.0
86;2021-01-01;1;0;0;2;0;0;0.0;0.0;0.0
86;2021-01-02;1;0;0;3;0;0;0.0;0.0;0.0
86;2021-01-03;0;0;0;3;0;0;0.0;0.0;0.0
86;2021-01-04;1;0;0;4;0;0;0.0;0.0;0.0
86;2021-01-05;3;0;0;7;0;0;0.0;0.0;0.0
86;2021-01-06;166;1;0;173;1;0;0.0;0.0;0.0
86;2021-01-07;661;0;0;834;1;0;0.2;0.0;0.0
86;2021-01-08;592;3;0;1426;4;0;0.4;0.0;0.0
86;2021-01-09;2;0;0;1428;4;0;0.4;0.0;0.0
86;2021-01-10;165;0;0;1593;4;0;0.4;0.0;0.0
86;2021-01-11;305;0;0;1898;4;0;0.5;0.0;0.0
86;2021-01-12;462;1;0;2360;5;0;0.6;0.0;0.0
86;2021-01-13;340;1;0;2700;6;0;0.7;0.0;0.0
86;2021-01-14;561;1;0;3261;7;0;0.9;0.0;0.0
86;2021-01-15;551;3;0;3812;10;0;1.0;0.0;0.0
86;2021-01-16;5;0;0;3817;10;0;1.0;0.0;0.0
86;2021-01-17;0;0;0;3817;10;0;1.0;0.0;0.0
86;2021-01-18;564;0;0;4381;10;0;1.1;0.0;0.0
86;2021-01-19;1820;2;0;6201;12;0;1.6;0.0;0.0
86;2021-01-20;1440;27;0;7641;39;0;2.0;0.0;0.0
86;2021-01-21;1263;3;0;8904;42;0;2.3;0.0;0.0
86;2021-01-22;824;2;0;9728;44;0;2.5;0.0;0.0
86;2021-01-23;295;2;0;10023;46;0;2.6;0.0;0.0
86;2021-01-24;1;0;0;10024;46;0;2.6;0.0;0.0
86;2021-01-25;588;108;0;10612;154;0;2.8;0.0;0.0
86;2021-01-26;731;120;0;11343;274;0;3.0;0.1;0.0
86;2021-01-27;761;152;0;12104;426;0;3.2;0.1;0.0
86;2021-01-28;1018;413;0;13122;839;0;3.4;0.2;0.0
86;2021-01-29;877;217;0;13999;1056;0;3.7;0.3;0.0
86;2021-01-30;259;101;0;14258;1157;0;3.7;0.3;0.0
86;2021-01-31;54;151;0;14312;1308;0;3.8;0.3;0.0
86;2021-02-01;416;213;0;14728;1521;0;3.9;0.4;0.0
86;2021-02-02;561;376;0;15289;1897;0;4.0;0.5;0.0
86;2021-02-03;521;233;0;15810;2130;0;4.1;0.6;0.0
86;2021-02-04;453;367;0;16263;2497;0;4.3;0.7;0.0
86;2021-02-05;437;725;0;16700;3222;0;4.4;0.8;0.0
86;2021-02-06;137;195;0;16837;3417;0;4.4;0.9;0.0
86;2021-02-07;103;4;0;16940;3421;0;4.4;0.9;0.0
86;2021-02-08;353;312;0;17293;3733;0;4.5;1.0;0.0
86;2021-02-09;737;1070;0;18030;4803;0;4.7;1.3;0.0
86;2021-02-10;940;903;0;18970;5706;0;5.0;1.5;0.0
86;2021-02-11;948;983;0;19918;6689;0;5.2;1.8;0.0
86;2021-02-12;698;405;0;20616;7094;0;5.4;1.9;0.0
86;2021-02-13;179;96;0;20795;7190;0;5.5;1.9;0.0
86;2021-02-14;1;32;0;20796;7222;0;5.5;1.9;0.0
86;2021-02-15;245;497;0;21041;7719;0;5.5;2.0;0.0
86;2021-02-16;372;843;0;21413;8562;0;5.6;2.2;0.0
86;2021-02-17;434;875;0;21847;9437;0;5.7;2.5;0.0
86;2021-02-18;431;894;0;22278;10331;0;5.8;2.7;0.0
86;2021-02-19;577;620;0;22855;10951;0;6.0;2.9;0.0
86;2021-02-20;110;174;0;22965;11125;0;6.0;2.9;0.0
86;2021-02-21;3;3;0;22968;11128;0;6.0;2.9;0.0
86;2021-02-22;225;432;0;23193;11560;0;6.1;3.0;0.0
86;2021-02-23;368;581;0;23561;12141;0;6.2;3.2;0.0
86;2021-02-24;394;586;0;23955;12727;0;6.3;3.3;0.0
86;2021-02-25;855;647;0;24810;13374;0;6.5;3.5;0.0
86;2021-02-26;983;553;0;25793;13927;0;6.8;3.7;0.0
86;2021-02-27;460;134;0;26253;14061;0;6.9;3.7;0.0
86;2021-02-28;7;2;0;26260;14063;0;6.9;3.7;0.0
86;2021-03-01;240;481;0;26500;14544;0;6.9;3.8;0.0
86;2021-03-02;1121;819;0;27621;15363;0;7.2;4.0;0.0
86;2021-03-03;807;627;0;28428;15990;0;7.5;4.2;0.0
86;2021-03-04;1485;583;0;29913;16573;0;7.8;4.3;0.0
86;2021-03-05;1565;322;0;31478;16895;0;8.3;4.4;0.0
86;2021-03-06;976;165;0;32454;17060;0;8.5;4.5;0.0
86;2021-03-07;342;38;0;32796;17098;0;8.6;4.5;0.0
86;2021-03-08;461;522;0;33257;17620;0;8.7;4.6;0.0
86;2021-03-09;1339;502;0;34596;18122;0;9.1;4.8;0.0
86;2021-03-10;939;609;0;35535;18731;0;9.3;4.9;0.0
86;2021-03-11;1774;476;0;37309;19207;0;9.8;5.0;0.0
86;2021-03-12;2150;414;0;39459;19621;0;10.3;5.1;0.0
86;2021-03-13;1402;91;0;40861;19712;0;10.7;5.2;0.0
86;2021-03-14;126;13;0;40987;19725;0;10.7;5.2;0.0
86;2021-03-15;743;160;0;41730;19885;0;10.9;5.2;0.0
86;2021-03-16;820;206;0;42550;20091;0;11.2;5.3;0.0
86;2021-03-17;729;214;0;43279;20305;0;11.3;5.3;0.0
86;2021-03-18;892;111;0;44171;20416;0;11.6;5.4;0.0
86;2021-03-19;2038;340;0;46209;20756;0;12.1;5.4;0.0
86;2021-03-20;605;127;0;46814;20883;0;12.3;5.5;0.0
86;2021-03-21;14;0;0;46828;20883;0;12.3;5.5;0.0
86;2021-03-22;812;272;0;47640;21155;0;12.5;5.5;0.0
86;2021-03-23;1967;333;0;49607;21488;0;13.0;5.6;0.0
86;2021-03-24;1497;340;0;51104;21828;0;13.4;5.7;0.0
86;2021-03-25;2382;365;0;53486;22193;0;14.0;5.8;0.0
86;2021-03-26;2907;366;0;56393;22559;0;14.8;5.9;0.0
86;2021-03-27;731;141;0;57124;22700;0;15.0;6.0;0.0
86;2021-03-28;8;111;0;57132;22811;0;15.0;6.0;0.0
86;2021-03-29;1159;382;0;58291;23193;0;15.3;6.1;0.0
86;2021-03-30;2304;801;0;60595;23994;0;15.9;6.3;0.0
86;2021-03-31;1446;617;0;62041;24611;0;16.3;6.5;0.0
86;2021-04-01;2156;920;0;64197;25531;0;16.8;6.7;0.0
86;2021-04-02;1883;530;0;66080;26061;0;17.3;6.8;0.0
86;2021-04-03;796;286;0;66876;26347;0;17.5;6.9;0.0
86;2021-04-04;80;96;0;66956;26443;0;17.6;6.9;0.0
86;2021-04-05;286;4;0;67242;26447;0;17.6;6.9;0.0
86;2021-04-06;1543;916;0;68785;27363;0;18.0;7.2;0.0
86;2021-04-07;1618;606;0;70403;27969;0;18.5;7.3;0.0
86;2021-04-08;2516;751;0;72919;28720;0;19.1;7.5;0.0
86;2021-04-09;3227;620;0;76146;29340;0;20.0;7.7;0.0
86;2021-04-10;1615;182;0;77761;29522;0;20.4;7.7;0.0
86;2021-04-11;425;11;0;78186;29533;0;20.5;7.7;0.0
86;2021-04-12;808;707;0;78994;30240;0;20.7;7.9;0.0
86;2021-04-13;2381;884;0;81375;31124;0;21.3;8.2;0.0
86;2021-04-14;1836;829;0;83211;31953;0;21.8;8.4;0.0
86;2021-04-15;2255;673;0;85466;32626;0;22.4;8.6;0.0
86;2021-04-16;2397;1169;0;87863;33795;0;23.0;8.9;0.0
86;2021-04-17;1045;276;0;88908;34071;0;23.3;8.9;0.0
86;2021-04-18;123;5;0;89031;34076;0;23.3;8.9;0.0
86;2021-04-19;759;744;0;89790;34820;0;23.5;9.1;0.0
86;2021-04-20;2326;1469;0;92116;36289;0;24.1;9.5;0.0
86;2021-04-21;2038;1032;0;94154;37321;0;24.7;9.8;0.0
86;2021-04-22;2252;1314;0;96406;38635;0;25.3;10.1;0.0
86;2021-04-23;2340;1461;0;98746;40096;0;25.9;10.5;0.0
86;2021-04-24;1228;514;0;99974;40610;0;26.2;10.6;0.0
86;2021-04-25;771;27;0;100745;40637;0;26.4;10.7;0.0
86;2021-04-26;1946;834;0;102691;41471;0;26.9;10.9;0.0
86;2021-04-27;2983;1621;0;105674;43092;0;27.7;11.3;0.0
86;2021-04-28;2875;1408;0;108549;44500;0;28.5;11.7;0.0
86;2021-04-29;3481;1782;0;112030;46282;0;29.4;12.1;0.0
86;2021-04-30;2935;1430;0;114965;47712;0;30.1;12.5;0.0
86;2021-05-01;1544;202;0;116509;47914;0;30.5;12.6;0.0
86;2021-05-02;1211;45;0;117720;47959;0;30.9;12.6;0.0
86;2021-05-03;2417;964;0;120137;48923;0;31.5;12.8;0.0
86;2021-05-04;3288;1858;0;123425;50781;0;32.4;13.3;0.0
86;2021-05-05;3748;1448;0;127173;52229;0;33.3;13.7;0.0
86;2021-05-06;4074;1618;0;131247;53847;0;34.4;14.1;0.0
86;2021-05-07;3984;1815;0;135231;55662;0;35.4;14.6;0.0
86;2021-05-08;1824;383;0;137055;56045;0;35.9;14.7;0.0
86;2021-05-09;1512;184;0;138567;56229;0;36.3;14.7;0.0
86;2021-05-10;1852;1143;0;140419;57372;0;36.8;15.0;0.0
86;2021-05-11;3262;2593;0;143681;59965;0;37.7;15.7;0.0
86;2021-05-12;2140;1633;0;145821;61598;0;38.2;16.1;0.0
86;2021-05-13;1477;278;0;147298;61876;0;38.6;16.2;0.0
86;2021-05-14;1933;795;0;149231;62671;0;39.1;16.4;0.0
86;2021-05-15;1366;459;0;150597;63130;0;39.5;16.5;0.0
86;2021-05-16;734;148;0;151331;63278;0;39.7;16.6;0.0
86;2021-05-17;3005;1028;0;154336;64306;0;40.5;16.9;0.0
86;2021-05-18;3994;1595;0;158330;65901;0;41.5;17.3;0.0
86;2021-05-19;3320;1362;0;161650;67263;0;42.4;17.6;0.0
86;2021-05-20;3927;1567;0;165577;68830;0;43.4;18.0;0.0
86;2021-05-21;3225;1702;0;168802;70532;0;44.2;18.5;0.0
86;2021-05-22;1884;665;0;170686;71197;0;44.7;18.7;0.0
86;2021-05-23;1266;167;0;171952;71364;0;45.1;18.7;0.0
86;2021-05-24;1629;199;0;173581;71563;0;45.5;18.8;0.0
86;2021-05-25;2557;1547;0;176138;73110;0;46.2;19.2;0.0
86;2021-05-26;2540;1452;0;178678;74562;0;46.8;19.5;0.0
86;2021-05-27;3158;1772;0;181836;76334;0;47.7;20.0;0.0
86;2021-05-28;2128;2494;0;183964;78828;0;48.2;20.7;0.0
86;2021-05-29;1397;1252;0;185361;80080;0;48.6;21.0;0.0
86;2021-05-30;862;126;0;186223;80206;0;48.8;21.0;0.0
86;2021-05-31;1818;1738;0;188041;81944;0;49.3;21.5;0.0
86;2021-06-01;2450;2572;0;190491;84516;0;49.9;22.2;0.0
86;2021-06-02;2208;2534;0;192699;87050;0;50.5;22.8;0.0
86;2021-06-03;2976;2370;0;195675;89420;0;51.3;23.4;0.0
86;2021-06-04;2219;2810;0;197894;92230;0;51.9;24.2;0.0
86;2021-06-05;1466;1526;0;199360;93756;0;52.3;24.6;0.0
86;2021-06-06;788;870;0;200148;94626;0;52.5;24.8;0.0
86;2021-06-07;1180;2300;0;201328;96926;0;52.8;25.4;0.0
86;2021-06-08;1905;3537;0;203233;100463;0;53.3;26.3;0.0
86;2021-06-09;1874;3157;0;205107;103620;0;53.8;27.2;0.0
86;2021-06-10;2311;3116;0;207418;106736;0;54.4;28.0;0.0
86;2021-06-11;1617;2771;0;209035;109507;0;54.8;28.7;0.0
86;2021-06-12;898;2149;0;209933;111656;0;55.0;29.3;0.0
86;2021-06-13;281;1405;0;210214;113061;0;55.1;29.6;0.0
86;2021-06-14;1202;2783;0;211416;115844;0;55.4;30.4;0.0
86;2021-06-15;1724;3986;0;213140;119830;0;55.9;31.4;0.0
86;2021-06-16;1785;3065;0;214925;122895;0;56.3;32.2;0.0
86;2021-06-17;1844;4319;0;216769;127214;0;56.8;33.3;0.0
86;2021-06-18;1959;4476;0;218728;131690;0;57.3;34.5;0.0
86;2021-06-19;725;1985;0;219453;133675;0;57.5;35.0;0.0
86;2021-06-20;185;1235;0;219638;134910;0;57.6;35.4;0.0
86;2021-06-21;1197;2100;0;220835;137010;0;57.9;35.9;0.0
86;2021-06-22;1357;3256;0;222192;140266;0;58.2;36.8;0.0
86;2021-06-23;1478;2345;0;223670;142611;0;58.6;37.4;0.0
86;2021-06-24;1705;2666;0;225375;145277;0;59.1;38.1;0.0
86;2021-06-25;1310;3420;0;226685;148697;0;59.4;39.0;0.0
86;2021-06-26;474;2496;0;227159;151193;0;59.5;39.6;0.0
86;2021-06-27;141;1524;0;227300;152717;0;59.6;40.0;0.0
86;2021-06-28;437;3170;0;227737;155887;0;59.7;40.9;0.0
86;2021-06-29;980;4272;0;228717;160159;0;60.0;42.0;0.0
86;2021-06-30;1116;2864;0;229833;163023;0;60.2;42.7;0.0
86;2021-07-01;1539;2972;0;231372;165995;0;60.6;43.5;0.0
86;2021-07-02;1201;3584;0;232573;169579;0;61.0;44.5;0.0
86;2021-07-03;560;2268;0;233133;171847;0;61.1;45.0;0.0
86;2021-07-04;118;1241;0;233251;173088;0;61.1;45.4;0.0
86;2021-07-05;594;2725;0;233845;175813;0;61.3;46.1;0.0
86;2021-07-06;1038;3881;0;234883;179694;0;61.6;47.1;0.0
86;2021-07-07;1290;2555;0;236173;182249;0;61.9;47.8;0.0
86;2021-07-08;1636;3010;0;237809;185259;0;62.3;48.6;0.0
86;2021-07-09;1674;3060;0;239483;188319;0;62.8;49.4;0.0
86;2021-07-10;1165;1879;0;240648;190198;0;63.1;49.9;0.0
86;2021-07-11;476;807;0;241124;191005;0;63.2;50.1;0.0
86;2021-07-12;858;2406;0;241982;193411;0;63.4;50.7;0.0
86;2021-07-13;1755;3208;0;243737;196619;0;63.9;51.5;0.0
86;2021-07-14;796;1141;0;244533;197760;0;64.1;51.8;0.0
86;2021-07-15;1928;3188;0;246461;200948;0;64.6;52.7;0.0
86;2021-07-16;1734;2711;0;248195;203659;0;65.1;53.4;0.0
86;2021-07-17;1340;1653;0;249535;205312;0;65.4;53.8;0.0
86;2021-07-18;418;886;0;249953;206198;0;65.5;54.0;0.0
86;2021-07-19;1415;1973;0;251368;208171;0;65.9;54.6;0.0
86;2021-07-20;2357;2787;0;253725;210958;0;66.5;55.3;0.0
86;2021-07-21;2316;2268;0;256041;213226;0;67.1;55.9;0.0
86;2021-07-22;2720;2822;0;258761;216048;0;67.8;56.6;0.0
86;2021-07-23;2438;2447;0;261199;218495;0;68.5;57.3;0.0
86;2021-07-24;1529;1356;0;262728;219851;0;68.9;57.6;0.0
86;2021-07-25;730;393;0;263458;220244;0;69.1;57.7;0.0
86;2021-07-26;1669;2208;0;265127;222452;0;69.5;58.3;0.0
86;2021-07-27;3246;2777;0;268373;225229;0;70.3;59.0;0.0
86;2021-07-28;3159;2202;0;271532;227431;0;71.2;59.6;0.0
86;2021-07-29;3186;2550;0;274718;229981;0;72.0;60.3;0.0
86;2021-07-30;2265;2465;0;276983;232446;0;72.6;60.9;0.0
86;2021-07-31;1402;1105;0;278385;233551;0;73.0;61.2;0.0
86;2021-08-01;669;344;0;279054;233895;0;73.1;61.3;0.0
86;2021-08-02;1908;1678;0;280962;235573;0;73.6;61.7;0.0
86;2021-08-03;3067;2021;0;284029;237594;0;74.5;62.3;0.0
86;2021-08-04;2599;1736;0;286628;239330;0;75.1;62.7;0.0
86;2021-08-05;3181;2011;0;289809;241341;0;76.0;63.3;0.0
86;2021-08-06;2416;1804;0;292225;243145;0;76.6;63.7;0.0
86;2021-08-07;1509;1030;0;293734;244175;0;77.0;64.0;0.0
86;2021-08-08;834;524;0;294568;244699;0;77.2;64.1;0.0
86;2021-08-09;1841;1354;0;296409;246053;0;77.7;64.5;0.0
86;2021-08-10;2504;1847;0;298913;247900;0;78.4;65.0;0.0
86;2021-08-11;2222;1460;0;301135;249360;0;78.9;65.4;0.0
86;2021-08-12;2208;1839;0;303343;251199;0;79.5;65.8;0.0
86;2021-08-13;1794;1535;0;305137;252734;0;80.0;66.2;0.0
86;2021-08-14;1244;1114;0;306381;253848;0;80.3;66.5;0.0
86;2021-08-15;501;589;0;306882;254437;0;80.4;66.7;0.0
86;2021-08-16;1120;1869;0;308002;256306;0;80.7;67.2;0.0
86;2021-08-17;1507;2168;0;309509;258474;0;81.1;67.8;0.0
86;2021-08-18;1267;1861;0;310776;260335;0;81.5;68.2;0.0
86;2021-08-19;1412;2579;0;312188;262914;0;81.8;68.9;0.0
86;2021-08-20;1236;2635;0;313424;265549;0;82.2;69.6;0.0
86;2021-08-21;794;1856;0;314218;267405;0;82.4;70.1;0.0
86;2021-08-22;319;693;0;314537;268098;0;82.4;70.3;0.0
86;2021-08-23;754;1839;0;315291;269937;0;82.6;70.8;0.0
86;2021-08-24;1049;2668;0;316340;272605;0;82.9;71.5;0.0
86;2021-08-25;887;1972;0;317227;274577;0;83.2;72.0;0.0
86;2021-08-26;871;2644;0;318098;277221;0;83.4;72.7;0.0
86;2021-08-27;846;2208;0;318944;279429;0;83.6;73.2;0.0
86;2021-08-28;504;1671;0;319448;281100;0;83.7;73.7;0.0
86;2021-08-29;109;789;0;319557;281889;0;83.8;73.9;0.0
86;2021-08-30;653;2033;25;320210;283922;25;83.9;74.4;0.0
86;2021-08-31;918;2957;50;321128;286879;75;84.2;75.2;0.0
86;2021-09-01;584;2463;176;321712;289342;251;84.3;75.8;0.1
86;2021-09-02;707;2328;213;322419;291670;464;84.5;76.5;0.1
86;2021-09-03;718;2193;168;323137;293863;632;84.7;77.0;0.2
86;2021-09-04;348;2003;88;323485;295866;720;84.8;77.6;0.2
86;2021-09-05;32;835;11;323517;296701;731;84.8;77.8;0.2
86;2021-09-06;354;1495;176;323871;298196;907;84.9;78.2;0.2
86;2021-09-07;471;1851;220;324342;300047;1127;85.0;78.6;0.3
86;2021-09-08;542;1992;298;324884;302039;1425;85.2;79.2;0.4
86;2021-09-09;483;1618;240;325367;303657;1665;85.3;79.6;0.4
86;2021-09-10;495;1736;318;325862;305393;1983;85.4;80.0;0.5
86;2021-09-11;337;1713;55;326199;307106;2038;85.5;80.5;0.5
86;2021-09-12;93;693;57;326292;307799;2095;85.5;80.7;0.5
86;2021-09-13;328;978;520;326620;308777;2615;85.6;80.9;0.7
86;2021-09-14;380;1310;661;327000;310087;3276;85.7;81.3;0.9
86;2021-09-15;460;1470;298;327460;311557;3574;85.8;81.7;0.9
86;2021-09-16;395;954;828;327855;312511;4402;85.9;81.9;1.2
86;2021-09-17;454;1050;540;328309;313561;4942;86.1;82.2;1.3
86;2021-09-18;290;1148;119;328599;314709;5061;86.1;82.5;1.3
86;2021-09-19;70;388;17;328669;315097;5078;86.2;82.6;1.3
86;2021-09-20;216;605;341;328885;315702;5419;86.2;82.8;1.4
86;2021-09-21;260;836;518;329145;316538;5937;86.3;83.0;1.6
86;2021-09-22;301;1137;426;329446;317675;6363;86.4;83.3;1.7
86;2021-09-23;348;585;730;329794;318260;7093;86.4;83.4;1.9
86;2021-09-24;312;832;341;330106;319092;7434;86.5;83.6;1.9
86;2021-09-25;266;924;136;330372;320016;7570;86.6;83.9;2.0
86;2021-09-26;36;156;16;330408;320172;7586;86.6;83.9;2.0
86;2021-09-27;154;333;361;330562;320505;7947;86.6;84.0;2.1
86;2021-09-28;238;340;527;330800;320845;8474;86.7;84.1;2.2
86;2021-09-29;221;644;517;331021;321489;8991;86.8;84.3;2.4
86;2021-09-30;236;433;674;331257;321922;9665;86.8;84.4;2.5
86;2021-10-01;278;520;475;331535;322442;10140;86.9;84.5;2.7
86;2021-10-02;271;523;203;331806;322965;10343;87.0;84.7;2.7
86;2021-10-03;18;63;4;331824;323028;10347;87.0;84.7;2.7
86;2021-10-04;110;294;397;331934;323322;10744;87.0;84.7;2.8
86;2021-10-05;141;281;476;332075;323603;11220;87.0;84.8;2.9
86;2021-10-06;186;457;336;332261;324060;11556;87.1;84.9;3.0
86;2021-10-07;161;406;761;332422;324466;12317;87.1;85.0;3.2
86;2021-10-08;213;465;484;332635;324931;12801;87.2;85.2;3.4
86;2021-10-09;212;417;203;332847;325348;13004;87.2;85.3;3.4
86;2021-10-10;7;14;7;332854;325362;13011;87.2;85.3;3.4
86;2021-10-11;145;293;428;332999;325655;13439;87.3;85.4;3.5
86;2021-10-12;121;305;684;333120;325960;14123;87.3;85.4;3.7
86;2021-10-13;198;348;636;333318;326308;14759;87.4;85.5;3.9
86;2021-10-14;139;324;798;333457;326632;15557;87.4;85.6;4.1
86;2021-10-15;186;323;689;333643;326955;16246;87.5;85.7;4.3
86;2021-10-16;200;314;207;333843;327269;16453;87.5;85.8;4.3
86;2021-10-17;4;5;0;333847;327274;16453;87.5;85.8;4.3
86;2021-10-18;147;294;530;333994;327568;16983;87.5;85.9;4.5
86;2021-10-19;113;271;796;334107;327839;17779;87.6;85.9;4.7
86;2021-10-20;205;326;696;334312;328165;18475;87.6;86.0;4.8
86;2021-10-21;140;322;591;334452;328487;19066;87.7;86.1;5.0
86;2021-10-22;170;220;637;334622;328707;19703;87.7;86.2;5.2
86;2021-10-23;190;332;318;334812;329039;20021;87.8;86.2;5.2
86;2021-10-24;1;3;2;334813;329042;20023;87.8;86.2;5.2
86;2021-10-25;69;152;628;334882;329194;20651;87.8;86.3;5.4
86;2021-10-26;102;112;638;334984;329306;21289;87.8;86.3;5.6
86;2021-10-27;206;277;680;335190;329583;21969;87.9;86.4;5.8
86;2021-10-28;78;141;531;335268;329724;22500;87.9;86.4;5.9
86;2021-10-29;109;159;697;335377;329883;23197;87.9;86.5;6.1
86;2021-10-30;141;197;372;335518;330080;23569;87.9;86.5;6.2
86;2021-10-31;0;5;5;335518;330085;23574;87.9;86.5;6.2
86;2021-11-01;12;2;21;335530;330087;23595;87.9;86.5;6.2
86;2021-11-02;68;135;793;335598;330222;24388;88.0;86.6;6.4
86;2021-11-03;158;274;1030;335756;330496;25418;88.0;86.6;6.7
86;2021-11-04;100;134;766;335856;330630;26184;88.0;86.7;6.9
86;2021-11-05;137;178;775;335993;330808;26959;88.1;86.7;7.1
86;2021-11-06;143;235;629;336136;331043;27588;88.1;86.8;7.2
86;2021-11-07;2;6;5;336138;331049;27593;88.1;86.8;7.2
86;2021-11-08;74;99;744;336212;331148;28337;88.1;86.8;7.4
86;2021-11-09;100;140;1385;336312;331288;29722;88.2;86.8;7.8
86;2021-11-10;143;302;1538;336455;331590;31260;88.2;86.9;8.2
86;2021-11-11;12;9;71;336467;331599;31331;88.2;86.9;8.2
86;2021-11-12;84;146;922;336551;331745;32253;88.2;87.0;8.5
86;2021-11-13;88;216;881;336639;331961;33134;88.2;87.0;8.7
86;2021-11-14;2;2;21;336641;331963;33155;88.2;87.0;8.7
86;2021-11-15;65;69;872;336706;332032;34027;88.3;87.0;8.9
86;2021-11-16;101;132;1543;336807;332164;35570;88.3;87.1;9.3
86;2021-11-17;132;222;1657;336939;332386;37227;88.3;87.1;9.8
86;2021-11-18;122;113;1557;337061;332499;38784;88.4;87.2;10.2
86;2021-11-19;138;142;1558;337199;332641;40342;88.4;87.2;10.6
86;2021-11-20;100;180;974;337299;332821;41316;88.4;87.2;10.8
86;2021-11-21;2;4;18;337301;332825;41334;88.4;87.2;10.8
86;2021-11-22;79;42;914;337380;332867;42248;88.4;87.3;11.1
86;2021-11-23;135;110;1617;337515;332977;43865;88.5;87.3;11.5
86;2021-11-24;126;169;1614;337641;333146;45479;88.5;87.3;11.9
86;2021-11-25;176;106;2069;337817;333252;47548;88.5;87.4;12.5
86;2021-11-26;145;142;1847;337962;333394;49395;88.6;87.4;12.9
86;2021-11-27;87;134;1107;338049;333528;50502;88.6;87.4;13.2
86;2021-11-28;3;9;69;338052;333537;50571;88.6;87.4;13.3
86;2021-11-29;80;70;2101;338132;333607;52672;88.6;87.4;13.8
86;2021-11-30;145;125;3906;338277;333732;56578;88.7;87.5;14.8
86;2021-12-01;87;103;3011;338364;333835;59589;88.7;87.5;15.6
86;2021-12-02;121;102;4426;338485;333937;64015;88.7;87.5;16.8
86;2021-12-03;92;118;3719;338577;334055;67734;88.7;87.6;17.8
86;2021-12-04;66;93;2293;338643;334148;70027;88.8;87.6;18.4
86;2021-12-05;10;17;732;338653;334165;70759;88.8;87.6;18.5
86;2021-12-06;48;72;2735;338701;334237;73494;88.8;87.6;19.3
86;2021-12-07;116;105;5183;338817;334342;78677;88.8;87.6;20.6
86;2021-12-08;84;131;4998;338901;334473;83675;88.8;87.7;21.9
86;2021-12-09;106;149;5874;339007;334622;89549;88.9;87.7;23.5
86;2021-12-10;132;157;5110;339139;334779;94659;88.9;87.8;24.8
86;2021-12-11;78;90;3204;339217;334869;97863;88.9;87.8;25.7
86;2021-12-12;22;22;720;339239;334891;98583;88.9;87.8;25.8
86;2021-12-13;71;86;3867;339310;334977;102450;88.9;87.8;26.9
86;2021-12-14;141;186;6455;339451;335163;108905;89.0;87.9;28.5
86;2021-12-15;116;145;4997;339567;335308;113902;89.0;87.9;29.9
86;2021-12-16;142;238;7281;339709;335546;121183;89.0;88.0;31.8
86;2021-12-17;156;164;6745;339865;335710;127928;89.1;88.0;33.5
86;2021-12-18;114;134;3978;339979;335844;131906;89.1;88.0;34.6
86;2021-12-19;37;23;1576;340016;335867;133482;89.1;88.0;35.0
87;2020-12-27;0;0;0;0;0;0;0.0;0.0;0.0
87;2020-12-28;1;0;0;1;0;0;0.0;0.0;0.0
87;2020-12-29;0;0;0;1;0;0;0.0;0.0;0.0
87;2020-12-30;1;0;0;2;0;0;0.0;0.0;0.0
87;2020-12-31;0;0;0;2;0;0;0.0;0.0;0.0
87;2021-01-01;0;0;0;2;0;0;0.0;0.0;0.0
87;2021-01-02;0;0;0;2;0;0;0.0;0.0;0.0
87;2021-01-03;0;0;0;2;0;0;0.0;0.0;0.0
87;2021-01-04;1;0;0;3;0;0;0.0;0.0;0.0
87;2021-01-05;2;0;0;5;0;0;0.0;0.0;0.0
87;2021-01-06;22;0;0;27;0;0;0.0;0.0;0.0
87;2021-01-07;253;0;0;280;0;0;0.1;0.0;0.0
87;2021-01-08;347;0;0;627;0;0;0.2;0.0;0.0
87;2021-01-09;64;0;0;691;0;0;0.2;0.0;0.0
87;2021-01-10;33;0;0;724;0;0;0.2;0.0;0.0
87;2021-01-11;397;0;0;1121;0;0;0.3;0.0;0.0
87;2021-01-12;616;0;0;1737;0;0;0.5;0.0;0.0
87;2021-01-13;506;1;0;2243;1;0;0.7;0.0;0.0
87;2021-01-14;435;3;0;2678;4;0;0.8;0.0;0.0
87;2021-01-15;507;3;0;3185;7;0;1.0;0.0;0.0
87;2021-01-16;208;1;0;3393;8;0;1.0;0.0;0.0
87;2021-01-17;5;0;0;3398;8;0;1.0;0.0;0.0
87;2021-01-18;605;5;0;4003;13;0;1.2;0.0;0.0
87;2021-01-19;689;2;0;4692;15;0;1.4;0.0;0.0
87;2021-01-20;701;4;0;5393;19;0;1.7;0.0;0.0
87;2021-01-21;759;2;0;6152;21;0;1.9;0.0;0.0
87;2021-01-22;734;5;0;6886;26;0;2.1;0.0;0.0
87;2021-01-23;308;2;0;7194;28;0;2.2;0.0;0.0
87;2021-01-24;0;0;0;7194;28;0;2.2;0.0;0.0
87;2021-01-25;619;9;0;7813;37;0;2.4;0.0;0.0
87;2021-01-26;618;55;0;8431;92;0;2.6;0.0;0.0
87;2021-01-27;581;50;0;9012;142;0;2.8;0.0;0.0
87;2021-01-28;869;122;0;9881;264;0;3.0;0.1;0.0
87;2021-01-29;727;205;0;10608;469;0;3.2;0.1;0.0
87;2021-01-30;321;73;0;10929;542;0;3.3;0.2;0.0
87;2021-01-31;31;65;0;10960;607;0;3.4;0.2;0.0
87;2021-02-01;395;297;0;11355;904;0;3.5;0.3;0.0
87;2021-02-02;431;460;0;11786;1364;0;3.6;0.4;0.0
87;2021-02-03;619;338;0;12405;1702;0;3.8;0.5;0.0
87;2021-02-04;547;547;0;12952;2249;0;4.0;0.7;0.0
87;2021-02-05;340;343;0;13292;2592;0;4.1;0.8;0.0
87;2021-02-06;56;156;0;13348;2748;0;4.1;0.8;0.0
87;2021-02-07;20;0;0;13368;2748;0;4.1;0.8;0.0
87;2021-02-08;244;409;0;13612;3157;0;4.2;1.0;0.0
87;2021-02-09;262;466;0;13874;3623;0;4.3;1.1;0.0
87;2021-02-10;267;623;0;14141;4246;0;4.3;1.3;0.0
87;2021-02-11;307;539;0;14448;4785;0;4.4;1.5;0.0
87;2021-02-12;281;558;0;14729;5343;0;4.5;1.6;0.0
87;2021-02-13;30;176;0;14759;5519;0;4.5;1.7;0.0
87;2021-02-14;1;4;0;14760;5523;0;4.5;1.7;0.0
87;2021-02-15;241;392;0;15001;5915;0;4.6;1.8;0.0
87;2021-02-16;326;301;0;15327;6216;0;4.7;1.9;0.0
87;2021-02-17;319;397;0;15646;6613;0;4.8;2.0;0.0
87;2021-02-18;470;634;0;16116;7247;0;4.9;2.2;0.0
87;2021-02-19;407;485;0;16523;7732;0;5.1;2.4;0.0
87;2021-02-20;117;196;0;16640;7928;0;5.1;2.4;0.0
87;2021-02-21;5;8;0;16645;7936;0;5.1;2.4;0.0
87;2021-02-22;424;578;0;17069;8514;0;5.2;2.6;0.0
87;2021-02-23;563;645;0;17632;9159;0;5.4;2.8;0.0
87;2021-02-24;514;707;0;18146;9866;0;5.6;3.0;0.0
87;2021-02-25;783;723;0;18929;10589;0;5.8;3.2;0.0
87;2021-02-26;852;503;0;19781;11092;0;6.1;3.4;0.0
87;2021-02-27;406;213;0;20187;11305;0;6.2;3.5;0.0
87;2021-02-28;5;1;0;20192;11306;0;6.2;3.5;0.0
87;2021-03-01;499;366;0;20691;11672;0;6.3;3.6;0.0
87;2021-03-02;971;389;0;21662;12061;0;6.6;3.7;0.0
87;2021-03-03;1125;364;0;22787;12425;0;7.0;3.8;0.0
87;2021-03-04;1399;350;0;24186;12775;0;7.4;3.9;0.0
87;2021-03-05;1762;299;0;25948;13074;0;7.9;4.0;0.0
87;2021-03-06;1003;53;0;26951;13127;0;8.3;4.0;0.0
87;2021-03-07;271;8;0;27222;13135;0;8.3;4.0;0.0
87;2021-03-08;812;240;0;28034;13375;0;8.6;4.1;0.0
87;2021-03-09;1270;243;0;29304;13618;0;9.0;4.2;0.0
87;2021-03-10;1286;224;0;30590;13842;0;9.4;4.2;0.0
87;2021-03-11;1726;259;0;32316;14101;0;9.9;4.3;0.0
87;2021-03-12;2080;292;0;34396;14393;0;10.5;4.4;0.0
87;2021-03-13;1307;27;0;35703;14420;0;10.9;4.4;0.0
87;2021-03-14;94;1;0;35797;14421;0;11.0;4.4;0.0
87;2021-03-15;957;341;0;36754;14762;0;11.3;4.5;0.0
87;2021-03-16;1039;233;0;37793;14995;0;11.6;4.6;0.0
87;2021-03-17;1076;246;0;38869;15241;0;11.9;4.7;0.0
87;2021-03-18;1184;350;0;40053;15591;0;12.3;4.8;0.0
87;2021-03-19;1613;301;0;41666;15892;0;12.8;4.9;0.0
87;2021-03-20;986;91;0;42652;15983;0;13.1;4.9;0.0
87;2021-03-21;35;0;0;42687;15983;0;13.1;4.9;0.0
87;2021-03-22;1003;390;0;43690;16373;0;13.4;5.0;0.0
87;2021-03-23;1340;408;0;45030;16781;0;13.8;5.1;0.0
87;2021-03-24;1483;388;0;46513;17169;0;14.2;5.3;0.0
87;2021-03-25;2400;391;0;48913;17560;0;15.0;5.4;0.0
87;2021-03-26;2456;410;0;51369;17970;0;15.7;5.5;0.0
87;2021-03-27;876;131;0;52245;18101;0;16.0;5.5;0.0
87;2021-03-28;260;17;0;52505;18118;0;16.1;5.6;0.0
87;2021-03-29;1098;406;0;53603;18524;0;16.4;5.7;0.0
87;2021-03-30;1876;646;0;55479;19170;0;17.0;5.9;0.0
87;2021-03-31;1663;683;0;57142;19853;0;17.5;6.1;0.0
87;2021-04-01;2254;577;0;59396;20430;0;18.2;6.3;0.0
87;2021-04-02;1844;597;0;61240;21027;0;18.8;6.4;0.0
87;2021-04-03;494;256;0;61734;21283;0;18.9;6.5;0.0
87;2021-04-04;5;1;0;61739;21284;0;18.9;6.5;0.0
87;2021-04-05;96;4;0;61835;21288;0;18.9;6.5;0.0
87;2021-04-06;1034;911;0;62869;22199;0;19.3;6.8;0.0
87;2021-04-07;1552;929;0;64421;23128;0;19.7;7.1;0.0
87;2021-04-08;1749;1021;0;66170;24149;0;20.3;7.4;0.0
87;2021-04-09;2651;737;0;68821;24886;0;21.1;7.6;0.0
87;2021-04-10;1226;312;0;70047;25198;0;21.5;7.7;0.0
87;2021-04-11;102;7;0;70149;25205;0;21.5;7.7;0.0
87;2021-04-12;1652;815;0;71801;26020;0;22.0;8.0;0.0
87;2021-04-13;2254;1027;0;74055;27047;0;22.7;8.3;0.0
87;2021-04-14;2509;1197;0;76564;28244;0;23.5;8.7;0.0
87;2021-04-15;2213;1050;0;78777;29294;0;24.1;9.0;0.0
87;2021-04-16;2670;1041;0;81447;30335;0;24.9;9.3;0.0
87;2021-04-17;824;447;0;82271;30782;0;25.2;9.4;0.0
87;2021-04-18;137;146;0;82408;30928;0;25.2;9.5;0.0
87;2021-04-19;1686;820;0;84094;31748;0;25.8;9.7;0.0
87;2021-04-20;2068;890;0;86162;32638;0;26.4;10.0;0.0
87;2021-04-21;2235;971;0;88397;33609;0;27.1;10.3;0.0
87;2021-04-22;2549;1151;0;90946;34760;0;27.9;10.6;0.0
87;2021-04-23;2004;1186;0;92950;35946;0;28.5;11.0;0.0
87;2021-04-24;1031;613;0;93981;36559;0;28.8;11.2;0.0
87;2021-04-25;108;106;0;94089;36665;0;28.8;11.2;0.0
87;2021-04-26;1318;883;0;95407;37548;0;29.2;11.5;0.0
87;2021-04-27;2301;1206;0;97708;38754;0;29.9;11.9;0.0
87;2021-04-28;3720;1445;0;101428;40199;0;31.1;12.3;0.0
87;2021-04-29;2971;1838;0;104399;42037;0;32.0;12.9;0.0
87;2021-04-30;3075;1393;0;107474;43430;0;32.9;13.3;0.0
87;2021-05-01;756;65;0;108230;43495;0;33.2;13.3;0.0
87;2021-05-02;389;17;0;108619;43512;0;33.3;13.3;0.0
87;2021-05-03;2122;957;0;110741;44469;0;33.9;13.6;0.0
87;2021-05-04;2730;1128;0;113471;45597;0;34.8;14.0;0.0
87;2021-05-05;2815;1553;0;116286;47150;0;35.6;14.4;0.0
87;2021-05-06;2534;1740;0;118820;48890;0;36.4;15.0;0.0
87;2021-05-07;2864;1748;0;121684;50638;0;37.3;15.5;0.0
87;2021-05-08;826;321;0;122510;50959;0;37.5;15.6;0.0
87;2021-05-09;57;157;0;122567;51116;0;37.5;15.7;0.0
87;2021-05-10;1802;1576;0;124369;52692;0;38.1;16.1;0.0
87;2021-05-11;2381;1915;0;126750;54607;0;38.8;16.7;0.0
87;2021-05-12;2676;2047;0;129426;56654;0;39.6;17.4;0.0
87;2021-05-13;1131;293;0;130557;56947;0;40.0;17.4;0.0
87;2021-05-14;2230;1717;0;132787;58664;0;40.7;18.0;0.0
87;2021-05-15;1099;489;0;133886;59153;0;41.0;18.1;0.0
87;2021-05-16;201;81;0;134087;59234;0;41.1;18.1;0.0
87;2021-05-17;1623;1649;0;135710;60883;0;41.6;18.7;0.0
87;2021-05-18;2709;1796;0;138419;62679;0;42.4;19.2;0.0
87;2021-05-19;2900;1546;0;141319;64225;0;43.3;19.7;0.0
87;2021-05-20;3334;1720;0;144653;65945;0;44.3;20.2;0.0
87;2021-05-21;2811;1799;0;147464;67744;0;45.2;20.8;0.0
87;2021-05-22;1548;641;0;149012;68385;0;45.6;20.9;0.0
87;2021-05-23;251;91;0;149263;68476;0;45.7;21.0;0.0
87;2021-05-24;1101;148;0;150364;68624;0;46.1;21.0;0.0
87;2021-05-25;2154;1778;0;152518;70402;0;46.7;21.6;0.0
87;2021-05-26;3248;2435;0;155766;72837;0;47.7;22.3;0.0
87;2021-05-27;2970;2315;0;158736;75152;0;48.6;23.0;0.0
87;2021-05-28;2650;2512;0;161386;77664;0;49.4;23.8;0.0
87;2021-05-29;1167;1369;0;162553;79033;0;49.8;24.2;0.0
87;2021-05-30;285;85;0;162838;79118;0;49.9;24.2;0.0
87;2021-05-31;2315;1370;0;165153;80488;0;50.6;24.7;0.0
87;2021-06-01;2543;1909;0;167696;82397;0;51.4;25.2;0.0
87;2021-06-02;2573;1858;0;170269;84255;0;52.2;25.8;0.0
87;2021-06-03;3149;2468;0;173418;86723;0;53.1;26.6;0.0
87;2021-06-04;2833;2034;0;176251;88757;0;54.0;27.2;0.0
87;2021-06-05;1403;663;0;177654;89420;0;54.4;27.4;0.0
87;2021-06-06;266;110;0;177920;89530;0;54.5;27.4;0.0
87;2021-06-07;2033;1836;0;179953;91366;0;55.1;28.0;0.0
87;2021-06-08;2842;2473;0;182795;93839;0;56.0;28.7;0.0
87;2021-06-09;2242;2665;0;185037;96504;0;56.7;29.6;0.0
87;2021-06-10;2784;2488;0;187821;98992;0;57.5;30.3;0.0
87;2021-06-11;2305;2945;0;190126;101937;0;58.2;31.2;0.0
87;2021-06-12;1224;1134;0;191350;103071;0;58.6;31.6;0.0
87;2021-06-13;296;497;0;191646;103568;0;58.7;31.7;0.0
87;2021-06-14;990;2595;0;192636;106163;0;59.0;32.5;0.0
87;2021-06-15;1335;3221;0;193971;109384;0;59.4;33.5;0.0
87;2021-06-16;1643;3292;0;195614;112676;0;59.9;34.5;0.0
87;2021-06-17;2340;2269;0;197954;114945;0;60.6;35.2;0.0
87;2021-06-18;1707;2937;0;199661;117882;0;61.2;36.1;0.0
87;2021-06-19;1040;1219;0;200701;119101;0;61.5;36.5;0.0
87;2021-06-20;219;204;0;200920;119305;0;61.5;36.5;0.0
87;2021-06-21;949;2511;0;201869;121816;0;61.8;37.3;0.0
87;2021-06-22;1001;2828;0;202870;124644;0;62.1;38.2;0.0
87;2021-06-23;1197;3091;0;204067;127735;0;62.5;39.1;0.0
87;2021-06-24;1540;2553;0;205607;130288;0;63.0;39.9;0.0
87;2021-06-25;1345;2706;0;206952;132994;0;63.4;40.7;0.0
87;2021-06-26;546;1300;0;207498;134294;0;63.6;41.1;0.0
87;2021-06-27;34;264;0;207532;134558;0;63.6;41.2;0.0
87;2021-06-28;683;2596;0;208215;137154;0;63.8;42.0;0.0
87;2021-06-29;1086;3434;0;209301;140588;0;64.1;43.1;0.0
87;2021-06-30;1057;2737;0;210358;143325;0;64.4;43.9;0.0
87;2021-07-01;1280;2548;0;211638;145873;0;64.8;44.7;0.0
87;2021-07-02;1151;3476;0;212789;149349;0;65.2;45.8;0.0
87;2021-07-03;435;1613;0;213224;150962;0;65.3;46.2;0.0
87;2021-07-04;34;393;0;213258;151355;0;65.3;46.4;0.0
87;2021-07-05;652;2474;0;213910;153829;0;65.5;47.1;0.0
87;2021-07-06;574;3236;0;214484;157065;0;65.7;48.1;0.0
87;2021-07-07;874;3326;0;215358;160391;0;66.0;49.1;0.0
87;2021-07-08;1058;3552;0;216416;163943;0;66.3;50.2;0.0
87;2021-07-09;1098;3717;0;217514;167660;0;66.6;51.4;0.0
87;2021-07-10;331;1477;0;217845;169137;0;66.7;51.8;0.0
87;2021-07-11;64;330;0;217909;169467;0;66.8;51.9;0.0
87;2021-07-12;582;3179;0;218491;172646;0;66.9;52.9;0.0
87;2021-07-13;891;3513;0;219382;176159;0;67.2;54.0;0.0
87;2021-07-14;510;583;0;219892;176742;0;67.4;54.1;0.0
87;2021-07-15;1363;3437;0;221255;180179;0;67.8;55.2;0.0
87;2021-07-16;1726;3599;0;222981;183778;0;68.3;56.3;0.0
87;2021-07-17;685;1457;0;223666;185235;0;68.5;56.7;0.0
87;2021-07-18;121;281;0;223787;185516;0;68.6;56.8;0.0
87;2021-07-19;1367;3317;0;225154;188833;0;69.0;57.8;0.0
87;2021-07-20;1762;3480;0;226916;192313;0;69.5;58.9;0.0
87;2021-07-21;1476;3042;0;228392;195355;0;70.0;59.8;0.0
87;2021-07-22;1895;3112;0;230287;198467;0;70.5;60.8;0.0
87;2021-07-23;1867;3063;0;232154;201530;0;71.1;61.7;0.0
87;2021-07-24;876;1319;0;233030;202849;0;71.4;62.1;0.0
87;2021-07-25;148;231;0;233178;203080;0;71.4;62.2;0.0
87;2021-07-26;1498;2290;0;234676;205370;0;71.9;62.9;0.0
87;2021-07-27;2465;1995;0;237141;207365;0;72.6;63.5;0.0
87;2021-07-28;2290;1933;0;239431;209298;0;73.3;64.1;0.0
87;2021-07-29;2824;1896;0;242255;211194;0;74.2;64.7;0.0
87;2021-07-30;2431;1894;0;244686;213088;0;75.0;65.3;0.0
87;2021-07-31;1200;913;0;245886;214001;0;75.3;65.6;0.0
87;2021-08-01;296;163;0;246182;214164;0;75.4;65.6;0.0
87;2021-08-02;2023;1497;0;248205;215661;0;76.0;66.1;0.0
87;2021-08-03;2345;1293;0;250550;216954;0;76.8;66.5;0.0
87;2021-08-04;2213;996;0;252763;217950;0;77.4;66.8;0.0
87;2021-08-05;2354;1353;0;255117;219303;0;78.2;67.2;0.0
87;2021-08-06;2036;1620;0;257153;220923;0;78.8;67.7;0.0
87;2021-08-07;1082;793;0;258235;221716;0;79.1;67.9;0.0
87;2021-08-08;213;128;0;258448;221844;0;79.2;68.0;0.0
87;2021-08-09;1720;1462;0;260168;223306;0;79.7;68.4;0.0
87;2021-08-10;2094;1493;0;262262;224799;0;80.3;68.9;0.0
87;2021-08-11;1803;1253;0;264065;226052;0;80.9;69.2;0.0
87;2021-08-12;1901;1423;0;265966;227475;0;81.5;69.7;0.0
87;2021-08-13;1565;1533;0;267531;229008;0;82.0;70.2;0.0
87;2021-08-14;674;704;0;268205;229712;0;82.2;70.4;0.0
87;2021-08-15;74;106;0;268279;229818;0;82.2;70.4;0.0
87;2021-08-16;1364;1679;0;269643;231497;0;82.6;70.9;0.0
87;2021-08-17;1282;1651;0;270925;233148;0;83.0;71.4;0.0
87;2021-08-18;1149;1925;0;272074;235073;0;83.3;72.0;0.0
87;2021-08-19;1101;1759;0;273175;236832;0;83.7;72.5;0.0
87;2021-08-20;869;2140;0;274044;238972;0;83.9;73.2;0.0
87;2021-08-21;351;972;0;274395;239944;0;84.1;73.5;0.0
87;2021-08-22;84;233;0;274479;240177;0;84.1;73.6;0.0
87;2021-08-23;699;2305;0;275178;242482;0;84.3;74.3;0.0
87;2021-08-24;733;2135;0;275911;244617;0;84.5;74.9;0.0
87;2021-08-25;677;2007;0;276588;246624;0;84.7;75.5;0.0
87;2021-08-26;801;2123;0;277389;248747;0;85.0;76.2;0.0
87;2021-08-27;737;2553;0;278126;251300;0;85.2;77.0;0.0
87;2021-08-28;321;1290;0;278447;252590;0;85.3;77.4;0.0
87;2021-08-29;64;263;0;278511;252853;0;85.3;77.5;0.0
87;2021-08-30;463;2112;15;278974;254965;15;85.5;78.1;0.0
87;2021-08-31;566;1831;28;279540;256796;43;85.6;78.7;0.0
87;2021-09-01;726;2258;123;280266;259054;166;85.9;79.4;0.1
87;2021-09-02;537;2003;200;280803;261057;366;86.0;80.0;0.1
87;2021-09-03;593;2005;337;281396;263062;703;86.2;80.6;0.2
87;2021-09-04;281;1132;61;281677;264194;764;86.3;80.9;0.2
87;2021-09-05;10;24;2;281687;264218;766;86.3;80.9;0.2
87;2021-09-06;370;1472;374;282057;265690;1140;86.4;81.4;0.3
87;2021-09-07;356;1148;286;282413;266838;1426;86.5;81.7;0.4
87;2021-09-08;428;1409;309;282841;268247;1735;86.6;82.2;0.5
87;2021-09-09;326;915;309;283167;269162;2044;86.7;82.5;0.6
87;2021-09-10;426;1300;329;283593;270462;2373;86.9;82.9;0.7
87;2021-09-11;282;882;70;283875;271344;2443;87.0;83.1;0.7
87;2021-09-12;7;18;2;283882;271362;2445;87.0;83.1;0.7
87;2021-09-13;307;720;372;284189;272082;2817;87.1;83.3;0.9
87;2021-09-14;287;606;412;284476;272688;3229;87.1;83.5;1.0
87;2021-09-15;335;930;339;284811;273618;3568;87.2;83.8;1.1
87;2021-09-16;318;746;374;285129;274364;3942;87.3;84.0;1.2
87;2021-09-17;370;830;429;285499;275194;4371;87.5;84.3;1.3
87;2021-09-18;260;686;123;285759;275880;4494;87.5;84.5;1.4
87;2021-09-19;9;23;7;285768;275903;4501;87.5;84.5;1.4
87;2021-09-20;184;440;247;285952;276343;4748;87.6;84.7;1.5
87;2021-09-21;273;485;307;286225;276828;5055;87.7;84.8;1.5
87;2021-09-22;218;720;416;286443;277548;5471;87.7;85.0;1.7
87;2021-09-23;204;504;394;286647;278052;5865;87.8;85.2;1.8
87;2021-09-24;257;686;557;286904;278738;6422;87.9;85.4;2.0
87;2021-09-25;149;473;156;287053;279211;6578;87.9;85.5;2.0
87;2021-09-26;5;11;4;287058;279222;6582;87.9;85.5;2.0
87;2021-09-27;186;382;246;287244;279604;6828;88.0;85.7;2.1
87;2021-09-28;177;296;346;287421;279900;7174;88.0;85.7;2.2
87;2021-09-29;142;387;347;287563;280287;7521;88.1;85.9;2.3
87;2021-09-30;121;257;389;287684;280544;7910;88.1;85.9;2.4
87;2021-10-01;215;478;353;287899;281022;8263;88.2;86.1;2.5
87;2021-10-02;146;348;136;288045;281370;8399;88.2;86.2;2.6
87;2021-10-03;5;6;2;288050;281376;8401;88.2;86.2;2.6
87;2021-10-04;145;275;449;288195;281651;8850;88.3;86.3;2.7
87;2021-10-05;108;209;480;288303;281860;9330;88.3;86.3;2.9
87;2021-10-06;185;382;589;288488;282242;9919;88.4;86.5;3.0
87;2021-10-07;114;249;409;288602;282491;10328;88.4;86.5;3.2
87;2021-10-08;223;460;679;288825;282951;11007;88.5;86.7;3.4
87;2021-10-09;148;323;243;288973;283274;11250;88.5;86.8;3.4
87;2021-10-10;3;8;3;288976;283282;11253;88.5;86.8;3.4
87;2021-10-11;126;259;310;289102;283541;11563;88.6;86.9;3.5
87;2021-10-12;101;218;574;289203;283759;12137;88.6;86.9;3.7
87;2021-10-13;151;200;494;289354;283959;12631;88.6;87.0;3.9
87;2021-10-14;115;236;502;289469;284195;13133;88.7;87.1;4.0
87;2021-10-15;175;312;601;289644;284507;13734;88.7;87.2;4.2
87;2021-10-16;134;253;294;289778;284760;14028;88.8;87.2;4.3
87;2021-10-17;6;10;0;289784;284770;14028;88.8;87.2;4.3
87;2021-10-18;115;188;526;289899;284958;14554;88.8;87.3;4.5
87;2021-10-19;121;179;603;290020;285137;15157;88.8;87.3;4.6
87;2021-10-20;123;165;623;290143;285302;15780;88.9;87.4;4.8
87;2021-10-21;92;242;620;290235;285544;16400;88.9;87.5;5.0
87;2021-10-22;162;267;605;290397;285811;17005;89.0;87.6;5.2
87;2021-10-23;88;144;242;290485;285955;17247;89.0;87.6;5.3
87;2021-10-24;5;8;1;290490;285963;17248;89.0;87.6;5.3
87;2021-10-25;112;172;546;290602;286135;17794;89.0;87.7;5.5
87;2021-10-26;54;74;571;290656;286209;18365;89.0;87.7;5.6
87;2021-10-27;111;178;739;290767;286387;19104;89.1;87.7;5.9
87;2021-10-28;94;116;585;290861;286503;19689;89.1;87.8;6.0
87;2021-10-29;144;195;688;291005;286698;20377;89.1;87.8;6.2
87;2021-10-30;70;124;263;291075;286822;20640;89.2;87.9;6.3
87;2021-10-31;4;5;5;291079;286827;20645;89.2;87.9;6.3
87;2021-11-01;4;3;5;291083;286830;20650;89.2;87.9;6.3
87;2021-11-02;101;128;663;291184;286958;21313;89.2;87.9;6.5
87;2021-11-03;86;183;644;291270;287141;21957;89.2;88.0;6.7
87;2021-11-04;79;109;654;291349;287250;22611;89.2;88.0;6.9
87;2021-11-05;129;187;840;291478;287437;23451;89.3;88.1;7.2
87;2021-11-06;94;105;313;291572;287542;23764;89.3;88.1;7.3
87;2021-11-07;2;9;0;291574;287551;23764;89.3;88.1;7.3
87;2021-11-08;95;113;798;291669;287664;24562;89.3;88.1;7.5
87;2021-11-09;85;123;1171;291754;287787;25733;89.4;88.2;7.9
87;2021-11-10;114;197;1103;291868;287984;26836;89.4;88.2;8.2
87;2021-11-11;4;5;18;291872;287989;26854;89.4;88.2;8.2
87;2021-11-12;89;157;1036;291961;288146;27890;89.4;88.3;8.5
87;2021-11-13;45;65;326;292006;288211;28216;89.5;88.3;8.6
87;2021-11-14;2;8;3;292008;288219;28219;89.5;88.3;8.6
87;2021-11-15;70;104;1073;292078;288323;29292;89.5;88.3;9.0
87;2021-11-16;85;107;1494;292163;288430;30786;89.5;88.4;9.4
87;2021-11-17;138;153;1307;292301;288583;32093;89.5;88.4;9.8
87;2021-11-18;135;123;1501;292436;288706;33594;89.6;88.4;10.3
87;2021-11-19;116;166;1661;292552;288872;35255;89.6;88.5;10.8
87;2021-11-20;78;116;614;292630;288988;35869;89.6;88.5;11.0
87;2021-11-21;10;7;54;292640;288995;35923;89.6;88.5;11.0
87;2021-11-22;93;88;1338;292733;289083;37261;89.7;88.6;11.4
87;2021-11-23;128;100;1999;292861;289183;39260;89.7;88.6;12.0
87;2021-11-24;159;116;1665;293020;289299;40925;89.8;88.6;12.5
87;2021-11-25;103;115;2180;293123;289414;43105;89.8;88.7;13.2
87;2021-11-26;127;138;2511;293250;289552;45616;89.8;88.7;14.0
87;2021-11-27;79;90;1256;293329;289642;46872;89.9;88.7;14.4
87;2021-11-28;5;6;62;293334;289648;46934;89.9;88.7;14.4
87;2021-11-29;71;100;2119;293405;289748;49053;89.9;88.8;15.0
87;2021-11-30;103;97;2999;293508;289845;52052;89.9;88.8;15.9
87;2021-12-01;62;124;2908;293570;289969;54960;89.9;88.8;16.8
87;2021-12-02;66;63;3581;293636;290032;58541;89.9;88.8;17.9
87;2021-12-03;91;120;3929;293727;290152;62470;90.0;88.9;19.1
87;2021-12-04;62;123;1317;293789;290275;63787;90.0;88.9;19.5
87;2021-12-05;0;9;221;293789;290284;64008;90.0;88.9;19.6
87;2021-12-06;44;85;2781;293833;290369;66789;90.0;88.9;20.5
87;2021-12-07;78;108;5520;293911;290477;72309;90.0;89.0;22.2
87;2021-12-08;94;111;4529;294005;290588;76838;90.1;89.0;23.5
87;2021-12-09;68;107;4314;294073;290695;81152;90.1;89.0;24.9
87;2021-12-10;97;131;5586;294170;290826;86738;90.1;89.1;26.6
87;2021-12-11;53;74;2454;294223;290900;89192;90.1;89.1;27.3
87;2021-12-12;6;14;330;294229;290914;89522;90.1;89.1;27.4
87;2021-12-13;82;102;4345;294311;291016;93867;90.2;89.1;28.8
87;2021-12-14;100;126;5889;294411;291142;99756;90.2;89.2;30.6
87;2021-12-15;99;171;5263;294510;291313;105019;90.2;89.2;32.2
87;2021-12-16;66;108;5332;294576;291421;110351;90.2;89.3;33.8
87;2021-12-17;122;168;6009;294698;291589;116360;90.3;89.3;35.6
87;2021-12-18;80;110;3098;294778;291699;119458;90.3;89.4;36.6
87;2021-12-19;12;14;378;294790;291713;119836;90.3;89.4;36.7
88;2020-12-27;0;0;0;0;0;0;0.0;0.0;0.0
88;2020-12-28;0;0;0;0;0;0;0.0;0.0;0.0
88;2020-12-29;0;0;0;0;0;0;0.0;0.0;0.0
88;2020-12-30;0;0;0;0;0;0;0.0;0.0;0.0
88;2020-12-31;0;0;0;0;0;0;0.0;0.0;0.0
88;2021-01-01;1;0;0;1;0;0;0.0;0.0;0.0
88;2021-01-02;0;0;0;1;0;0;0.0;0.0;0.0
88;2021-01-03;0;0;0;1;0;0;0.0;0.0;0.0
88;2021-01-04;1;0;0;2;0;0;0.0;0.0;0.0
88;2021-01-05;8;0;0;10;0;0;0.0;0.0;0.0
88;2021-01-06;19;0;0;29;0;0;0.0;0.0;0.0
88;2021-01-07;80;0;0;109;0;0;0.0;0.0;0.0
88;2021-01-08;170;2;0;279;2;0;0.1;0.0;0.0
88;2021-01-09;174;1;0;453;3;0;0.1;0.0;0.0
88;2021-01-10;2;0;0;455;3;0;0.1;0.0;0.0
88;2021-01-11;222;0;0;677;3;0;0.2;0.0;0.0
88;2021-01-12;419;0;0;1096;3;0;0.3;0.0;0.0
88;2021-01-13;485;3;0;1581;6;0;0.5;0.0;0.0
88;2021-01-14;367;4;0;1948;10;0;0.6;0.0;0.0
88;2021-01-15;372;3;0;2320;13;0;0.7;0.0;0.0
88;2021-01-16;61;0;0;2381;13;0;0.8;0.0;0.0
88;2021-01-17;0;0;0;2381;13;0;0.8;0.0;0.0
88;2021-01-18;458;0;0;2839;13;0;0.9;0.0;0.0
88;2021-01-19;461;1;0;3300;14;0;1.0;0.0;0.0
88;2021-01-20;474;1;0;3774;15;0;1.2;0.0;0.0
88;2021-01-21;1435;7;0;5209;22;0;1.6;0.0;0.0
88;2021-01-22;1117;3;0;6326;25;0;2.0;0.0;0.0
88;2021-01-23;280;0;0;6606;25;0;2.1;0.0;0.0
88;2021-01-24;267;2;0;6873;27;0;2.2;0.0;0.0
88;2021-01-25;865;3;0;7738;30;0;2.4;0.0;0.0
88;2021-01-26;359;9;0;8097;39;0;2.6;0.0;0.0
88;2021-01-27;19;5;0;8116;44;0;2.6;0.0;0.0
88;2021-01-28;154;36;0;8270;80;0;2.6;0.0;0.0
88;2021-01-29;509;136;0;8779;216;0;2.8;0.1;0.0
88;2021-01-30;286;118;0;9065;334;0;2.9;0.1;0.0
88;2021-01-31;1;1;0;9066;335;0;2.9;0.1;0.0
88;2021-02-01;411;273;0;9477;608;0;3.0;0.2;0.0
88;2021-02-02;325;348;0;9802;956;0;3.1;0.3;0.0
88;2021-02-03;434;245;0;10236;1201;0;3.2;0.4;0.0
88;2021-02-04;325;242;0;10561;1443;0;3.3;0.5;0.0
88;2021-02-05;461;282;0;11022;1725;0;3.5;0.5;0.0
88;2021-02-06;109;57;0;11131;1782;0;3.5;0.6;0.0
88;2021-02-07;0;4;0;11131;1786;0;3.5;0.6;0.0
88;2021-02-08;356;202;0;11487;1988;0;3.6;0.6;0.0
88;2021-02-09;294;283;0;11781;2271;0;3.7;0.7;0.0
88;2021-02-10;423;347;0;12204;2618;0;3.9;0.8;0.0
88;2021-02-11;811;1010;0;13015;3628;0;4.1;1.1;0.0
88;2021-02-12;912;677;0;13927;4305;0;4.4;1.4;0.0
88;2021-02-13;158;200;0;14085;4505;0;4.5;1.4;0.0
88;2021-02-14;76;193;0;14161;4698;0;4.5;1.5;0.0
88;2021-02-15;620;989;0;14781;5687;0;4.7;1.8;0.0
88;2021-02-16;470;689;0;15251;6376;0;4.8;2.0;0.0
88;2021-02-17;464;435;0;15715;6811;0;5.0;2.2;0.0
88;2021-02-18;519;366;0;16234;7177;0;5.1;2.3;0.0
88;2021-02-19;560;421;0;16794;7598;0;5.3;2.4;0.0
88;2021-02-20;163;103;0;16957;7701;0;5.4;2.4;0.0
88;2021-02-21;0;24;0;16957;7725;0;5.4;2.4;0.0
88;2021-02-22;418;337;0;17375;8062;0;5.5;2.6;0.0
88;2021-02-23;407;237;0;17782;8299;0;5.6;2.6;0.0
88;2021-02-24;543;229;0;18325;8528;0;5.8;2.7;0.0
88;2021-02-25;682;296;0;19007;8824;0;6.0;2.8;0.0
88;2021-02-26;879;293;0;19886;9117;0;6.3;2.9;0.0
88;2021-02-27;265;34;0;20151;9151;0;6.4;2.9;0.0
88;2021-02-28;28;0;0;20179;9151;0;6.4;2.9;0.0
88;2021-03-01;361;453;0;20540;9604;0;6.5;3.0;0.0
88;2021-03-02;438;472;0;20978;10076;0;6.6;3.2;0.0
88;2021-03-03;666;455;0;21644;10531;0;6.8;3.3;0.0
88;2021-03-04;1037;731;0;22681;11262;0;7.2;3.6;0.0
88;2021-03-05;921;690;0;23602;11952;0;7.5;3.8;0.0
88;2021-03-06;1789;123;0;25391;12075;0;8.0;3.8;0.0
88;2021-03-07;1033;81;0;26424;12156;0;8.4;3.8;0.0
88;2021-03-08;721;668;0;27145;12824;0;8.6;4.1;0.0
88;2021-03-09;1101;512;0;28246;13336;0;8.9;4.2;0.0
88;2021-03-10;1062;495;0;29308;13831;0;9.3;4.4;0.0
88;2021-03-11;1413;400;0;30721;14231;0;9.7;4.5;0.0
88;2021-03-12;1289;493;0;32010;14724;0;10.1;4.7;0.0
88;2021-03-13;1244;130;0;33254;14854;0;10.5;4.7;0.0
88;2021-03-14;168;5;0;33422;14859;0;10.6;4.7;0.0
88;2021-03-15;903;436;0;34325;15295;0;10.9;4.8;0.0
88;2021-03-16;967;339;0;35292;15634;0;11.2;4.9;0.0
88;2021-03-17;832;415;0;36124;16049;0;11.4;5.1;0.0
88;2021-03-18;1249;397;0;37373;16446;0;11.8;5.2;0.0
88;2021-03-19;1372;506;0;38745;16952;0;12.3;5.4;0.0
88;2021-03-20;1267;62;0;40012;17014;0;12.7;5.4;0.0
88;2021-03-21;37;0;0;40049;17014;0;12.7;5.4;0.0
88;2021-03-22;1127;531;0;41176;17545;0;13.0;5.6;0.0
88;2021-03-23;1613;436;0;42789;17981;0;13.5;5.7;0.0
88;2021-03-24;1739;477;0;44528;18458;0;14.1;5.8;0.0
88;2021-03-25;2350;483;0;46878;18941;0;14.8;6.0;0.0
88;2021-03-26;2316;451;0;49194;19392;0;15.6;6.1;0.0
88;2021-03-27;879;306;0;50073;19698;0;15.8;6.2;0.0
88;2021-03-28;64;5;0;50137;19703;0;15.9;6.2;0.0
88;2021-03-29;1210;441;0;51347;20144;0;16.2;6.4;0.0
88;2021-03-30;1962;399;0;53309;20543;0;16.9;6.5;0.0
88;2021-03-31;1529;577;0;54838;21120;0;17.3;6.7;0.0
88;2021-04-01;2053;696;0;56891;21816;0;18.0;6.9;0.0
88;2021-04-02;2560;625;0;59451;22441;0;18.8;7.1;0.0
88;2021-04-03;663;211;0;60114;22652;0;19.0;7.2;0.0
88;2021-04-04;22;10;0;60136;22662;0;19.0;7.2;0.0
88;2021-04-05;26;7;0;60162;22669;0;19.0;7.2;0.0
88;2021-04-06;1077;681;0;61239;23350;0;19.4;7.4;0.0
88;2021-04-07;1473;694;0;62712;24044;0;19.8;7.6;0.0
88;2021-04-08;1737;777;0;64449;24821;0;20.4;7.9;0.0
88;2021-04-09;2843;762;0;67292;25583;0;21.3;8.1;0.0
88;2021-04-10;733;639;0;68025;26222;0;21.5;8.3;0.0
88;2021-04-11;36;10;0;68061;26232;0;21.5;8.3;0.0
88;2021-04-12;1437;908;0;69498;27140;0;22.0;8.6;0.0
88;2021-04-13;1975;1036;0;71473;28176;0;22.6;8.9;0.0
88;2021-04-14;1852;869;0;73325;29045;0;23.2;9.2;0.0
88;2021-04-15;1864;1195;0;75189;30240;0;23.8;9.6;0.0
88;2021-04-16;2021;971;0;77210;31211;0;24.4;9.9;0.0
88;2021-04-17;1251;706;0;78461;31917;0;24.8;10.1;0.0
88;2021-04-18;228;23;0;78689;31940;0;24.9;10.1;0.0
88;2021-04-19;1131;1074;0;79820;33014;0;25.3;10.4;0.0
88;2021-04-20;1145;1257;0;80965;34271;0;25.6;10.8;0.0
88;2021-04-21;1450;1215;0;82415;35486;0;26.1;11.2;0.0
88;2021-04-22;1876;1539;0;84291;37025;0;26.7;11.7;0.0
88;2021-04-23;1795;1909;0;86086;38934;0;27.2;12.3;0.0
88;2021-04-24;1039;749;0;87125;39683;0;27.6;12.6;0.0
88;2021-04-25;40;3;0;87165;39686;0;27.6;12.6;0.0
88;2021-04-26;1105;1041;0;88270;40727;0;27.9;12.9;0.0
88;2021-04-27;1228;1621;0;89498;42348;0;28.3;13.4;0.0
88;2021-04-28;1526;1363;0;91024;43711;0;28.8;13.8;0.0
88;2021-04-29;1873;1371;0;92897;45082;0;29.4;14.3;0.0
88;2021-04-30;2240;1455;1;95137;46537;1;30.1;14.7;0.0
88;2021-05-01;1905;288;0;97042;46825;1;30.7;14.8;0.0
88;2021-05-02;1180;121;0;98222;46946;1;31.1;14.9;0.0
88;2021-05-03;1465;1097;0;99687;48043;1;31.5;15.2;0.0
88;2021-05-04;1394;1366;0;101081;49409;1;32.0;15.6;0.0
88;2021-05-05;2268;1478;0;103349;50887;1;32.7;16.1;0.0
88;2021-05-06;2954;1173;0;106303;52060;1;33.6;16.5;0.0
88;2021-05-07;2617;1225;0;108920;53285;1;34.5;16.9;0.0
88;2021-05-08;1455;463;0;110375;53748;1;34.9;17.0;0.0
88;2021-05-09;1461;146;0;111836;53894;1;35.4;17.0;0.0
88;2021-05-10;1631;1482;0;113467;55376;1;35.9;17.5;0.0
88;2021-05-11;2408;1819;0;115875;57195;1;36.7;18.1;0.0
88;2021-05-12;2335;1737;0;118210;58932;1;37.4;18.6;0.0
88;2021-05-13;2715;640;0;120925;59572;1;38.3;18.8;0.0
88;2021-05-14;2219;1382;0;123144;60954;1;39.0;19.3;0.0
88;2021-05-15;1631;741;0;124775;61695;1;39.5;19.5;0.0
88;2021-05-16;1132;95;0;125907;61790;1;39.8;19.5;0.0
88;2021-05-17;1751;913;0;127658;62703;1;40.4;19.8;0.0
88;2021-05-18;1978;1060;0;129636;63763;1;41.0;20.2;0.0
88;2021-05-19;2334;1070;0;131970;64833;1;41.7;20.5;0.0
88;2021-05-20;2818;1187;0;134788;66020;1;42.6;20.9;0.0
88;2021-05-21;2448;1103;0;137236;67123;1;43.4;21.2;0.0
88;2021-05-22;1469;712;0;138705;67835;1;43.9;21.5;0.0
88;2021-05-23;536;73;0;139241;67908;1;44.0;21.5;0.0
88;2021-05-24;1257;388;0;140498;68296;1;44.4;21.6;0.0
88;2021-05-25;1446;1094;0;141944;69390;1;44.9;22.0;0.0
88;2021-05-26;2060;1070;0;144004;70460;1;45.6;22.3;0.0
88;2021-05-27;1795;1268;0;145799;71728;1;46.1;22.7;0.0
88;2021-05-28;1683;1859;0;147482;73587;1;46.7;23.3;0.0
88;2021-05-29;1243;1693;0;148725;75280;1;47.0;23.8;0.0
88;2021-05-30;548;406;0;149273;75686;1;47.2;23.9;0.0
88;2021-05-31;1141;1726;0;150414;77412;1;47.6;24.5;0.0
88;2021-06-01;1582;1880;0;151996;79292;1;48.1;25.1;0.0
88;2021-06-02;1842;1765;0;153838;81057;1;48.7;25.6;0.0
88;2021-06-03;2504;1593;0;156342;82650;1;49.5;26.1;0.0
88;2021-06-04;1862;1839;0;158204;84489;1;50.0;26.7;0.0
88;2021-06-05;1429;1105;0;159633;85594;1;50.5;27.1;0.0
88;2021-06-06;670;151;0;160303;85745;1;50.7;27.1;0.0
88;2021-06-07;1235;1599;0;161538;87344;1;51.1;27.6;0.0
88;2021-06-08;1618;1788;0;163156;89132;1;51.6;28.2;0.0
88;2021-06-09;1588;1805;0;164744;90937;1;52.1;28.8;0.0
88;2021-06-10;1745;1914;0;166489;92851;1;52.7;29.4;0.0
88;2021-06-11;1549;2101;0;168038;94952;1;53.2;30.0;0.0
88;2021-06-12;755;1630;0;168793;96582;1;53.4;30.6;0.0
88;2021-06-13;452;355;0;169245;96937;1;53.5;30.7;0.0
88;2021-06-14;953;2063;0;170198;99000;1;53.8;31.3;0.0
88;2021-06-15;1800;2340;0;171998;101340;1;54.4;32.1;0.0
88;2021-06-16;1409;2715;0;173407;104055;1;54.9;32.9;0.0
88;2021-06-17;1557;2551;0;174964;106606;1;55.4;33.7;0.0
88;2021-06-18;1356;2302;0;176320;108908;1;55.8;34.5;0.0
88;2021-06-19;626;1075;0;176946;109983;1;56.0;34.8;0.0
88;2021-06-20;78;82;0;177024;110065;1;56.0;34.8;0.0
88;2021-06-21;643;2286;0;177667;112351;1;56.2;35.5;0.0
88;2021-06-22;880;3184;0;178547;115535;1;56.5;36.5;0.0
88;2021-06-23;1093;2647;0;179640;118182;1;56.8;37.4;0.0
88;2021-06-24;712;2471;0;180352;120653;1;57.1;38.2;0.0
88;2021-06-25;1357;2922;0;181709;123575;1;57.5;39.1;0.0
88;2021-06-26;801;2031;0;182510;125606;1;57.7;39.7;0.0
88;2021-06-27;520;622;0;183030;126228;1;57.9;39.9;0.0
88;2021-06-28;701;2218;0;183731;128446;1;58.1;40.6;0.0
88;2021-06-29;827;3057;0;184558;131503;1;58.4;41.6;0.0
88;2021-06-30;1029;2847;0;185587;134350;1;58.7;42.5;0.0
88;2021-07-01;1056;2553;0;186643;136903;1;59.0;43.3;0.0
88;2021-07-02;1025;2896;0;187668;139799;1;59.4;44.2;0.0
88;2021-07-03;654;1701;0;188322;141500;1;59.6;44.8;0.0
88;2021-07-04;250;771;0;188572;142271;1;59.7;45.0;0.0
88;2021-07-05;944;1792;0;189516;144063;1;60.0;45.6;0.0
88;2021-07-06;1011;2182;0;190527;146245;1;60.3;46.3;0.0
88;2021-07-07;1140;2412;0;191667;148657;1;60.6;47.0;0.0
88;2021-07-08;1004;1961;0;192671;150618;1;61.0;47.6;0.0
88;2021-07-09;1534;2469;0;194205;153087;1;61.4;48.4;0.0
88;2021-07-10;728;1820;0;194933;154907;1;61.7;49.0;0.0
88;2021-07-11;444;656;0;195377;155563;1;61.8;49.2;0.0
88;2021-07-12;989;2292;0;196366;157855;1;62.1;49.9;0.0
88;2021-07-13;1289;2454;0;197655;160309;1;62.5;50.7;0.0
88;2021-07-14;1115;720;0;198770;161029;1;62.9;50.9;0.0
88;2021-07-15;1710;3132;0;200480;164161;1;63.4;51.9;0.0
88;2021-07-16;1531;2860;0;202011;167021;1;63.9;52.8;0.0
88;2021-07-17;960;1690;0;202971;168711;1;64.2;53.4;0.0
88;2021-07-18;320;727;0;203291;169438;1;64.3;53.6;0.0
88;2021-07-19;1498;2044;0;204789;171482;1;64.8;54.2;0.0
88;2021-07-20;2082;2309;0;206871;173791;1;65.4;55.0;0.0
88;2021-07-21;1958;2195;0;208829;175986;1;66.1;55.7;0.0
88;2021-07-22;1868;2194;0;210697;178180;1;66.7;56.4;0.0
88;2021-07-23;2517;2786;0;213214;180966;1;67.5;57.2;0.0
88;2021-07-24;1262;1321;0;214476;182287;1;67.9;57.7;0.0
88;2021-07-25;445;591;0;214921;182878;1;68.0;57.9;0.0
88;2021-07-26;1653;1897;0;216574;184775;1;68.5;58.5;0.0
88;2021-07-27;2361;1972;0;218935;186747;1;69.3;59.1;0.0
88;2021-07-28;2315;1906;0;221250;188653;1;70.0;59.7;0.0
88;2021-07-29;2993;1597;0;224243;190250;1;70.9;60.2;0.0
88;2021-07-30;2339;2247;0;226582;192497;1;71.7;60.9;0.0
88;2021-07-31;1307;1112;0;227889;193609;1;72.1;61.2;0.0
88;2021-08-01;452;448;0;228341;194057;1;72.2;61.4;0.0
88;2021-08-02;2244;1620;0;230585;195677;1;72.9;61.9;0.0
88;2021-08-03;2761;1512;0;233346;197189;1;73.8;62.4;0.0
88;2021-08-04;2450;1542;0;235796;198731;1;74.6;62.9;0.0
88;2021-08-05;2027;1374;0;237823;200105;1;75.2;63.3;0.0
88;2021-08-06;2844;1929;0;240667;202034;1;76.1;63.9;0.0
88;2021-08-07;1232;992;0;241899;203026;1;76.5;64.2;0.0
88;2021-08-08;715;315;0;242614;203341;1;76.8;64.3;0.0
88;2021-08-09;1423;1561;0;244037;204902;1;77.2;64.8;0.0
88;2021-08-10;1826;1962;0;245863;206864;1;77.8;65.4;0.0
88;2021-08-11;1759;1679;0;247622;208543;1;78.3;66.0;0.0
88;2021-08-12;1581;1375;0;249203;209918;1;78.8;66.4;0.0
88;2021-08-13;1837;2079;0;251040;211997;1;79.4;67.1;0.0
88;2021-08-14;590;998;0;251630;212995;1;79.6;67.4;0.0
88;2021-08-15;280;485;0;251910;213480;1;79.7;67.5;0.0
88;2021-08-16;1038;1857;0;252948;215337;1;80.0;68.1;0.0
88;2021-08-17;1206;1974;0;254154;217311;1;80.4;68.7;0.0
88;2021-08-18;1177;1914;0;255331;219225;1;80.8;69.4;0.0
88;2021-08-19;997;1600;0;256328;220825;1;81.1;69.9;0.0
88;2021-08-20;1022;2278;0;257350;223103;1;81.4;70.6;0.0
88;2021-08-21;439;1292;0;257789;224395;1;81.6;71.0;0.0
88;2021-08-22;91;471;0;257880;224866;1;81.6;71.1;0.0
88;2021-08-23;695;1562;0;258575;226428;1;81.8;71.6;0.0
88;2021-08-24;870;1898;0;259445;228326;1;82.1;72.2;0.0
88;2021-08-25;856;2409;0;260301;230735;1;82.3;73.0;0.0
88;2021-08-26;834;2034;0;261135;232769;1;82.6;73.6;0.0
88;2021-08-27;801;2634;0;261936;235403;1;82.9;74.5;0.0
88;2021-08-28;493;1450;0;262429;236853;1;83.0;74.9;0.0
88;2021-08-29;128;657;0;262557;237510;1;83.1;75.1;0.0
88;2021-08-30;663;2218;38;263220;239728;39;83.3;75.8;0.0
88;2021-08-31;779;2335;46;263999;242063;85;83.5;76.6;0.0
88;2021-09-01;665;1914;86;264664;243977;171;83.7;77.2;0.1
88;2021-09-02;645;1555;130;265309;245532;301;83.9;77.7;0.1
88;2021-09-03;726;2056;158;266035;247588;459;84.2;78.3;0.1
88;2021-09-04;463;1126;56;266498;248714;515;84.3;78.7;0.2
88;2021-09-05;182;366;53;266680;249080;568;84.4;78.8;0.2
88;2021-09-06;467;1085;148;267147;250165;716;84.5;79.1;0.2
88;2021-09-07;540;1152;188;267687;251317;904;84.7;79.5;0.3
88;2021-09-08;450;1244;149;268137;252561;1053;84.8;79.9;0.3
88;2021-09-09;529;783;293;268666;253344;1346;85.0;80.1;0.4
88;2021-09-10;593;1283;227;269259;254627;1573;85.2;80.6;0.5
88;2021-09-11;351;809;72;269610;255436;1645;85.3;80.8;0.5
88;2021-09-12;62;122;18;269672;255558;1663;85.3;80.8;0.5
88;2021-09-13;401;632;334;270073;256190;1997;85.4;81.0;0.6
88;2021-09-14;537;706;572;270610;256896;2569;85.6;81.3;0.8
88;2021-09-15;424;930;417;271034;257826;2986;85.7;81.6;0.9
88;2021-09-16;261;527;337;271295;258353;3323;85.8;81.7;1.1
88;2021-09-17;410;967;426;271705;259320;3749;86.0;82.0;1.2
88;2021-09-18;234;719;149;271939;260039;3898;86.0;82.3;1.2
88;2021-09-19;45;157;10;271984;260196;3908;86.0;82.3;1.2
88;2021-09-20;224;536;368;272208;260732;4276;86.1;82.5;1.4
88;2021-09-21;214;568;351;272422;261300;4627;86.2;82.7;1.5
88;2021-09-22;187;742;456;272609;262042;5083;86.2;82.9;1.6
88;2021-09-23;275;608;326;272884;262650;5409;86.3;83.1;1.7
88;2021-09-24;268;797;473;273152;263447;5882;86.4;83.3;1.9
88;2021-09-25;130;596;179;273282;264043;6061;86.5;83.5;1.9
88;2021-09-26;16;149;22;273298;264192;6083;86.5;83.6;1.9
88;2021-09-27;153;431;428;273451;264623;6511;86.5;83.7;2.1
88;2021-09-28;176;500;475;273627;265123;6986;86.6;83.9;2.2
88;2021-09-29;163;482;368;273790;265605;7354;86.6;84.0;2.3
88;2021-09-30;136;454;253;273926;266059;7607;86.7;84.2;2.4
88;2021-10-01;239;655;355;274165;266714;7962;86.7;84.4;2.5
88;2021-10-02;151;366;102;274316;267080;8064;86.8;84.5;2.6
88;2021-10-03;24;72;19;274340;267152;8083;86.8;84.5;2.6
88;2021-10-04;149;434;387;274489;267586;8470;86.8;84.7;2.7
88;2021-10-05;178;550;477;274667;268136;8947;86.9;84.8;2.8
88;2021-10-06;180;391;402;274847;268527;9349;86.9;84.9;3.0
88;2021-10-07;75;222;173;274922;268749;9522;87.0;85.0;3.0
88;2021-10-08;267;609;521;275189;269358;10043;87.1;85.2;3.2
88;2021-10-09;131;260;137;275320;269618;10180;87.1;85.3;3.2
88;2021-10-10;23;43;12;275343;269661;10192;87.1;85.3;3.2
88;2021-10-11;107;229;447;275450;269890;10639;87.1;85.4;3.4
88;2021-10-12;146;266;717;275596;270156;11356;87.2;85.5;3.6
88;2021-10-13;146;238;537;275742;270394;11893;87.2;85.5;3.8
88;2021-10-14;84;197;281;275826;270591;12174;87.3;85.6;3.9
88;2021-10-15;193;376;586;276019;270967;12760;87.3;85.7;4.0
88;2021-10-16;132;139;156;276151;271106;12916;87.4;85.8;4.1
88;2021-10-17;1;13;0;276152;271119;12916;87.4;85.8;4.1
88;2021-10-18;166;224;637;276318;271343;13553;87.4;85.8;4.3
88;2021-10-19;142;156;478;276460;271499;14031;87.5;85.9;4.4
88;2021-10-20;156;190;449;276616;271689;14480;87.5;85.9;4.6
88;2021-10-21;97;124;299;276713;271813;14779;87.5;86.0;4.7
88;2021-10-22;168;254;762;276881;272067;15541;87.6;86.1;4.9
88;2021-10-23;92;139;191;276973;272206;15732;87.6;86.1;5.0
88;2021-10-24;2;1;8;276975;272207;15740;87.6;86.1;5.0
88;2021-10-25;168;178;731;277143;272385;16471;87.7;86.2;5.2
88;2021-10-26;174;184;885;277317;272569;17356;87.7;86.2;5.5
88;2021-10-27;113;151;663;277430;272720;18019;87.8;86.3;5.7
88;2021-10-28;57;82;218;277487;272802;18237;87.8;86.3;5.8
88;2021-10-29;166;209;801;277653;273011;19038;87.8;86.4;6.0
88;2021-10-30;71;169;308;277724;273180;19346;87.9;86.4;6.1
88;2021-10-31;2;6;0;277726;273186;19346;87.9;86.4;6.1
88;2021-11-01;8;18;12;277734;273204;19358;87.9;86.4;6.1
88;2021-11-02;133;188;782;277867;273392;20140;87.9;86.5;6.4
88;2021-11-03;111;168;830;277978;273560;20970;87.9;86.5;6.6
88;2021-11-04;63;103;428;278041;273663;21398;88.0;86.6;6.8
88;2021-11-05;141;230;987;278182;273893;22385;88.0;86.6;7.1
88;2021-11-06;103;146;327;278285;274039;22712;88.0;86.7;7.2
88;2021-11-07;7;7;17;278292;274046;22729;88.0;86.7;7.2
88;2021-11-08;116;161;1012;278408;274207;23741;88.1;86.7;7.5
88;2021-11-09;94;180;1317;278502;274387;25058;88.1;86.8;7.9
88;2021-11-10;154;181;1270;278656;274568;26328;88.2;86.9;8.3
88;2021-11-11;1;7;11;278657;274575;26339;88.2;86.9;8.3
88;2021-11-12;139;155;1294;278796;274730;27633;88.2;86.9;8.7
88;2021-11-13;74;137;441;278870;274867;28074;88.2;87.0;8.9
88;2021-11-14;1;2;4;278871;274869;28078;88.2;87.0;8.9
88;2021-11-15;113;176;1226;278984;275045;29304;88.3;87.0;9.3
88;2021-11-16;140;144;1466;279124;275189;30770;88.3;87.1;9.7
88;2021-11-17;118;179;1068;279242;275368;31838;88.3;87.1;10.1
88;2021-11-18;77;84;829;279319;275452;32667;88.4;87.1;10.3
88;2021-11-19;165;211;1739;279484;275663;34406;88.4;87.2;10.9
88;2021-11-20;105;105;570;279589;275768;34976;88.4;87.2;11.1
88;2021-11-21;12;15;30;279601;275783;35006;88.5;87.2;11.1
88;2021-11-22;86;56;1232;279687;275839;36238;88.5;87.3;11.5
88;2021-11-23;140;143;1990;279827;275982;38228;88.5;87.3;12.1
88;2021-11-24;136;123;1363;279963;276105;39591;88.6;87.3;12.5
88;2021-11-25;86;72;1106;280049;276177;40697;88.6;87.4;12.9
88;2021-11-26;186;181;2244;280235;276358;42941;88.7;87.4;13.6
88;2021-11-27;137;150;1330;280372;276508;44271;88.7;87.5;14.0
88;2021-11-28;0;5;45;280372;276513;44316;88.7;87.5;14.0
88;2021-11-29;133;107;2545;280505;276620;46861;88.7;87.5;14.8
88;2021-11-30;97;105;2508;280602;276725;49369;88.8;87.5;15.6
88;2021-12-01;109;124;3423;280711;276849;52792;88.8;87.6;16.7
88;2021-12-02;121;52;3536;280832;276901;56328;88.8;87.6;17.8
88;2021-12-03;116;152;3774;280948;277053;60102;88.9;87.6;19.0
88;2021-12-04;95;107;2453;281043;277160;62555;88.9;87.7;19.8
88;2021-12-05;9;19;261;281052;277179;62816;88.9;87.7;19.9
88;2021-12-06;86;101;3172;281138;277280;65988;88.9;87.7;20.9
88;2021-12-07;113;127;4252;281251;277407;70240;89.0;87.8;22.2
88;2021-12-08;117;136;3687;281368;277543;73927;89.0;87.8;23.4
88;2021-12-09;109;104;3570;281477;277647;77497;89.0;87.8;24.5
88;2021-12-10;105;160;4475;281582;277807;81972;89.1;87.9;25.9
88;2021-12-11;116;139;2843;281698;277946;84815;89.1;87.9;26.8
88;2021-12-12;18;13;585;281716;277959;85400;89.1;87.9;27.0
88;2021-12-13;103;87;3602;281819;278046;89002;89.2;88.0;28.2
88;2021-12-14;155;170;5079;281974;278216;94081;89.2;88.0;29.8
88;2021-12-15;163;134;3932;282137;278350;98013;89.3;88.1;31.0
88;2021-12-16;148;116;4719;282285;278466;102732;89.3;88.1;32.5
88;2021-12-17;126;168;4451;282411;278634;107183;89.3;88.1;33.9
88;2021-12-18;105;144;2662;282516;278778;109845;89.4;88.2;34.7
88;2021-12-19;13;8;424;282529;278786;110269;89.4;88.2;34.9
89;2020-12-27;0;0;0;0;0;0;0.0;0.0;0.0
89;2020-12-28;0;0;0;0;0;0;0.0;0.0;0.0
89;2020-12-29;0;0;0;0;0;0;0.0;0.0;0.0
89;2020-12-30;0;0;0;0;0;0;0.0;0.0;0.0
89;2020-12-31;0;0;0;0;0;0;0.0;0.0;0.0
89;2021-01-01;0;0;0;0;0;0;0.0;0.0;0.0
89;2021-01-02;0;0;0;0;0;0;0.0;0.0;0.0
89;2021-01-03;0;0;0;0;0;0;0.0;0.0;0.0
89;2021-01-04;0;0;0;0;0;0;0.0;0.0;0.0
89;2021-01-05;3;0;0;3;0;0;0.0;0.0;0.0
89;2021-01-06;46;0;0;49;0;0;0.0;0.0;0.0
89;2021-01-07;194;0;0;243;0;0;0.1;0.0;0.0
89;2021-01-08;55;0;0;298;0;0;0.1;0.0;0.0
89;2021-01-09;4;0;0;302;0;0;0.1;0.0;0.0
89;2021-01-10;0;0;0;302;0;0;0.1;0.0;0.0
89;2021-01-11;221;0;0;523;0;0;0.2;0.0;0.0
89;2021-01-12;327;1;0;850;1;0;0.3;0.0;0.0
89;2021-01-13;501;3;0;1351;4;0;0.5;0.0;0.0
89;2021-01-14;637;7;0;1988;11;0;0.7;0.0;0.0
89;2021-01-15;287;3;0;2275;14;0;0.8;0.0;0.0
89;2021-01-16;90;4;0;2365;18;0;0.8;0.0;0.0
89;2021-01-17;0;0;0;2365;18;0;0.8;0.0;0.0
89;2021-01-18;494;1;0;2859;19;0;1.0;0.0;0.0
89;2021-01-19;775;4;0;3634;23;0;1.3;0.0;0.0
89;2021-01-20;762;0;0;4396;23;0;1.5;0.0;0.0
89;2021-01-21;878;1;0;5274;24;0;1.8;0.0;0.0
89;2021-01-22;960;1;0;6234;25;0;2.2;0.0;0.0
89;2021-01-23;154;0;0;6388;25;0;2.2;0.0;0.0
89;2021-01-24;93;1;0;6481;26;0;2.2;0.0;0.0
89;2021-01-25;479;3;0;6960;29;0;2.4;0.0;0.0
89;2021-01-26;584;15;0;7544;44;0;2.6;0.0;0.0
89;2021-01-27;489;34;0;8033;78;0;2.8;0.0;0.0
89;2021-01-28;551;118;0;8584;196;0;3.0;0.1;0.0
89;2021-01-29;849;41;0;9433;237;0;3.3;0.1;0.0
89;2021-01-30;165;64;0;9598;301;0;3.3;0.1;0.0
89;2021-01-31;23;2;0;9621;303;0;3.3;0.1;0.0
89;2021-02-01;257;153;0;9878;456;0;3.4;0.2;0.0
89;2021-02-02;283;322;0;10161;778;0;3.5;0.3;0.0
89;2021-02-03;293;325;0;10454;1103;0;3.6;0.4;0.0
89;2021-02-04;421;539;0;10875;1642;0;3.8;0.6;0.0
89;2021-02-05;364;193;0;11239;1835;0;3.9;0.6;0.0
89;2021-02-06;78;65;0;11317;1900;0;3.9;0.7;0.0
89;2021-02-07;1;1;0;11318;1901;0;3.9;0.7;0.0
89;2021-02-08;271;185;0;11589;2086;0;4.0;0.7;0.0
89;2021-02-09;294;441;0;11883;2527;0;4.1;0.9;0.0
89;2021-02-10;389;303;0;12272;2830;0;4.3;1.0;0.0
89;2021-02-11;329;552;0;12601;3382;0;4.4;1.2;0.0
89;2021-02-12;436;564;0;13037;3946;0;4.5;1.4;0.0
89;2021-02-13;50;125;0;13087;4071;0;4.5;1.4;0.0
89;2021-02-14;20;104;0;13107;4175;0;4.5;1.4;0.0
89;2021-02-15;211;407;0;13318;4582;0;4.6;1.6;0.0
89;2021-02-16;136;559;0;13454;5141;0;4.7;1.8;0.0
89;2021-02-17;271;431;0;13725;5572;0;4.8;1.9;0.0
89;2021-02-18;234;538;0;13959;6110;0;4.8;2.1;0.0
89;2021-02-19;235;609;0;14194;6719;0;4.9;2.3;0.0
89;2021-02-20;35;120;0;14229;6839;0;4.9;2.4;0.0
89;2021-02-21;1;9;0;14230;6848;0;4.9;2.4;0.0
89;2021-02-22;221;443;0;14451;7291;0;5.0;2.5;0.0
89;2021-02-23;179;489;0;14630;7780;0;5.1;2.7;0.0
89;2021-02-24;326;403;0;14956;8183;0;5.2;2.8;0.0
89;2021-02-25;385;461;0;15341;8644;0;5.3;3.0;0.0
89;2021-02-26;375;320;0;15716;8964;0;5.4;3.1;0.0
89;2021-02-27;143;89;0;15859;9053;0;5.5;3.1;0.0
89;2021-02-28;2;13;0;15861;9066;0;5.5;3.1;0.0
89;2021-03-01;518;248;0;16379;9314;0;5.7;3.2;0.0
89;2021-03-02;733;363;0;17112;9677;0;5.9;3.4;0.0
89;2021-03-03;640;272;0;17752;9949;0;6.1;3.4;0.0
89;2021-03-04;673;382;0;18425;10331;0;6.4;3.6;0.0
89;2021-03-05;756;486;0;19181;10817;0;6.6;3.7;0.0
89;2021-03-06;552;137;0;19733;10954;0;6.8;3.8;0.0
89;2021-03-07;307;47;0;20040;11001;0;6.9;3.8;0.0
89;2021-03-08;568;315;0;20608;11316;0;7.1;3.9;0.0
89;2021-03-09;1010;288;0;21618;11604;0;7.5;4.0;0.0
89;2021-03-10;1026;254;0;22644;11858;0;7.8;4.1;0.0
89;2021-03-11;1090;307;0;23734;12165;0;8.2;4.2;0.0
89;2021-03-12;1279;334;0;25013;12499;0;8.7;4.3;0.0
89;2021-03-13;634;48;0;25647;12547;0;8.9;4.3;0.0
89;2021-03-14;11;1;0;25658;12548;0;8.9;4.3;0.0
89;2021-03-15;839;304;0;26497;12852;0;9.2;4.5;0.0
89;2021-03-16;932;214;0;27429;13066;0;9.5;4.5;0.0
89;2021-03-17;923;208;0;28352;13274;0;9.8;4.6;0.0
89;2021-03-18;893;220;0;29245;13494;0;10.1;4.7;0.0
89;2021-03-19;1122;194;0;30367;13688;0;10.5;4.7;0.0
89;2021-03-20;827;28;0;31194;13716;0;10.8;4.8;0.0
89;2021-03-21;193;11;0;31387;13727;0;10.9;4.8;0.0
89;2021-03-22;1051;223;0;32438;13950;0;11.2;4.8;0.0
89;2021-03-23;1700;230;0;34138;14180;0;11.8;4.9;0.0
89;2021-03-24;1937;324;0;36075;14504;0;12.5;5.0;0.0
89;2021-03-25;1847;184;0;37922;14688;0;13.1;5.1;0.0
89;2021-03-26;2503;177;0;40425;14865;0;14.0;5.1;0.0
89;2021-03-27;1682;50;0;42107;14915;0;14.6;5.2;0.0
89;2021-03-28;26;0;0;42133;14915;0;14.6;5.2;0.0
89;2021-03-29;942;564;0;43075;15479;0;14.9;5.4;0.0
89;2021-03-30;1166;565;0;44241;16044;0;15.3;5.6;0.0
89;2021-03-31;1911;487;0;46152;16531;0;16.0;5.7;0.0
89;2021-04-01;2043;467;0;48195;16998;0;16.7;5.9;0.0
89;2021-04-02;1973;443;0;50168;17441;0;17.4;6.0;0.0
89;2021-04-03;912;243;0;51080;17684;0;17.7;6.1;0.0
89;2021-04-04;29;12;0;51109;17696;0;17.7;6.1;0.0
89;2021-04-05;91;5;0;51200;17701;0;17.7;6.1;0.0
89;2021-04-06;1017;750;0;52217;18451;0;18.1;6.4;0.0
89;2021-04-07;985;799;0;53202;19250;0;18.4;6.7;0.0
89;2021-04-08;1689;716;0;54891;19966;0;19.0;6.9;0.0
89;2021-04-09;2123;750;0;57014;20716;0;19.8;7.2;0.0
89;2021-04-10;895;184;0;57909;20900;0;20.1;7.2;0.0
89;2021-04-11;48;5;0;57957;20905;0;20.1;7.2;0.0
89;2021-04-12;964;791;0;58921;21696;0;20.4;7.5;0.0
89;2021-04-13;1315;1049;0;60236;22745;0;20.9;7.9;0.0
89;2021-04-14;1185;1007;0;61421;23752;0;21.3;8.2;0.0
89;2021-04-15;1381;928;0;62802;24680;0;21.8;8.6;0.0
89;2021-04-16;1322;916;0;64124;25596;0;22.2;8.9;0.0
89;2021-04-17;997;440;0;65121;26036;0;22.6;9.0;0.0
89;2021-04-18;47;176;0;65168;26212;0;22.6;9.1;0.0
89;2021-04-19;717;1021;0;65885;27233;0;22.8;9.4;0.0
89;2021-04-20;988;1531;0;66873;28764;0;23.2;10.0;0.0
89;2021-04-21;823;1090;0;67696;29854;0;23.5;10.3;0.0
89;2021-04-22;1059;1155;0;68755;31009;0;23.8;10.7;0.0
89;2021-04-23;1664;1893;0;70419;32902;0;24.4;11.4;0.0
89;2021-04-24;1137;1114;0;71556;34016;0;24.8;11.8;0.0
89;2021-04-25;179;18;0;71735;34034;0;24.9;11.8;0.0
89;2021-04-26;1440;749;0;73175;34783;0;25.4;12.1;0.0
89;2021-04-27;1721;1040;0;74896;35823;0;25.9;12.4;0.0
89;2021-04-28;1589;1764;0;76485;37587;0;26.5;13.0;0.0
89;2021-04-29;1914;1815;0;78399;39402;0;27.2;13.7;0.0
89;2021-04-30;1796;1639;0;80195;41041;0;27.8;14.2;0.0
89;2021-05-01;843;642;0;81038;41683;0;28.1;14.4;0.0
89;2021-05-02;161;47;0;81199;41730;0;28.1;14.5;0.0
89;2021-05-03;1520;777;0;82719;42507;0;28.7;14.7;0.0
89;2021-05-04;1573;1111;0;84292;43618;0;29.2;15.1;0.0
89;2021-05-05;2280;1192;0;86572;44810;0;30.0;15.5;0.0
89;2021-05-06;2349;1364;0;88921;46174;0;30.8;16.0;0.0
89;2021-05-07;2652;1274;0;91573;47448;0;31.7;16.4;0.0
89;2021-05-08;1671;504;0;93244;47952;0;32.3;16.6;0.0
89;2021-05-09;259;33;0;93503;47985;0;32.4;16.6;0.0
89;2021-05-10;1269;950;0;94772;48935;0;32.8;17.0;0.0
89;2021-05-11;2550;1449;0;97322;50384;0;33.7;17.5;0.0
89;2021-05-12;2111;1201;0;99433;51585;0;34.4;17.9;0.0
89;2021-05-13;542;318;0;99975;51903;0;34.6;18.0;0.0
89;2021-05-14;1957;1041;0;101932;52944;0;35.3;18.3;0.0
89;2021-05-15;2034;374;0;103966;53318;0;36.0;18.5;0.0
89;2021-05-16;109;50;0;104075;53368;0;36.1;18.5;0.0
89;2021-05-17;2169;631;0;106244;53999;0;36.8;18.7;0.0
89;2021-05-18;2428;831;0;108672;54830;0;37.6;19.0;0.0
89;2021-05-19;2880;878;0;111552;55708;0;38.6;19.3;0.0
89;2021-05-20;2962;883;0;114514;56591;0;39.7;19.6;0.0
89;2021-05-21;2503;854;0;117017;57445;0;40.5;19.9;0.0
89;2021-05-22;1396;565;0;118413;58010;0;41.0;20.1;0.0
89;2021-05-23;215;15;0;118628;58025;0;41.1;20.1;0.0
89;2021-05-24;443;220;0;119071;58245;0;41.3;20.2;0.0
89;2021-05-25;1650;971;0;120721;59216;0;41.8;20.5;0.0
89;2021-05-26;1860;1005;0;122581;60221;0;42.5;20.9;0.0
89;2021-05-27;2194;1329;0;124775;61550;0;43.2;21.3;0.0
89;2021-05-28;2132;1387;0;126907;62937;0;44.0;21.8;0.0
89;2021-05-29;687;651;0;127594;63588;0;44.2;22.0;0.0
89;2021-05-30;87;29;0;127681;63617;0;44.2;22.0;0.0
89;2021-05-31;1379;964;0;129060;64581;0;44.7;22.4;0.0
89;2021-06-01;1697;982;0;130757;65563;0;45.3;22.7;0.0
89;2021-06-02;2065;1231;0;132822;66794;0;46.0;23.1;0.0
89;2021-06-03;2446;1467;0;135268;68261;0;46.9;23.6;0.0
89;2021-06-04;2272;1834;0;137540;70095;0;47.6;24.3;0.0
89;2021-06-05;1258;1196;0;138798;71291;0;48.1;24.7;0.0
89;2021-06-06;98;69;0;138896;71360;0;48.1;24.7;0.0
89;2021-06-07;2143;1440;0;141039;72800;0;48.9;25.2;0.0
89;2021-06-08;2236;1484;0;143275;74284;0;49.6;25.7;0.0
89;2021-06-09;2294;1473;0;145569;75757;0;50.4;26.2;0.0
89;2021-06-10;2800;1637;0;148369;77394;0;51.4;26.8;0.0
89;2021-06-11;2002;1728;0;150371;79122;0;52.1;27.4;0.0
89;2021-06-12;1040;797;0;151411;79919;0;52.5;27.7;0.0
89;2021-06-13;197;432;0;151608;80351;0;52.5;27.8;0.0
89;2021-06-14;1364;1764;0;152972;82115;0;53.0;28.4;0.0
89;2021-06-15;1454;1969;0;154426;84084;0;53.5;29.1;0.0
89;2021-06-16;1159;2547;0;155585;86631;0;53.9;30.0;0.0
89;2021-06-17;1472;2366;0;157057;88997;0;54.4;30.8;0.0
89;2021-06-18;1623;2811;0;158680;91808;0;55.0;31.8;0.0
89;2021-06-19;720;1631;0;159400;93439;0;55.2;32.4;0.0
89;2021-06-20;71;161;0;159471;93600;0;55.2;32.4;0.0
89;2021-06-21;774;1564;0;160245;95164;0;55.5;33.0;0.0
89;2021-06-22;1080;2724;0;161325;97888;0;55.9;33.9;0.0
89;2021-06-23;1174;1891;0;162499;99779;0;56.3;34.6;0.0
89;2021-06-24;1116;1623;0;163615;101402;0;56.7;35.1;0.0
89;2021-06-25;982;2508;0;164597;103910;0;57.0;36.0;0.0
89;2021-06-26;605;2279;0;165202;106189;0;57.2;36.8;0.0
89;2021-06-27;42;90;0;165244;106279;0;57.2;36.8;0.0
89;2021-06-28;971;2545;0;166215;108824;0;57.6;37.7;0.0
89;2021-06-29;704;2548;0;166919;111372;0;57.8;38.6;0.0
89;2021-06-30;1056;3194;0;167975;114566;0;58.2;39.7;0.0
89;2021-07-01;979;2981;0;168954;117547;0;58.5;40.7;0.0
89;2021-07-02;1197;2759;0;170151;120306;0;58.9;41.7;0.0
89;2021-07-03;585;1585;0;170736;121891;0;59.1;42.2;0.0
89;2021-07-04;35;143;0;170771;122034;0;59.2;42.3;0.0
89;2021-07-05;1280;1877;0;172051;123911;0;59.6;42.9;0.0
89;2021-07-06;1060;2337;0;173111;126248;0;60.0;43.7;0.0
89;2021-07-07;707;1867;0;173818;128115;0;60.2;44.4;0.0
89;2021-07-08;849;1999;0;174667;130114;0;60.5;45.1;0.0
89;2021-07-09;1173;2577;0;175840;132691;0;60.9;46.0;0.0
89;2021-07-10;739;1025;0;176579;133716;0;61.2;46.3;0.0
89;2021-07-11;68;116;0;176647;133832;0;61.2;46.4;0.0
89;2021-07-12;1334;1999;0;177981;135831;0;61.7;47.1;0.0
89;2021-07-13;2095;2804;0;180076;138635;0;62.4;48.0;0.0
89;2021-07-14;433;450;0;180509;139085;0;62.5;48.2;0.0
89;2021-07-15;2210;3244;0;182719;142329;0;63.3;49.3;0.0
89;2021-07-16;2360;2938;0;185079;145267;0;64.1;50.3;0.0
89;2021-07-17;1280;1361;0;186359;146628;0;64.6;50.8;0.0
89;2021-07-18;336;171;0;186695;146799;0;64.7;50.9;0.0
89;2021-07-19;1635;2835;0;188330;149634;0;65.2;51.8;0.0
89;2021-07-20;2076;3335;0;190406;152969;0;66.0;53.0;0.0
89;2021-07-21;2086;2683;0;192492;155652;0;66.7;53.9;0.0
89;2021-07-22;2597;2970;0;195089;158622;0;67.6;55.0;0.0
89;2021-07-23;2542;3092;0;197631;161714;0;68.5;56.0;0.0
89;2021-07-24;1270;1237;0;198901;162951;0;68.9;56.5;0.0
89;2021-07-25;219;231;0;199120;163182;0;69.0;56.5;0.0
89;2021-07-26;1781;2313;0;200901;165495;0;69.6;57.3;0.0
89;2021-07-27;2494;1953;0;203395;167448;0;70.5;58.0;0.0
89;2021-07-28;2572;1423;0;205967;168871;0;71.4;58.5;0.0
89;2021-07-29;2600;1627;0;208567;170498;0;72.3;59.1;0.0
89;2021-07-30;2612;1657;0;211179;172155;0;73.2;59.6;0.0
89;2021-07-31;1172;1099;0;212351;173254;0;73.6;60.0;0.0
89;2021-08-01;175;68;0;212526;173322;0;73.6;60.0;0.0
89;2021-08-02;1848;1346;0;214374;174668;0;74.3;60.5;0.0
89;2021-08-03;2402;1297;0;216776;175965;0;75.1;61.0;0.0
89;2021-08-04;1507;1609;0;218283;177574;0;75.6;61.5;0.0
89;2021-08-05;1507;1665;0;219790;179239;0;76.1;62.1;0.0
89;2021-08-06;2088;1673;0;221878;180912;0;76.9;62.7;0.0
89;2021-08-07;927;1195;0;222805;182107;0;77.2;63.1;0.0
89;2021-08-08;94;103;0;222899;182210;0;77.2;63.1;0.0
89;2021-08-09;1093;1341;0;223992;183551;0;77.6;63.6;0.0
89;2021-08-10;1691;1849;0;225683;185400;0;78.2;64.2;0.0
89;2021-08-11;1468;1613;0;227151;187013;0;78.7;64.8;0.0
89;2021-08-12;1340;1450;0;228491;188463;0;79.2;65.3;0.0
89;2021-08-13;1232;1975;0;229723;190438;0;79.6;66.0;0.0
89;2021-08-14;519;1116;0;230242;191554;0;79.8;66.4;0.0
89;2021-08-15;38;109;0;230280;191663;0;79.8;66.4;0.0
89;2021-08-16;1015;2046;0;231295;193709;0;80.1;67.1;0.0
89;2021-08-17;801;1701;0;232096;195410;0;80.4;67.7;0.0
89;2021-08-18;615;1941;0;232711;197351;0;80.6;68.4;0.0
89;2021-08-19;698;1448;0;233409;198799;0;80.9;68.9;0.0
89;2021-08-20;1009;2206;0;234418;201005;0;81.2;69.6;0.0
89;2021-08-21;310;1159;0;234728;202164;0;81.3;70.0;0.0
89;2021-08-22;42;139;0;234770;202303;0;81.3;70.1;0.0
89;2021-08-23;739;2250;0;235509;204553;0;81.6;70.9;0.0
89;2021-08-24;842;2439;0;236351;206992;0;81.9;71.7;0.0
89;2021-08-25;576;1542;0;236927;208534;0;82.1;72.2;0.0
89;2021-08-26;588;2022;0;237515;210556;0;82.3;72.9;0.0
89;2021-08-27;782;2232;0;238297;212788;0;82.6;73.7;0.0
89;2021-08-28;381;1372;0;238678;214160;0;82.7;74.2;0.0
89;2021-08-29;21;148;0;238699;214308;0;82.7;74.2;0.0
89;2021-08-30;587;2189;25;239286;216497;25;82.9;75.0;0.0
89;2021-08-31;576;1587;40;239862;218084;65;83.1;75.6;0.0
89;2021-09-01;545;1360;82;240407;219444;147;83.3;76.0;0.1
89;2021-09-02;466;1386;151;240873;220830;298;83.4;76.5;0.1
89;2021-09-03;594;1882;181;241467;222712;479;83.7;77.2;0.2
89;2021-09-04;461;954;56;241928;223666;535;83.8;77.5;0.2
89;2021-09-05;27;35;7;241955;223701;542;83.8;77.5;0.2
89;2021-09-06;394;1484;295;242349;225185;837;84.0;78.0;0.3
89;2021-09-07;356;943;236;242705;226128;1073;84.1;78.3;0.4
89;2021-09-08;345;904;173;243050;227032;1246;84.2;78.7;0.4
89;2021-09-09;275;832;132;243325;227864;1378;84.3;78.9;0.5
89;2021-09-10;461;1338;174;243786;229202;1552;84.5;79.4;0.5
89;2021-09-11;295;790;61;244081;229992;1613;84.6;79.7;0.6
89;2021-09-12;14;56;10;244095;230048;1623;84.6;79.7;0.6
89;2021-09-13;380;1027;231;244475;231075;1854;84.7;80.1;0.6
89;2021-09-14;379;663;218;244854;231738;2072;84.8;80.3;0.7
89;2021-09-15;253;728;164;245107;232466;2236;84.9;80.5;0.8
89;2021-09-16;251;544;414;245358;233010;2650;85.0;80.7;0.9
89;2021-09-17;476;1038;344;245834;234048;2994;85.2;81.1;1.0
89;2021-09-18;182;745;92;246016;234793;3086;85.2;81.3;1.1
89;2021-09-19;9;23;12;246025;234816;3098;85.2;81.3;1.1
89;2021-09-20;253;669;381;246278;235485;3479;85.3;81.6;1.2
89;2021-09-21;300;455;466;246578;235940;3945;85.4;81.7;1.4
89;2021-09-22;205;601;261;246783;236541;4206;85.5;81.9;1.5
89;2021-09-23;220;420;274;247003;236961;4480;85.6;82.1;1.6
89;2021-09-24;299;820;322;247302;237781;4802;85.7;82.4;1.7
89;2021-09-25;112;483;75;247414;238264;4877;85.7;82.5;1.7
89;2021-09-26;8;29;5;247422;238293;4882;85.7;82.6;1.7
89;2021-09-27;180;439;378;247602;238732;5260;85.8;82.7;1.8
89;2021-09-28;235;367;309;247837;239099;5569;85.9;82.8;1.9
89;2021-09-29;201;372;312;248038;239471;5881;85.9;83.0;2.0
89;2021-09-30;151;406;327;248189;239877;6208;86.0;83.1;2.2
89;2021-10-01;296;495;380;248485;240372;6588;86.1;83.3;2.3
89;2021-10-02;141;355;84;248626;240727;6672;86.1;83.4;2.3
89;2021-10-03;7;21;5;248633;240748;6677;86.1;83.4;2.3
89;2021-10-04;126;388;329;248759;241136;7006;86.2;83.5;2.4
89;2021-10-05;149;430;328;248908;241566;7334;86.2;83.7;2.5
89;2021-10-06;231;422;434;249139;241988;7768;86.3;83.8;2.7
89;2021-10-07;83;322;385;249222;242310;8153;86.3;83.9;2.8
89;2021-10-08;226;524;494;249448;242834;8647;86.4;84.1;3.0
89;2021-10-09;126;251;173;249574;243085;8820;86.5;84.2;3.1
89;2021-10-10;1;9;7;249575;243094;8827;86.5;84.2;3.1
89;2021-10-11;137;295;276;249712;243389;9103;86.5;84.3;3.2
89;2021-10-12;116;228;432;249828;243617;9535;86.5;84.4;3.3
89;2021-10-13;162;257;397;249990;243874;9932;86.6;84.5;3.4
89;2021-10-14;120;241;397;250110;244115;10329;86.6;84.6;3.6
89;2021-10-15;208;417;518;250318;244532;10847;86.7;84.7;3.8
89;2021-10-16;119;137;153;250437;244669;11000;86.8;84.8;3.8
89;2021-10-17;5;12;31;250442;244681;11031;86.8;84.8;3.8
89;2021-10-18;120;245;399;250562;244926;11430;86.8;84.9;4.0
89;2021-10-19;141;239;545;250703;245165;11975;86.9;84.9;4.1
89;2021-10-20;103;267;640;250806;245432;12615;86.9;85.0;4.4
89;2021-10-21;106;157;548;250912;245589;13163;86.9;85.1;4.6
89;2021-10-22;227;321;586;251139;245910;13749;87.0;85.2;4.8
89;2021-10-23;105;149;304;251244;246059;14053;87.0;85.2;4.9
89;2021-10-24;1;9;3;251245;246068;14056;87.0;85.2;4.9
89;2021-10-25;101;143;569;251346;246211;14625;87.1;85.3;5.1
89;2021-10-26;97;134;620;251443;246345;15245;87.1;85.3;5.3
89;2021-10-27;138;215;784;251581;246560;16029;87.2;85.4;5.6
89;2021-10-28;74;118;735;251655;246678;16764;87.2;85.5;5.8
89;2021-10-29;134;220;707;251789;246898;17471;87.2;85.5;6.1
89;2021-10-30;73;115;345;251862;247013;17816;87.3;85.6;6.2
89;2021-10-31;5;12;18;251867;247025;17834;87.3;85.6;6.2
89;2021-11-01;6;8;12;251873;247033;17846;87.3;85.6;6.2
89;2021-11-02;104;155;609;251977;247188;18455;87.3;85.6;6.4
89;2021-11-03;129;222;946;252106;247410;19401;87.3;85.7;6.7
89;2021-11-04;85;109;588;252191;247519;19989;87.4;85.7;6.9
89;2021-11-05;164;229;951;252355;247748;20940;87.4;85.8;7.3
89;2021-11-06;60;146;409;252415;247894;21349;87.4;85.9;7.4
89;2021-11-07;1;9;18;252416;247903;21367;87.4;85.9;7.4
89;2021-11-08;120;99;868;252536;248002;22235;87.5;85.9;7.7
89;2021-11-09;99;126;933;252635;248128;23168;87.5;86.0;8.0
89;2021-11-10;142;163;1199;252777;248291;24367;87.6;86.0;8.4
89;2021-11-11;6;11;43;252783;248302;24410;87.6;86.0;8.5
89;2021-11-12;115;189;1038;252898;248491;25448;87.6;86.1;8.8
89;2021-11-13;59;138;650;252957;248629;26098;87.6;86.1;9.0
89;2021-11-14;4;13;30;252961;248642;26128;87.6;86.1;9.1
89;2021-11-15;101;125;1119;253062;248767;27247;87.7;86.2;9.4
89;2021-11-16;103;126;1233;253165;248893;28480;87.7;86.2;9.9
89;2021-11-17;143;168;1157;253308;249061;29637;87.8;86.3;10.3
89;2021-11-18;62;86;768;253370;249147;30405;87.8;86.3;10.5
89;2021-11-19;144;206;1344;253514;249353;31749;87.8;86.4;11.0
89;2021-11-20;101;130;746;253615;249483;32495;87.9;86.4;11.3
89;2021-11-21;10;15;40;253625;249498;32535;87.9;86.4;11.3
89;2021-11-22;115;92;1325;253740;249590;33860;87.9;86.5;11.7
89;2021-11-23;97;104;1303;253837;249694;35163;87.9;86.5;12.2
89;2021-11-24;149;119;1262;253986;249813;36425;88.0;86.5;12.6
89;2021-11-25;100;123;1424;254086;249936;37849;88.0;86.6;13.1
89;2021-11-26;125;159;1925;254211;250095;39774;88.1;86.6;13.8
89;2021-11-27;105;115;1081;254316;250210;40855;88.1;86.7;14.2
89;2021-11-28;2;18;79;254318;250228;40934;88.1;86.7;14.2
89;2021-11-29;103;130;1859;254421;250358;42793;88.1;86.7;14.8
89;2021-11-30;105;125;2337;254526;250483;45130;88.2;86.8;15.6
89;2021-12-01;110;132;2480;254636;250615;47610;88.2;86.8;16.5
89;2021-12-02;81;61;2314;254717;250676;49924;88.2;86.8;17.3
89;2021-12-03;106;125;2898;254823;250801;52822;88.3;86.9;18.3
89;2021-12-04;42;92;1824;254865;250893;54646;88.3;86.9;18.9
89;2021-12-05;5;8;108;254870;250901;54754;88.3;86.9;19.0
89;2021-12-06;78;97;3374;254948;250998;58128;88.3;87.0;20.1
89;2021-12-07;111;113;3567;255059;251111;61695;88.4;87.0;21.4
89;2021-12-08;108;107;3159;255167;251218;64854;88.4;87.0;22.5
89;2021-12-09;116;85;3396;255283;251303;68250;88.4;87.1;23.6
89;2021-12-10;118;157;4010;255401;251460;72260;88.5;87.1;25.0
89;2021-12-11;62;120;2712;255463;251580;74972;88.5;87.2;26.0
89;2021-12-12;10;12;238;255473;251592;75210;88.5;87.2;26.1
89;2021-12-13;108;142;3800;255581;251734;79010;88.5;87.2;27.4
89;2021-12-14;109;126;5066;255690;251860;84076;88.6;87.3;29.1
89;2021-12-15;105;159;3654;255795;252019;87730;88.6;87.3;30.4
89;2021-12-16;109;127;4113;255904;252146;91843;88.7;87.4;31.8
89;2021-12-17;116;140;3684;256020;252286;95527;88.7;87.4;33.1
89;2021-12-18;90;140;2744;256110;252426;98271;88.7;87.4;34.0
89;2021-12-19;37;17;1152;256147;252443;99423;88.7;87.5;34.4
90;2020-12-27;0;0;0;0;0;0;0.0;0.0;0.0
90;2020-12-28;0;0;0;0;0;0;0.0;0.0;0.0
90;2020-12-29;0;0;0;0;0;0;0.0;0.0;0.0
90;2020-12-30;1;0;0;1;0;0;0.0;0.0;0.0
90;2020-12-31;0;0;0;1;0;0;0.0;0.0;0.0
90;2021-01-01;0;0;0;1;0;0;0.0;0.0;0.0
90;2021-01-02;1;0;0;2;0;0;0.0;0.0;0.0
90;2021-01-03;0;0;0;2;0;0;0.0;0.0;0.0
90;2021-01-04;4;0;0;6;0;0;0.0;0.0;0.0
90;2021-01-05;0;0;0;6;0;0;0.0;0.0;0.0
90;2021-01-06;6;0;0;12;0;0;0.0;0.0;0.0
90;2021-01-07;10;0;0;22;0;0;0.0;0.0;0.0
90;2021-01-08;93;0;0;115;0;0;0.1;0.0;0.0
90;2021-01-09;34;0;0;149;0;0;0.1;0.0;0.0
90;2021-01-10;0;0;0;149;0;0;0.1;0.0;0.0
90;2021-01-11;136;0;0;285;0;0;0.2;0.0;0.0
90;2021-01-12;335;0;0;620;0;0;0.5;0.0;0.0
90;2021-01-13;358;2;0;978;2;0;0.8;0.0;0.0
90;2021-01-14;310;2;0;1288;4;0;1.1;0.0;0.0
90;2021-01-15;299;7;0;1587;11;0;1.3;0.0;0.0
90;2021-01-16;77;2;0;1664;13;0;1.4;0.0;0.0
90;2021-01-17;1;0;0;1665;13;0;1.4;0.0;0.0
90;2021-01-18;278;1;0;1943;14;0;1.6;0.0;0.0
90;2021-01-19;358;5;0;2301;19;0;1.9;0.0;0.0
90;2021-01-20;318;2;0;2619;21;0;2.2;0.0;0.0
90;2021-01-21;301;1;0;2920;22;0;2.4;0.0;0.0
90;2021-01-22;335;1;0;3255;23;0;2.7;0.0;0.0
90;2021-01-23;118;0;0;3373;23;0;2.8;0.0;0.0
90;2021-01-24;2;0;0;3375;23;0;2.8;0.0;0.0
90;2021-01-25;287;3;0;3662;26;0;3.0;0.0;0.0
90;2021-01-26;259;2;0;3921;28;0;3.2;0.0;0.0
90;2021-01-27;267;4;0;4188;32;0;3.5;0.0;0.0
90;2021-01-28;301;24;0;4489;56;0;3.7;0.0;0.0
90;2021-01-29;245;89;0;4734;145;0;3.9;0.1;0.0
90;2021-01-30;134;23;0;4868;168;0;4.0;0.1;0.0
90;2021-01-31;111;0;0;4979;168;0;4.1;0.1;0.0
90;2021-02-01;254;62;0;5233;230;0;4.3;0.2;0.0
90;2021-02-02;271;99;0;5504;329;0;4.5;0.3;0.0
90;2021-02-03;233;271;0;5737;600;0;4.7;0.5;0.0
90;2021-02-04;235;218;0;5972;818;0;4.9;0.7;0.0
90;2021-02-05;225;224;0;6197;1042;0;5.1;0.9;0.0
90;2021-02-06;83;49;0;6280;1091;0;5.2;0.9;0.0
90;2021-02-07;2;0;0;6282;1091;0;5.2;0.9;0.0
90;2021-02-08;161;155;0;6443;1246;0;5.3;1.0;0.0
90;2021-02-09;117;112;0;6560;1358;0;5.4;1.1;0.0
90;2021-02-10;177;36;0;6737;1394;0;5.6;1.2;0.0
90;2021-02-11;164;93;0;6901;1487;0;5.7;1.2;0.0
90;2021-02-12;129;214;0;7030;1701;0;5.8;1.4;0.0
90;2021-02-13;83;42;0;7113;1743;0;5.9;1.4;0.0
90;2021-02-14;0;1;0;7113;1744;0;5.9;1.4;0.0
90;2021-02-15;118;210;0;7231;1954;0;6.0;1.6;0.0
90;2021-02-16;100;200;0;7331;2154;0;6.1;1.8;0.0
90;2021-02-17;145;181;0;7476;2335;0;6.2;1.9;0.0
90;2021-02-18;128;256;0;7604;2591;0;6.3;2.1;0.0
90;2021-02-19;81;257;0;7685;2848;0;6.3;2.4;0.0
90;2021-02-20;44;92;0;7729;2940;0;6.4;2.4;0.0
90;2021-02-21;0;1;0;7729;2941;0;6.4;2.4;0.0
90;2021-02-22;46;295;0;7775;3236;0;6.4;2.7;0.0
90;2021-02-23;49;247;0;7824;3483;0;6.5;2.9;0.0
90;2021-02-24;79;268;0;7903;3751;0;6.5;3.1;0.0
90;2021-02-25;89;304;0;7992;4055;0;6.6;3.3;0.0
90;2021-02-26;95;318;0;8087;4373;0;6.7;3.6;0.0
90;2021-02-27;140;155;0;8227;4528;0;6.8;3.7;0.0
90;2021-02-28;7;106;0;8234;4634;0;6.8;3.8;0.0
90;2021-03-01;150;206;0;8384;4840;0;6.9;4.0;0.0
90;2021-03-02;182;263;0;8566;5103;0;7.1;4.2;0.0
90;2021-03-03;227;299;0;8793;5402;0;7.3;4.5;0.0
90;2021-03-04;225;244;0;9018;5646;0;7.4;4.7;0.0
90;2021-03-05;338;248;0;9356;5894;0;7.7;4.9;0.0
90;2021-03-06;261;98;0;9617;5992;0;7.9;4.9;0.0
90;2021-03-07;27;2;0;9644;5994;0;8.0;4.9;0.0
90;2021-03-08;186;228;0;9830;6222;0;8.1;5.1;0.0
90;2021-03-09;360;146;0;10190;6368;0;8.4;5.3;0.0
90;2021-03-10;323;182;0;10513;6550;0;8.7;5.4;0.0
90;2021-03-11;314;133;0;10827;6683;0;8.9;5.5;0.0
90;2021-03-12;486;130;0;11313;6813;0;9.3;5.6;0.0
90;2021-03-13;491;51;0;11804;6864;0;9.7;5.7;0.0
90;2021-03-14;53;0;0;11857;6864;0;9.8;5.7;0.0
90;2021-03-15;390;121;0;12247;6985;0;10.1;5.8;0.0
90;2021-03-16;421;103;0;12668;7088;0;10.5;5.9;0.0
90;2021-03-17;306;73;0;12974;7161;0;10.7;5.9;0.0
90;2021-03-18;321;80;0;13295;7241;0;11.0;6.0;0.0
90;2021-03-19;432;80;0;13727;7321;0;11.3;6.0;0.0
90;2021-03-20;404;49;0;14131;7370;0;11.7;6.1;0.0
90;2021-03-21;3;0;0;14134;7370;0;11.7;6.1;0.0
90;2021-03-22;334;34;0;14468;7404;0;11.9;6.1;0.0
90;2021-03-23;660;73;0;15128;7477;0;12.5;6.2;0.0
90;2021-03-24;737;50;0;15865;7527;0;13.1;6.2;0.0
90;2021-03-25;812;66;0;16677;7593;0;13.8;6.3;0.0
90;2021-03-26;1056;46;0;17733;7639;0;14.6;6.3;0.0
90;2021-03-27;337;24;0;18070;7663;0;14.9;6.3;0.0
90;2021-03-28;35;0;0;18105;7663;0;14.9;6.3;0.0
90;2021-03-29;604;146;0;18709;7809;0;15.4;6.4;0.0
90;2021-03-30;584;143;0;19293;7952;0;15.9;6.6;0.0
90;2021-03-31;631;90;0;19924;8042;0;16.4;6.6;0.0
90;2021-04-01;490;120;0;20414;8162;0;16.9;6.7;0.0
90;2021-04-02;543;103;0;20957;8265;0;17.3;6.8;0.0
90;2021-04-03;299;34;0;21256;8299;0;17.5;6.9;0.0
90;2021-04-04;3;2;0;21259;8301;0;17.5;6.9;0.0
90;2021-04-05;3;0;0;21262;8301;0;17.6;6.9;0.0
90;2021-04-06;520;234;0;21782;8535;0;18.0;7.0;0.0
90;2021-04-07;402;228;0;22184;8763;0;18.3;7.2;0.0
90;2021-04-08;469;206;0;22653;8969;0;18.7;7.4;0.0
90;2021-04-09;658;207;0;23311;9176;0;19.2;7.6;0.0
90;2021-04-10;240;39;0;23551;9215;0;19.4;7.6;0.0
90;2021-04-11;9;38;0;23560;9253;0;19.4;7.6;0.0
90;2021-04-12;423;421;0;23983;9674;0;19.8;8.0;0.0
90;2021-04-13;470;463;0;24453;10137;0;20.2;8.4;0.0
90;2021-04-14;418;329;0;24871;10466;0;20.5;8.6;0.0
90;2021-04-15;737;267;0;25608;10733;0;21.1;8.9;0.0
90;2021-04-16;332;349;0;25940;11082;0;21.4;9.1;0.0
90;2021-04-17;147;84;0;26087;11166;0;21.5;9.2;0.0
90;2021-04-18;18;4;0;26105;11170;0;21.5;9.2;0.0
90;2021-04-19;372;485;0;26477;11655;0;21.9;9.6;0.0
90;2021-04-20;435;550;0;26912;12205;0;22.2;10.1;0.0
90;2021-04-21;327;478;0;27239;12683;0;22.5;10.5;0.0
90;2021-04-22;471;489;0;27710;13172;0;22.9;10.9;0.0
90;2021-04-23;437;598;0;28147;13770;0;23.2;11.4;0.0
90;2021-04-24;231;119;0;28378;13889;0;23.4;11.5;0.0
90;2021-04-25;11;1;0;28389;13890;0;23.4;11.5;0.0
90;2021-04-26;398;595;0;28787;14485;0;23.8;12.0;0.0
90;2021-04-27;563;524;0;29350;15009;0;24.2;12.4;0.0
90;2021-04-28;645;420;0;29995;15429;0;24.8;12.7;0.0
90;2021-04-29;884;355;0;30879;15784;0;25.5;13.0;0.0
90;2021-04-30;939;367;0;31818;16151;0;26.3;13.3;0.0
90;2021-05-01;131;45;0;31949;16196;0;26.4;13.4;0.0
90;2021-05-02;28;1;0;31977;16197;0;26.4;13.4;0.0
90;2021-05-03;837;278;0;32814;16475;0;27.1;13.6;0.0
90;2021-05-04;738;562;0;33552;17037;0;27.7;14.1;0.0
90;2021-05-05;837;472;0;34389;17509;0;28.4;14.5;0.0
90;2021-05-06;787;489;0;35176;17998;0;29.0;14.9;0.0
90;2021-05-07;487;428;0;35663;18426;0;29.4;15.2;0.0
90;2021-05-08;55;31;0;35718;18457;0;29.5;15.2;0.0
90;2021-05-09;23;30;0;35741;18487;0;29.5;15.3;0.0
90;2021-05-10;593;440;0;36334;18927;0;30.0;15.6;0.0
90;2021-05-11;850;521;0;37184;19448;0;30.7;16.1;0.0
90;2021-05-12;710;551;0;37894;19999;0;31.3;16.5;0.0
90;2021-05-13;1253;234;0;39147;20233;0;32.3;16.7;0.0
90;2021-05-14;1037;369;0;40184;20602;0;33.2;17.0;0.0
90;2021-05-15;280;125;0;40464;20727;0;33.4;17.1;0.0
90;2021-05-16;41;10;0;40505;20737;0;33.4;17.1;0.0
90;2021-05-17;958;286;0;41463;21023;0;34.2;17.4;0.0
90;2021-05-18;1270;398;0;42733;21421;0;35.3;17.7;0.0
90;2021-05-19;1482;347;0;44215;21768;0;36.5;18.0;0.0
90;2021-05-20;1427;267;0;45642;22035;0;37.7;18.2;0.0
90;2021-05-21;1427;427;0;47069;22462;0;38.9;18.5;0.0
90;2021-05-22;322;145;0;47391;22607;0;39.1;18.7;0.0
90;2021-05-23;12;1;0;47403;22608;0;39.1;18.7;0.0
90;2021-05-24;338;224;0;47741;22832;0;39.4;18.8;0.0
90;2021-05-25;739;676;0;48480;23508;0;40.0;19.4;0.0
90;2021-05-26;885;501;0;49365;24009;0;40.7;19.8;0.0
90;2021-05-27;1177;368;0;50542;24377;0;41.7;20.1;0.0
90;2021-05-28;826;695;0;51368;25072;0;42.4;20.7;0.0
90;2021-05-29;183;291;0;51551;25363;0;42.6;20.9;0.0
90;2021-05-30;7;1;0;51558;25364;0;42.6;20.9;0.0
90;2021-05-31;906;538;0;52464;25902;0;43.3;21.4;0.0
90;2021-06-01;944;575;0;53408;26477;0;44.1;21.9;0.0
90;2021-06-02;770;544;0;54178;27021;0;44.7;22.3;0.0
90;2021-06-03;793;576;0;54971;27597;0;45.4;22.8;0.0
90;2021-06-04;865;823;0;55836;28420;0;46.1;23.5;0.0
90;2021-06-05;121;404;0;55957;28824;0;46.2;23.8;0.0
90;2021-06-06;33;19;0;55990;28843;0;46.2;23.8;0.0
90;2021-06-07;1095;935;0;57085;29778;0;47.1;24.6;0.0
90;2021-06-08;1319;821;0;58404;30599;0;48.2;25.3;0.0
90;2021-06-09;880;599;0;59284;31198;0;48.9;25.8;0.0
90;2021-06-10;647;472;0;59931;31670;0;49.5;26.1;0.0
90;2021-06-11;753;990;0;60684;32660;0;50.1;27.0;0.0
90;2021-06-12;687;350;0;61371;33010;0;50.7;27.2;0.0
90;2021-06-13;22;20;0;61393;33030;0;50.7;27.3;0.0
90;2021-06-14;280;918;0;61673;33948;0;50.9;28.0;0.0
90;2021-06-15;536;899;0;62209;34847;0;51.4;28.8;0.0
90;2021-06-16;517;606;0;62726;35453;0;51.8;29.3;0.0
90;2021-06-17;408;571;0;63134;36024;0;52.1;29.7;0.0
90;2021-06-18;574;983;0;63708;37007;0;52.6;30.5;0.0
90;2021-06-19;414;233;0;64122;37240;0;52.9;30.7;0.0
90;2021-06-20;9;47;0;64131;37287;0;52.9;30.8;0.0
90;2021-06-21;288;1240;0;64419;38527;0;53.2;31.8;0.0
90;2021-06-22;347;1072;0;64766;39599;0;53.5;32.7;0.0
90;2021-06-23;377;783;0;65143;40382;0;53.8;33.3;0.0
90;2021-06-24;323;756;0;65466;41138;0;54.0;34.0;0.0
90;2021-06-25;401;1344;0;65867;42482;0;54.4;35.1;0.0
90;2021-06-26;388;762;0;66255;43244;0;54.7;35.7;0.0
90;2021-06-27;13;42;0;66268;43286;0;54.7;35.7;0.0
90;2021-06-28;361;1419;0;66629;44705;0;55.0;36.9;0.0
90;2021-06-29;292;1497;0;66921;46202;0;55.2;38.1;0.0
90;2021-06-30;453;1346;0;67374;47548;0;55.6;39.2;0.0
90;2021-07-01;348;1029;0;67722;48577;0;55.9;40.1;0.0
90;2021-07-02;543;1301;0;68265;49878;0;56.3;41.2;0.0
90;2021-07-03;87;296;0;68352;50174;0;56.4;41.4;0.0
90;2021-07-04;13;46;0;68365;50220;0;56.4;41.5;0.0
90;2021-07-05;399;947;0;68764;51167;0;56.8;42.2;0.0
90;2021-07-06;481;1120;0;69245;52287;0;57.2;43.2;0.0
90;2021-07-07;372;1176;0;69617;53463;0;57.5;44.1;0.0
90;2021-07-08;308;714;0;69925;54177;0;57.7;44.7;0.0
90;2021-07-09;439;1049;0;70364;55226;0;58.1;45.6;0.0
90;2021-07-10;82;229;0;70446;55455;0;58.1;45.8;0.0
90;2021-07-11;18;22;0;70464;55477;0;58.2;45.8;0.0
90;2021-07-12;262;1158;0;70726;56635;0;58.4;46.7;0.0
90;2021-07-13;511;1211;0;71237;57846;0;58.8;47.7;0.0
90;2021-07-14;106;60;0;71343;57906;0;58.9;47.8;0.0
90;2021-07-15;724;1331;0;72067;59237;0;59.5;48.9;0.0
90;2021-07-16;754;1493;0;72821;60730;0;60.1;50.1;0.0
90;2021-07-17;388;825;0;73209;61555;0;60.4;50.8;0.0
90;2021-07-18;78;42;0;73287;61597;0;60.5;50.8;0.0
90;2021-07-19;945;1263;0;74232;62860;0;61.3;51.9;0.0
90;2021-07-20;1082;1051;0;75314;63911;0;62.2;52.8;0.0
90;2021-07-21;1149;868;0;76463;64779;0;63.1;53.5;0.0
90;2021-07-22;1015;671;0;77478;65450;0;64.0;54.0;0.0
90;2021-07-23;928;1008;0;78406;66458;0;64.7;54.9;0.0
90;2021-07-24;196;133;0;78602;66591;0;64.9;55.0;0.0
90;2021-07-25;47;32;0;78649;66623;0;64.9;55.0;0.0
90;2021-07-26;954;751;0;79603;67374;0;65.7;55.6;0.0
90;2021-07-27;958;702;0;80561;68076;0;66.5;56.2;0.0
90;2021-07-28;839;597;0;81400;68673;0;67.2;56.7;0.0
90;2021-07-29;894;472;0;82294;69145;0;67.9;57.1;0.0
90;2021-07-30;860;569;0;83154;69714;0;68.6;57.5;0.0
90;2021-07-31;493;302;0;83647;70016;0;69.0;57.8;0.0
90;2021-08-01;38;27;0;83685;70043;0;69.1;57.8;0.0
90;2021-08-02;852;511;0;84537;70554;0;69.8;58.2;0.0
90;2021-08-03;863;509;0;85400;71063;0;70.5;58.7;0.0
90;2021-08-04;1040;434;0;86440;71497;0;71.4;59.0;0.0
90;2021-08-05;541;276;0;86981;71773;0;71.8;59.2;0.0
90;2021-08-06;597;431;0;87578;72204;0;72.3;59.6;0.0
90;2021-08-07;100;135;0;87678;72339;0;72.4;59.7;0.0
90;2021-08-08;36;44;0;87714;72383;0;72.4;59.7;0.0
90;2021-08-09;652;765;0;88366;73148;0;72.9;60.4;0.0
90;2021-08-10;499;989;0;88865;74137;0;73.4;61.2;0.0
90;2021-08-11;529;813;0;89394;74950;0;73.8;61.9;0.0
90;2021-08-12;397;716;0;89791;75666;0;74.1;62.5;0.0
90;2021-08-13;472;786;0;90263;76452;0;74.5;63.1;0.0
90;2021-08-14;81;170;0;90344;76622;0;74.6;63.2;0.0
90;2021-08-15;6;37;0;90350;76659;0;74.6;63.3;0.0
90;2021-08-16;411;627;0;90761;77286;0;74.9;63.8;0.0
90;2021-08-17;327;988;0;91088;78274;0;75.2;64.6;0.0
90;2021-08-18;275;849;0;91363;79123;0;75.4;65.3;0.0
90;2021-08-19;252;671;0;91615;79794;0;75.6;65.9;0.0
90;2021-08-20;341;777;0;91956;80571;0;75.9;66.5;0.0
90;2021-08-21;50;168;0;92006;80739;0;75.9;66.6;0.0
90;2021-08-22;3;36;0;92009;80775;0;75.9;66.7;0.0
90;2021-08-23;285;552;0;92294;81327;0;76.2;67.1;0.0
90;2021-08-24;295;936;0;92589;82263;0;76.4;67.9;0.0
90;2021-08-25;239;933;0;92828;83196;0;76.6;68.7;0.0
90;2021-08-26;222;678;0;93050;83874;0;76.8;69.2;0.0
90;2021-08-27;268;785;0;93318;84659;0;77.0;69.9;0.0
90;2021-08-28;41;160;0;93359;84819;0;77.1;70.0;0.0
90;2021-08-29;6;12;0;93365;84831;0;77.1;70.0;0.0
90;2021-08-30;311;653;11;93676;85484;11;77.3;70.6;0.0
90;2021-08-31;251;916;16;93927;86400;27;77.5;71.3;0.0
90;2021-09-01;288;670;141;94215;87070;168;77.8;71.9;0.1
90;2021-09-02;174;375;67;94389;87445;235;77.9;72.2;0.2
90;2021-09-03;249;535;33;94638;87980;268;78.1;72.6;0.2
90;2021-09-04;75;181;35;94713;88161;303;78.2;72.8;0.3
90;2021-09-05;10;31;2;94723;88192;305;78.2;72.8;0.3
90;2021-09-06;148;674;48;94871;88866;353;78.3;73.4;0.3
90;2021-09-07;199;511;111;95070;89377;464;78.5;73.8;0.4
90;2021-09-08;211;535;89;95281;89912;553;78.6;74.2;0.5
90;2021-09-09;186;264;65;95467;90176;618;78.8;74.4;0.5
90;2021-09-10;191;440;93;95658;90616;711;79.0;74.8;0.6
90;2021-09-11;32;39;14;95690;90655;725;79.0;74.8;0.6
90;2021-09-12;5;10;2;95695;90665;727;79.0;74.8;0.6
90;2021-09-13;219;331;156;95914;90996;883;79.2;75.1;0.7
90;2021-09-14;152;328;131;96066;91324;1014;79.3;75.4;0.8
90;2021-09-15;163;349;106;96229;91673;1120;79.4;75.7;0.9
90;2021-09-16;154;229;114;96383;91902;1234;79.6;75.9;1.0
90;2021-09-17;180;318;142;96563;92220;1376;79.7;76.1;1.1
90;2021-09-18;28;65;37;96591;92285;1413;79.7;76.2;1.2
90;2021-09-19;9;8;18;96600;92293;1431;79.7;76.2;1.2
90;2021-09-20;137;225;206;96737;92518;1637;79.9;76.4;1.4
90;2021-09-21;97;239;183;96834;92757;1820;79.9;76.6;1.5
90;2021-09-22;96;301;205;96930;93058;2025;80.0;76.8;1.7
90;2021-09-23;82;133;37;97012;93191;2062;80.1;76.9;1.7
90;2021-09-24;107;292;165;97119;93483;2227;80.2;77.2;1.8
90;2021-09-25;32;57;20;97151;93540;2247;80.2;77.2;1.9
90;2021-09-26;1;5;1;97152;93545;2248;80.2;77.2;1.9
90;2021-09-27;89;197;139;97241;93742;2387;80.3;77.4;2.0
90;2021-09-28;91;140;94;97332;93882;2481;80.3;77.5;2.0
90;2021-09-29;72;225;87;97404;94107;2568;80.4;77.7;2.1
90;2021-09-30;75;134;83;97479;94241;2651;80.5;77.8;2.2
90;2021-10-01;152;217;150;97631;94458;2801;80.6;78.0;2.3
90;2021-10-02;23;63;18;97654;94521;2819;80.6;78.0;2.3
90;2021-10-03;5;10;0;97659;94531;2819;80.6;78.0;2.3
90;2021-10-04;118;190;154;97777;94721;2973;80.7;78.2;2.5
90;2021-10-05;47;142;212;97824;94863;3185;80.7;78.3;2.6
90;2021-10-06;96;177;250;97920;95040;3435;80.8;78.5;2.8
90;2021-10-07;53;117;182;97973;95157;3617;80.9;78.5;3.0
90;2021-10-08;122;223;162;98095;95380;3779;81.0;78.7;3.1
90;2021-10-09;29;36;34;98124;95416;3813;81.0;78.8;3.1
90;2021-10-10;3;4;3;98127;95420;3816;81.0;78.8;3.1
90;2021-10-11;74;129;153;98201;95549;3969;81.1;78.9;3.3
90;2021-10-12;77;120;195;98278;95669;4164;81.1;79.0;3.4
90;2021-10-13;100;148;192;98378;95817;4356;81.2;79.1;3.6
90;2021-10-14;65;105;115;98443;95922;4471;81.3;79.2;3.7
90;2021-10-15;126;182;184;98569;96104;4655;81.4;79.3;3.8
90;2021-10-16;25;43;28;98594;96147;4683;81.4;79.4;3.9
90;2021-10-17;0;3;1;98594;96150;4684;81.4;79.4;3.9
90;2021-10-18;79;127;176;98673;96277;4860;81.4;79.5;4.0
90;2021-10-19;57;107;196;98730;96384;5056;81.5;79.6;4.2
90;2021-10-20;59;97;163;98789;96481;5219;81.5;79.6;4.3
90;2021-10-21;50;59;155;98839;96540;5374;81.6;79.7;4.4
90;2021-10-22;62;152;168;98901;96692;5542;81.6;79.8;4.6
90;2021-10-23;22;21;29;98923;96713;5571;81.7;79.8;4.6
90;2021-10-24;0;4;1;98923;96717;5572;81.7;79.8;4.6
90;2021-10-25;53;105;176;98976;96822;5748;81.7;79.9;4.7
90;2021-10-26;64;85;266;99040;96907;6014;81.8;80.0;5.0
90;2021-10-27;41;124;329;99081;97031;6343;81.8;80.1;5.2
90;2021-10-28;40;46;168;99121;97077;6511;81.8;80.1;5.4
90;2021-10-29;55;92;293;99176;97169;6804;81.9;80.2;5.6
90;2021-10-30;16;27;36;99192;97196;6840;81.9;80.2;5.6
90;2021-10-31;1;8;0;99193;97204;6840;81.9;80.2;5.6
90;2021-11-01;2;1;0;99195;97205;6840;81.9;80.2;5.6
90;2021-11-02;60;90;195;99255;97295;7035;81.9;80.3;5.8
90;2021-11-03;58;108;357;99313;97403;7392;82.0;80.4;6.1
90;2021-11-04;41;65;185;99354;97468;7577;82.0;80.5;6.3
90;2021-11-05;75;112;308;99429;97580;7885;82.1;80.5;6.5
90;2021-11-06;14;29;52;99443;97609;7937;82.1;80.6;6.6
90;2021-11-07;0;2;7;99443;97611;7944;82.1;80.6;6.6
90;2021-11-08;43;72;356;99486;97683;8300;82.1;80.6;6.9
90;2021-11-09;38;71;381;99524;97754;8681;82.2;80.7;7.2
90;2021-11-10;68;75;398;99592;97829;9079;82.2;80.8;7.5
90;2021-11-11;4;7;5;99596;97836;9084;82.2;80.8;7.5
90;2021-11-12;49;83;431;99645;97919;9515;82.3;80.8;7.9
90;2021-11-13;12;34;56;99657;97953;9571;82.3;80.9;7.9
90;2021-11-14;0;4;0;99657;97957;9571;82.3;80.9;7.9
90;2021-11-15;39;52;428;99696;98009;9999;82.3;80.9;8.3
90;2021-11-16;61;59;451;99757;98068;10450;82.3;81.0;8.6
90;2021-11-17;46;80;561;99803;98148;11011;82.4;81.0;9.1
90;2021-11-18;46;46;434;99849;98194;11445;82.4;81.1;9.4
90;2021-11-19;66;61;643;99915;98255;12088;82.5;81.1;10.0
90;2021-11-20;18;20;78;99933;98275;12166;82.5;81.1;10.0
90;2021-11-21;0;2;1;99933;98277;12167;82.5;81.1;10.0
90;2021-11-22;72;40;572;100005;98317;12739;82.5;81.2;10.5
90;2021-11-23;48;59;612;100053;98376;13351;82.6;81.2;11.0
90;2021-11-24;57;76;461;100110;98452;13812;82.6;81.3;11.4
90;2021-11-25;36;41;418;100146;98493;14230;82.7;81.3;11.7
90;2021-11-26;48;83;737;100194;98576;14967;82.7;81.4;12.4
90;2021-11-27;9;27;166;100203;98603;15133;82.7;81.4;12.5
90;2021-11-28;3;6;16;100206;98609;15149;82.7;81.4;12.5
90;2021-11-29;38;52;1141;100244;98661;16290;82.7;81.4;13.4
90;2021-11-30;47;57;1356;100291;98718;17646;82.8;81.5;14.6
90;2021-12-01;39;66;1331;100330;98784;18977;82.8;81.5;15.7
90;2021-12-02;34;30;1507;100364;98814;20484;82.8;81.6;16.9
90;2021-12-03;43;58;1695;100407;98872;22179;82.9;81.6;18.3
90;2021-12-04;29;24;634;100436;98896;22813;82.9;81.6;18.8
90;2021-12-05;3;2;99;100439;98898;22912;82.9;81.6;18.9
90;2021-12-06;35;54;1526;100474;98952;24438;82.9;81.7;20.2
90;2021-12-07;42;79;1875;100516;99031;26313;83.0;81.7;21.7
90;2021-12-08;35;61;1548;100551;99092;27861;83.0;81.8;23.0
90;2021-12-09;34;46;1521;100585;99138;29382;83.0;81.8;24.3
90;2021-12-10;52;88;1765;100637;99226;31147;83.1;81.9;25.7
90;2021-12-11;12;20;562;100649;99246;31709;83.1;81.9;26.2
90;2021-12-12;0;3;37;100649;99249;31746;83.1;81.9;26.2
90;2021-12-13;48;70;1637;100697;99319;33383;83.1;82.0;27.6
90;2021-12-14;42;66;1836;100739;99385;35219;83.2;82.0;29.1
90;2021-12-15;19;70;1342;100758;99455;36561;83.2;82.1;30.2
90;2021-12-16;46;43;1415;100804;99498;37976;83.2;82.1;31.3
90;2021-12-17;45;66;1684;100849;99564;39660;83.2;82.2;32.7
90;2021-12-18;46;24;622;100895;99588;40282;83.3;82.2;33.3
90;2021-12-19;1;9;42;100896;99597;40324;83.3;82.2;33.3
91;2020-12-27;1;0;0;1;0;0;0.0;0.0;0.0
91;2020-12-28;0;0;0;1;0;0;0.0;0.0;0.0
91;2020-12-29;1;0;0;2;0;0;0.0;0.0;0.0
91;2020-12-30;5;0;0;7;0;0;0.0;0.0;0.0
91;2020-12-31;0;0;0;7;0;0;0.0;0.0;0.0
91;2021-01-01;9;0;0;16;0;0;0.0;0.0;0.0
91;2021-01-02;0;0;0;16;0;0;0.0;0.0;0.0
91;2021-01-03;2;0;0;18;0;0;0.0;0.0;0.0
91;2021-01-04;12;0;0;30;0;0;0.0;0.0;0.0
91;2021-01-05;143;3;0;173;3;0;0.0;0.0;0.0
91;2021-01-06;287;2;0;460;5;0;0.0;0.0;0.0
91;2021-01-07;585;7;0;1045;12;0;0.1;0.0;0.0
91;2021-01-08;526;5;0;1571;17;0;0.1;0.0;0.0
91;2021-01-09;111;3;0;1682;20;0;0.2;0.0;0.0
91;2021-01-10;24;0;0;1706;20;0;0.2;0.0;0.0
91;2021-01-11;760;7;0;2466;27;0;0.2;0.0;0.0
91;2021-01-12;1080;14;0;3546;41;0;0.3;0.0;0.0
91;2021-01-13;887;12;0;4433;53;0;0.4;0.0;0.0
91;2021-01-14;972;17;0;5405;70;0;0.5;0.0;0.0
91;2021-01-15;784;8;0;6189;78;0;0.6;0.0;0.0
91;2021-01-16;304;7;0;6493;85;0;0.6;0.0;0.0
91;2021-01-17;101;1;0;6594;86;0;0.6;0.0;0.0
91;2021-01-18;1165;17;0;7759;103;0;0.7;0.0;0.0
91;2021-01-19;1994;35;0;9753;138;0;0.9;0.0;0.0
91;2021-01-20;2339;38;0;12092;176;0;1.1;0.0;0.0
91;2021-01-21;2222;28;0;14314;204;0;1.3;0.0;0.0
91;2021-01-22;1882;20;0;16196;224;0;1.5;0.0;0.0
91;2021-01-23;433;2;0;16629;226;0;1.5;0.0;0.0
91;2021-01-24;75;2;0;16704;228;0;1.5;0.0;0.0
91;2021-01-25;1075;8;0;17779;236;0;1.6;0.0;0.0
91;2021-01-26;1653;56;0;19432;292;0;1.8;0.0;0.0
91;2021-01-27;2332;103;0;21764;395;0;2.0;0.0;0.0
91;2021-01-28;1949;221;0;23713;616;0;2.2;0.1;0.0
91;2021-01-29;1732;83;0;25445;699;0;2.3;0.1;0.0
91;2021-01-30;382;11;0;25827;710;0;2.3;0.1;0.0
91;2021-01-31;48;3;0;25875;713;0;2.4;0.1;0.0
91;2021-02-01;940;215;0;26815;928;0;2.4;0.1;0.0
91;2021-02-02;888;367;0;27703;1295;0;2.5;0.1;0.0
91;2021-02-03;992;527;0;28695;1822;0;2.6;0.2;0.0
91;2021-02-04;868;357;0;29563;2179;0;2.7;0.2;0.0
91;2021-02-05;1016;444;0;30579;2623;0;2.8;0.2;0.0
91;2021-02-06;297;97;0;30876;2720;0;2.8;0.2;0.0
91;2021-02-07;19;12;0;30895;2732;0;2.8;0.2;0.0
91;2021-02-08;809;648;0;31704;3380;0;2.9;0.3;0.0
91;2021-02-09;908;1019;0;32612;4399;0;3.0;0.4;0.0
91;2021-02-10;1039;1145;0;33651;5544;0;3.1;0.5;0.0
91;2021-02-11;1209;1268;0;34860;6812;0;3.2;0.6;0.0
91;2021-02-12;1105;1000;0;35965;7812;0;3.3;0.7;0.0
91;2021-02-13;305;310;0;36270;8122;0;3.3;0.7;0.0
91;2021-02-14;14;90;0;36284;8212;0;3.3;0.7;0.0
91;2021-02-15;421;1307;0;36705;9519;0;3.3;0.9;0.0
91;2021-02-16;609;2040;0;37314;11559;0;3.4;1.1;0.0
91;2021-02-17;791;2457;0;38105;14016;0;3.5;1.3;0.0
91;2021-02-18;949;1993;0;39054;16009;0;3.5;1.5;0.0
91;2021-02-19;963;1445;0;40017;17454;0;3.6;1.6;0.0
91;2021-02-20;145;415;0;40162;17869;0;3.6;1.6;0.0
91;2021-02-21;17;43;0;40179;17912;0;3.7;1.6;0.0
91;2021-02-22;404;1157;0;40583;19069;0;3.7;1.7;0.0
91;2021-02-23;508;1070;0;41091;20139;0;3.7;1.8;0.0
91;2021-02-24;591;1006;0;41682;21145;0;3.8;1.9;0.0
91;2021-02-25;815;1176;0;42497;22321;0;3.9;2.0;0.0
91;2021-02-26;1191;1034;0;43688;23355;0;4.0;2.1;0.0
91;2021-02-27;621;290;0;44309;23645;0;4.0;2.1;0.0
91;2021-02-28;76;66;0;44385;23711;0;4.0;2.2;0.0
91;2021-03-01;986;946;0;45371;24657;0;4.1;2.2;0.0
91;2021-03-02;1486;1079;0;46857;25736;0;4.3;2.3;0.0
91;2021-03-03;1731;1234;0;48588;26970;0;4.4;2.5;0.0
91;2021-03-04;2702;1149;0;51290;28119;0;4.7;2.6;0.0
91;2021-03-05;3831;1202;0;55121;29321;0;5.0;2.7;0.0
91;2021-03-06;4820;436;0;59941;29757;0;5.4;2.7;0.0
91;2021-03-07;3020;200;0;62961;29957;0;5.7;2.7;0.0
91;2021-03-08;1787;987;0;64748;30944;0;5.9;2.8;0.0
91;2021-03-09;2979;941;0;67727;31885;0;6.2;2.9;0.0
91;2021-03-10;2981;1002;0;70708;32887;0;6.4;3.0;0.0
91;2021-03-11;4090;1124;0;74798;34011;0;6.8;3.1;0.0
91;2021-03-12;5081;1025;0;79879;35036;0;7.3;3.2;0.0
91;2021-03-13;5280;363;0;85159;35399;0;7.7;3.2;0.0
91;2021-03-14;522;50;0;85681;35449;0;7.8;3.2;0.0
91;2021-03-15;3187;486;0;88868;35935;0;8.1;3.3;0.0
91;2021-03-16;2719;440;0;91587;36375;0;8.3;3.3;0.0
91;2021-03-17;2470;394;0;94057;36769;0;8.5;3.3;0.0
91;2021-03-18;2615;448;0;96672;37217;0;8.8;3.4;0.0
91;2021-03-19;4171;463;0;100843;37680;0;9.2;3.4;0.0
91;2021-03-20;3412;198;0;104255;37878;0;9.5;3.4;0.0
91;2021-03-21;206;71;0;104461;37949;0;9.5;3.4;0.0
91;2021-03-22;3316;599;0;107777;38548;0;9.8;3.5;0.0
91;2021-03-23;4412;721;0;112189;39269;0;10.2;3.6;0.0
91;2021-03-24;4209;599;0;116398;39868;0;10.6;3.6;0.0
91;2021-03-25;5574;565;0;121972;40433;0;11.1;3.7;0.0
91;2021-03-26;6004;671;0;127976;41104;0;11.6;3.7;0.0
91;2021-03-27;4602;337;0;132578;41441;0;12.0;3.8;0.0
91;2021-03-28;430;62;0;133008;41503;0;12.1;3.8;0.0
91;2021-03-29;3712;1119;0;136720;42622;0;12.4;3.9;0.0
91;2021-03-30;4930;1307;0;141650;43929;0;12.9;4.0;0.0
91;2021-03-31;3860;1476;0;145510;45405;0;13.2;4.1;0.0
91;2021-04-01;4460;1861;0;149970;47266;0;13.6;4.3;0.0
91;2021-04-02;4387;2414;0;154357;49680;0;14.0;4.5;0.0
91;2021-04-03;2113;2452;0;156470;52132;0;14.2;4.7;0.0
91;2021-04-04;682;1130;0;157152;53262;0;14.3;4.8;0.0
91;2021-04-05;683;162;0;157835;53424;0;14.3;4.9;0.0
91;2021-04-06;3885;1982;0;161720;55406;0;14.7;5.0;0.0
91;2021-04-07;4195;2129;0;165915;57535;0;15.1;5.2;0.0
91;2021-04-08;5261;2323;0;171176;59858;0;15.6;5.4;0.0
91;2021-04-09;6065;2356;0;177241;62214;0;16.1;5.7;0.0
91;2021-04-10;3118;2740;0;180359;64954;0;16.4;5.9;0.0
91;2021-04-11;334;229;0;180693;65183;0;16.4;5.9;0.0
91;2021-04-12;3384;2360;0;184077;67543;0;16.7;6.1;0.0
91;2021-04-13;4312;2963;0;188389;70506;0;17.1;6.4;0.0
91;2021-04-14;4252;2512;0;192641;73018;0;17.5;6.6;0.0
91;2021-04-15;4908;2703;0;197549;75721;0;18.0;6.9;0.0
91;2021-04-16;5158;2970;0;202707;78691;0;18.4;7.2;0.0
91;2021-04-17;3130;2002;0;205837;80693;0;18.7;7.3;0.0
91;2021-04-18;432;125;0;206269;80818;0;18.7;7.3;0.0
91;2021-04-19;2805;2851;0;209074;83669;0;19.0;7.6;0.0
91;2021-04-20;3692;3055;0;212766;86724;0;19.3;7.9;0.0
91;2021-04-21;3580;3045;0;216346;89769;0;19.7;8.2;0.0
91;2021-04-22;3782;3700;0;220128;93469;0;20.0;8.5;0.0
91;2021-04-23;4362;3541;0;224490;97010;0;20.4;8.8;0.0
91;2021-04-24;4051;3379;0;228541;100389;0;20.8;9.1;0.0
91;2021-04-25;2638;704;0;231179;101093;0;21.0;9.2;0.0
91;2021-04-26;3993;3007;0;235172;104100;0;21.4;9.5;0.0
91;2021-04-27;5062;3205;0;240234;107305;0;21.8;9.8;0.0
91;2021-04-28;5315;2949;0;245549;110254;0;22.3;10.0;0.0
91;2021-04-29;6426;3287;0;251975;113541;0;22.9;10.3;0.0
91;2021-04-30;6077;3107;0;258052;116648;0;23.5;10.6;0.0
91;2021-05-01;3534;637;0;261586;117285;0;23.8;10.7;0.0
91;2021-05-02;928;205;0;262514;117490;0;23.9;10.7;0.0
91;2021-05-03;5781;3243;0;268295;120733;0;24.4;11.0;0.0
91;2021-05-04;6117;3814;0;274412;124547;0;24.9;11.3;0.0
91;2021-05-05;5602;3353;0;280014;127900;0;25.4;11.6;0.0
91;2021-05-06;6040;3851;0;286054;131751;0;26.0;12.0;0.0
91;2021-05-07;6692;4098;0;292746;135849;0;26.6;12.3;0.0
91;2021-05-08;6090;1490;0;298836;137339;0;27.2;12.5;0.0
91;2021-05-09;4689;768;0;303525;138107;0;27.6;12.6;0.0
91;2021-05-10;6569;3481;0;310094;141588;0;28.2;12.9;0.0
91;2021-05-11;7827;4297;0;317921;145885;0;28.9;13.3;0.0
91;2021-05-12;7260;3868;0;325181;149753;0;29.6;13.6;0.0
91;2021-05-13;5631;1148;0;330812;150901;0;30.1;13.7;0.0
91;2021-05-14;7803;2667;0;338615;153568;0;30.8;14.0;0.0
91;2021-05-15;7658;2054;0;346273;155622;0;31.5;14.1;0.0
91;2021-05-16;4391;445;0;350664;156067;0;31.9;14.2;0.0
91;2021-05-17;7756;1936;0;358420;158003;0;32.6;14.4;0.0
91;2021-05-18;8993;2011;0;367413;160014;0;33.4;14.5;0.0
91;2021-05-19;8557;2443;0;375970;162457;0;34.2;14.8;0.0
91;2021-05-20;9521;2673;0;385491;165130;0;35.0;15.0;0.0
91;2021-05-21;9250;2826;0;394741;167956;0;35.9;15.3;0.0
91;2021-05-22;7495;1560;0;402236;169516;0;36.6;15.4;0.0
91;2021-05-23;4679;559;0;406915;170075;0;37.0;15.5;0.0
91;2021-05-24;5044;644;0;411959;170719;0;37.4;15.5;0.0
91;2021-05-25;8549;3207;0;420508;173926;0;38.2;15.8;0.0
91;2021-05-26;7824;3322;0;428332;177248;0;38.9;16.1;0.0
91;2021-05-27;8557;3815;0;436889;181063;0;39.7;16.5;0.0
91;2021-05-28;8028;4689;0;444917;185752;0;40.4;16.9;0.0
91;2021-05-29;8579;3510;0;453496;189262;0;41.2;17.2;0.0
91;2021-05-30;4620;896;0;458116;190158;0;41.6;17.3;0.0
91;2021-05-31;7311;4111;0;465427;194269;0;42.3;17.7;0.0
91;2021-06-01;8339;5279;0;473766;199548;0;43.1;18.1;0.0
91;2021-06-02;8100;4602;0;481866;204150;0;43.8;18.6;0.0
91;2021-06-03;8442;5244;0;490308;209394;0;44.6;19.0;0.0
91;2021-06-04;7829;6142;0;498137;215536;0;45.3;19.6;0.0
91;2021-06-05;6341;6130;0;504478;221666;0;45.8;20.1;0.0
91;2021-06-06;3853;2312;0;508331;223978;0;46.2;20.4;0.0
91;2021-06-07;6237;5886;0;514568;229864;0;46.8;20.9;0.0
91;2021-06-08;7127;6482;0;521695;236346;0;47.4;21.5;0.0
91;2021-06-09;6821;6050;0;528516;242396;0;48.0;22.0;0.0
91;2021-06-10;7266;7558;0;535782;249954;0;48.7;22.7;0.0
91;2021-06-11;6754;7555;0;542536;257509;0;49.3;23.4;0.0
91;2021-06-12;6196;6969;0;548732;264478;0;49.9;24.0;0.0
91;2021-06-13;2654;2160;0;551386;266638;0;50.1;24.2;0.0
91;2021-06-14;4423;7886;0;555809;274524;0;50.5;24.9;0.0
91;2021-06-15;5731;8043;0;561540;282567;0;51.0;25.7;0.0
91;2021-06-16;5170;7089;0;566710;289656;0;51.5;26.3;0.0
91;2021-06-17;6039;7737;0;572749;297393;0;52.0;27.0;0.0
91;2021-06-18;4915;9495;0;577664;306888;0;52.5;27.9;0.0
91;2021-06-19;4044;7252;0;581708;314140;0;52.9;28.5;0.0
91;2021-06-20;954;4212;0;582662;318352;0;52.9;28.9;0.0
91;2021-06-21;3422;8124;0;586084;326476;0;53.3;29.7;0.0
91;2021-06-22;4043;9924;0;590127;336400;0;53.6;30.6;0.0
91;2021-06-23;4141;8720;0;594268;345120;0;54.0;31.4;0.0
91;2021-06-24;4738;8900;0;599006;354020;0;54.4;32.2;0.0
91;2021-06-25;3647;10187;0;602653;364207;0;54.8;33.1;0.0
91;2021-06-26;2901;8281;0;605554;372488;0;55.0;33.8;0.0
91;2021-06-27;611;3227;0;606165;375715;0;55.1;34.1;0.0
91;2021-06-28;3081;8922;0;609246;384637;0;55.4;35.0;0.0
91;2021-06-29;3590;10272;0;612836;394909;0;55.7;35.9;0.0
91;2021-06-30;3882;9529;0;616718;404438;0;56.0;36.8;0.0
91;2021-07-01;4210;9689;0;620928;414127;0;56.4;37.6;0.0
91;2021-07-02;4128;10099;0;625056;424226;0;56.8;38.6;0.0
91;2021-07-03;3005;9908;0;628061;434134;0;57.1;39.5;0.0
91;2021-07-04;986;4550;0;629047;438684;0;57.2;39.9;0.0
91;2021-07-05;2988;7806;0;632035;446490;0;57.4;40.6;0.0
91;2021-07-06;3801;10083;0;635836;456573;0;57.8;41.5;0.0
91;2021-07-07;4068;9679;0;639904;466252;0;58.2;42.4;0.0
91;2021-07-08;4568;9680;0;644472;475932;0;58.6;43.3;0.0
91;2021-07-09;4386;10474;0;648858;486406;0;59.0;44.2;0.0
91;2021-07-10;3552;9902;0;652410;496308;0;59.3;45.1;0.0
91;2021-07-11;1218;4302;0;653628;500610;0;59.4;45.5;0.0
91;2021-07-12;3244;9922;0;656872;510532;0;59.7;46.4;0.0
91;2021-07-13;5653;11398;0;662525;521930;0;60.2;47.4;0.0
91;2021-07-14;3333;4061;0;665858;525991;0;60.5;47.8;0.0
91;2021-07-15;6145;11159;0;672003;537150;0;61.1;48.8;0.0
91;2021-07-16;7541;10424;0;679544;547574;0;61.8;49.8;0.0
91;2021-07-17;6293;8944;0;685837;556518;0;62.3;50.6;0.0
91;2021-07-18;3729;3567;0;689566;560085;0;62.7;50.9;0.0
91;2021-07-19;5078;8404;0;694644;568489;0;63.1;51.7;0.0
91;2021-07-20;7540;9909;0;702184;578398;0;63.8;52.6;0.0
91;2021-07-21;7742;8408;0;709926;586806;0;64.5;53.3;0.0
91;2021-07-22;8163;8985;0;718089;595791;0;65.3;54.1;0.0
91;2021-07-23;8262;8808;0;726351;604599;0;66.0;54.9;0.0
91;2021-07-24;5822;6689;0;732173;611288;0;66.5;55.6;0.0
91;2021-07-25;3507;1625;0;735680;612913;0;66.9;55.7;0.0
91;2021-07-26;6164;7159;0;741844;620072;0;67.4;56.3;0.0
91;2021-07-27;8712;7603;0;750556;627675;0;68.2;57.0;0.0
91;2021-07-28;8376;6445;0;758932;634120;0;69.0;57.6;0.0
91;2021-07-29;8452;6512;0;767384;640632;0;69.7;58.2;0.0
91;2021-07-30;7792;6341;0;775176;646973;0;70.4;58.8;0.0
91;2021-07-31;5303;5075;0;780479;652048;0;70.9;59.3;0.0
91;2021-08-01;2715;1413;0;783194;653461;0;71.2;59.4;0.0
91;2021-08-02;5567;4853;0;788761;658314;0;71.7;59.8;0.0
91;2021-08-03;6310;5412;0;795071;663726;0;72.3;60.3;0.0
91;2021-08-04;6264;4843;0;801335;668569;0;72.8;60.8;0.0
91;2021-08-05;5794;5098;0;807129;673667;0;73.3;61.2;0.0
91;2021-08-06;6035;6393;0;813164;680060;0;73.9;61.8;0.0
91;2021-08-07;3268;3350;0;816432;683410;0;74.2;62.1;0.0
91;2021-08-08;880;1493;0;817312;684903;0;74.3;62.2;0.0
91;2021-08-09;4245;5082;0;821557;689985;0;74.7;62.7;0.0
91;2021-08-10;4914;5606;0;826471;695591;0;75.1;63.2;0.0
91;2021-08-11;4373;5564;0;830844;701155;0;75.5;63.7;0.0
91;2021-08-12;4230;5753;0;835074;706908;0;75.9;64.2;0.0
91;2021-08-13;4168;5637;1;839242;712545;1;76.3;64.8;0.0
91;2021-08-14;2210;3333;0;841452;715878;1;76.5;65.1;0.0
91;2021-08-15;258;464;0;841710;716342;1;76.5;65.1;0.0
91;2021-08-16;3047;5856;0;844757;722198;1;76.8;65.6;0.0
91;2021-08-17;3635;6818;0;848392;729016;1;77.1;66.2;0.0
91;2021-08-18;3014;6568;0;851406;735584;1;77.4;66.8;0.0
91;2021-08-19;3436;6538;0;854842;742122;1;77.7;67.4;0.0
91;2021-08-20;3149;7393;0;857991;749515;1;78.0;68.1;0.0
91;2021-08-21;2296;4171;0;860287;753686;1;78.2;68.5;0.0
91;2021-08-22;704;1719;0;860991;755405;1;78.2;68.6;0.0
91;2021-08-23;2467;6360;0;863458;761765;1;78.5;69.2;0.0
91;2021-08-24;2957;7540;0;866415;769305;1;78.7;69.9;0.0
91;2021-08-25;3168;7046;0;869583;776351;1;79.0;70.6;0.0
91;2021-08-26;2736;6374;0;872319;782725;1;79.3;71.1;0.0
91;2021-08-27;2779;7729;0;875098;790454;1;79.5;71.8;0.0
91;2021-08-28;2176;5063;0;877274;795517;1;79.7;72.3;0.0
91;2021-08-29;1524;2632;0;878798;798149;1;79.9;72.5;0.0
91;2021-08-30;1840;6032;79;880638;804181;80;80.0;73.1;0.0
91;2021-08-31;2204;6045;190;882842;810226;270;80.2;73.6;0.0
91;2021-09-01;2595;4556;255;885437;814782;525;80.5;74.0;0.0
91;2021-09-02;2104;3792;365;887541;818574;890;80.7;74.4;0.1
91;2021-09-03;2167;4698;375;889708;823272;1265;80.9;74.8;0.1
91;2021-09-04;2066;4117;143;891774;827389;1408;81.0;75.2;0.1
91;2021-09-05;659;843;68;892433;828232;1476;81.1;75.3;0.1
91;2021-09-06;1623;3052;540;894056;831284;2016;81.2;75.5;0.2
91;2021-09-07;1520;2870;512;895576;834154;2528;81.4;75.8;0.2
91;2021-09-08;1787;3135;509;897363;837289;3037;81.5;76.1;0.3
91;2021-09-09;1329;2789;611;898692;840078;3648;81.7;76.3;0.3
91;2021-09-10;1818;3389;526;900510;843467;4174;81.8;76.7;0.4
91;2021-09-11;1690;4030;208;902200;847497;4382;82.0;77.0;0.4
91;2021-09-12;547;907;87;902747;848404;4469;82.0;77.1;0.4
91;2021-09-13;1365;2279;728;904112;850683;5197;82.2;77.3;0.5
91;2021-09-14;1692;2531;1130;905804;853214;6327;82.3;77.5;0.6
91;2021-09-15;1656;3254;871;907460;856468;7198;82.5;77.8;0.7
91;2021-09-16;1377;2151;1021;908837;858619;8219;82.6;78.0;0.7
91;2021-09-17;1378;2753;772;910215;861372;8991;82.7;78.3;0.8
91;2021-09-18;1283;3342;260;911498;864714;9251;82.8;78.6;0.8
91;2021-09-19;391;1017;62;911889;865731;9313;82.9;78.7;0.8
91;2021-09-20;775;1588;844;912664;867319;10157;82.9;78.8;0.9
91;2021-09-21;906;1652;1167;913570;868971;11324;83.0;79.0;1.0
91;2021-09-22;915;2515;634;914485;871486;11958;83.1;79.2;1.1
91;2021-09-23;881;1683;1075;915366;873169;13033;83.2;79.3;1.2
91;2021-09-24;911;2136;845;916277;875305;13878;83.3;79.5;1.3
91;2021-09-25;1004;3142;357;917281;878447;14235;83.4;79.8;1.3
91;2021-09-26;195;716;115;917476;879163;14350;83.4;79.9;1.3
91;2021-09-27;743;1528;663;918219;880691;15013;83.4;80.0;1.4
91;2021-09-28;859;1311;660;919078;882002;15673;83.5;80.2;1.4
91;2021-09-29;968;2186;776;920046;884188;16449;83.6;80.4;1.5
91;2021-09-30;655;1159;796;920701;885347;17245;83.7;80.5;1.6
91;2021-10-01;1342;1822;898;922043;887169;18143;83.8;80.6;1.6
91;2021-10-02;1019;2154;454;923062;889323;18597;83.9;80.8;1.7
91;2021-10-03;218;532;99;923280;889855;18696;83.9;80.9;1.7
91;2021-10-04;732;1126;1089;924012;890981;19785;84.0;81.0;1.8
91;2021-10-05;690;1142;951;924702;892123;20736;84.0;81.1;1.9
91;2021-10-06;787;1712;1206;925489;893835;21942;84.1;81.2;2.0
91;2021-10-07;609;1043;1210;926098;894878;23152;84.2;81.3;2.1
91;2021-10-08;839;1691;1412;926937;896569;24564;84.2;81.5;2.2
91;2021-10-09;962;1767;685;927899;898336;25249;84.3;81.6;2.3
91;2021-10-10;236;441;131;928135;898777;25380;84.3;81.7;2.3
91;2021-10-11;585;953;1103;928720;899730;26483;84.4;81.8;2.4
91;2021-10-12;555;1018;1099;929275;900748;27582;84.4;81.9;2.5
91;2021-10-13;743;1324;1393;930018;902072;28975;84.5;82.0;2.6
91;2021-10-14;492;974;977;930510;903046;29952;84.6;82.1;2.7
91;2021-10-15;877;1364;1729;931387;904410;31681;84.6;82.2;2.9
91;2021-10-16;833;1340;698;932220;905750;32379;84.7;82.3;2.9
91;2021-10-17;189;282;248;932409;906032;32627;84.7;82.3;3.0
91;2021-10-18;590;874;1340;932999;906906;33967;84.8;82.4;3.1
91;2021-10-19;470;980;1091;933469;907886;35058;84.8;82.5;3.2
91;2021-10-20;595;1006;1737;934064;908892;36795;84.9;82.6;3.3
91;2021-10-21;314;682;1244;934378;909574;38039;84.9;82.7;3.5
91;2021-10-22;589;1115;1790;934967;910689;39829;85.0;82.8;3.6
91;2021-10-23;643;1126;1032;935610;911815;40861;85.0;82.9;3.7
91;2021-10-24;133;224;213;935743;912039;41074;85.0;82.9;3.7
91;2021-10-25;363;622;1300;936106;912661;42374;85.1;82.9;3.9
91;2021-10-26;434;603;1455;936540;913264;43829;85.1;83.0;4.0
91;2021-10-27;488;814;1888;937028;914078;45717;85.2;83.1;4.2
91;2021-10-28;309;499;1317;937337;914577;47034;85.2;83.1;4.3
91;2021-10-29;499;777;2051;937836;915354;49085;85.2;83.2;4.5
91;2021-10-30;482;891;1076;938318;916245;50161;85.3;83.3;4.6
91;2021-10-31;98;155;216;938416;916400;50377;85.3;83.3;4.6
91;2021-11-01;84;104;63;938500;916504;50440;85.3;83.3;4.6
91;2021-11-02;430;630;1262;938930;917134;51702;85.3;83.3;4.7
91;2021-11-03;490;736;1921;939420;917870;53623;85.4;83.4;4.9
91;2021-11-04;330;519;1401;939750;918389;55024;85.4;83.5;5.0
91;2021-11-05;449;763;2434;940199;919152;57458;85.4;83.5;5.2
91;2021-11-06;504;875;1447;940703;920027;58905;85.5;83.6;5.4
91;2021-11-07;82;161;238;940785;920188;59143;85.5;83.6;5.4
91;2021-11-08;219;461;1892;941004;920649;61035;85.5;83.7;5.5
91;2021-11-09;312;619;2613;941316;921268;63648;85.5;83.7;5.8
91;2021-11-10;473;757;3134;941789;922025;66782;85.6;83.8;6.1
91;2021-11-11;119;157;520;941908;922182;67302;85.6;83.8;6.1
91;2021-11-12;445;711;3560;942353;922893;70862;85.6;83.9;6.4
91;2021-11-13;539;850;2176;942892;923743;73038;85.7;83.9;6.6
91;2021-11-14;56;136;271;942948;923879;73309;85.7;84.0;6.7
91;2021-11-15;271;462;2190;943219;924341;75499;85.7;84.0;6.9
91;2021-11-16;372;504;3302;943591;924845;78801;85.7;84.0;7.2
91;2021-11-17;385;600;3009;943976;925445;81810;85.8;84.1;7.4
91;2021-11-18;294;421;2830;944270;925866;84640;85.8;84.1;7.7
91;2021-11-19;427;625;3427;944697;926491;88067;85.8;84.2;8.0
91;2021-11-20;583;782;2672;945280;927273;90739;85.9;84.3;8.2
91;2021-11-21;137;184;454;945417;927457;91193;85.9;84.3;8.3
91;2021-11-22;265;298;2397;945682;927755;93590;85.9;84.3;8.5
91;2021-11-23;333;431;3207;946015;928186;96797;86.0;84.3;8.8
91;2021-11-24;427;550;2990;946442;928736;99787;86.0;84.4;9.1
91;2021-11-25;342;443;4118;946784;929179;103905;86.0;84.4;9.4
91;2021-11-26;433;545;6452;947217;929724;110357;86.1;84.5;10.0
91;2021-11-27;510;756;5791;947727;930480;116148;86.1;84.6;10.6
91;2021-11-28;102;146;1791;947829;930626;117939;86.1;84.6;10.7
91;2021-11-29;189;340;5204;948018;930966;123143;86.2;84.6;11.2
91;2021-11-30;288;416;7662;948306;931382;130805;86.2;84.6;11.9
91;2021-12-01;255;503;8712;948561;931885;139517;86.2;84.7;12.7
91;2021-12-02;207;326;9063;948768;932211;148580;86.2;84.7;13.5
91;2021-12-03;230;431;10192;948998;932642;158772;86.2;84.8;14.4
91;2021-12-04;307;567;8744;949305;933209;167516;86.3;84.8;15.2
91;2021-12-05;98;147;3667;949403;933356;171183;86.3;84.8;15.6
91;2021-12-06;220;404;7449;949623;933760;178632;86.3;84.9;16.2
91;2021-12-07;252;474;11377;949875;934234;190009;86.3;84.9;17.3
91;2021-12-08;292;521;10173;950167;934755;200182;86.3;84.9;18.2
91;2021-12-09;251;449;11854;950418;935204;212036;86.4;85.0;19.3
91;2021-12-10;263;515;12596;950681;935719;224632;86.4;85.0;20.4
91;2021-12-11;362;677;13092;951043;936396;237724;86.4;85.1;21.6
91;2021-12-12;172;222;6680;951215;936618;244404;86.4;85.1;22.2
91;2021-12-13;224;375;8730;951439;936993;253134;86.5;85.1;23.0
91;2021-12-14;315;401;14259;951754;937394;267393;86.5;85.2;24.3
91;2021-12-15;322;520;12828;952076;937914;280221;86.5;85.2;25.5
91;2021-12-16;343;492;14298;952419;938406;294519;86.6;85.3;26.8
91;2021-12-17;356;550;13754;952775;938956;308273;86.6;85.3;28.0
91;2021-12-18;484;632;14609;953259;939588;322882;86.6;85.4;29.3
91;2021-12-19;229;235;8310;953488;939823;331192;86.6;85.4;30.1
92;2020-12-27;7;0;0;7;0;0;0.0;0.0;0.0
92;2020-12-28;14;0;0;21;0;0;0.0;0.0;0.0
92;2020-12-29;50;0;0;71;0;0;0.0;0.0;0.0
92;2020-12-30;21;0;0;92;0;0;0.0;0.0;0.0
92;2020-12-31;11;0;0;103;0;0;0.0;0.0;0.0
92;2021-01-01;13;0;0;116;0;0;0.0;0.0;0.0
92;2021-01-02;9;0;0;125;0;0;0.0;0.0;0.0
92;2021-01-03;25;2;0;150;2;0;0.0;0.0;0.0
92;2021-01-04;86;1;0;236;3;0;0.0;0.0;0.0
92;2021-01-05;268;4;0;504;7;0;0.0;0.0;0.0
92;2021-01-06;512;10;0;1016;17;0;0.1;0.0;0.0
92;2021-01-07;799;4;0;1815;21;0;0.1;0.0;0.0
92;2021-01-08;1049;9;0;2864;30;0;0.2;0.0;0.0
92;2021-01-09;209;0;0;3073;30;0;0.2;0.0;0.0
92;2021-01-10;199;2;0;3272;32;0;0.2;0.0;0.0
92;2021-01-11;1119;21;0;4391;53;0;0.3;0.0;0.0
92;2021-01-12;1561;17;0;5952;70;0;0.4;0.0;0.0
92;2021-01-13;1404;12;0;7356;82;0;0.5;0.0;0.0
92;2021-01-14;1362;17;0;8718;99;0;0.6;0.0;0.0
92;2021-01-15;1244;11;0;9962;110;0;0.7;0.0;0.0
92;2021-01-16;340;4;0;10302;114;0;0.8;0.0;0.0
92;2021-01-17;142;3;0;10444;117;0;0.8;0.0;0.0
92;2021-01-18;1947;26;0;12391;143;0;0.9;0.0;0.0
92;2021-01-19;2058;21;0;14449;164;0;1.1;0.0;0.0
92;2021-01-20;2343;26;0;16792;190;0;1.2;0.0;0.0
92;2021-01-21;3552;27;0;20344;217;0;1.5;0.0;0.0
92;2021-01-22;2970;43;0;23314;260;0;1.7;0.0;0.0
92;2021-01-23;430;1;0;23744;261;0;1.7;0.0;0.0
92;2021-01-24;111;2;0;23855;263;0;1.7;0.0;0.0
92;2021-01-25;1224;18;0;25079;281;0;1.8;0.0;0.0
92;2021-01-26;1573;28;0;26652;309;0;1.9;0.0;0.0
92;2021-01-27;2222;104;0;28874;413;0;2.1;0.0;0.0
92;2021-01-28;3963;181;0;32837;594;0;2.4;0.0;0.0
92;2021-01-29;2845;249;0;35682;843;0;2.6;0.1;0.0
92;2021-01-30;454;12;0;36136;855;0;2.6;0.1;0.0
92;2021-01-31;72;2;0;36208;857;0;2.6;0.1;0.0
92;2021-02-01;1197;276;0;37405;1133;0;2.7;0.1;0.0
92;2021-02-02;1414;407;0;38819;1540;0;2.8;0.1;0.0
92;2021-02-03;1300;455;0;40119;1995;0;2.9;0.1;0.0
92;2021-02-04;1298;607;0;41417;2602;0;3.0;0.2;0.0
92;2021-02-05;1603;561;0;43020;3163;0;3.1;0.2;0.0
92;2021-02-06;261;62;0;43281;3225;0;3.2;0.2;0.0
92;2021-02-07;77;39;0;43358;3264;0;3.2;0.2;0.0
92;2021-02-08;927;769;0;44285;4033;0;3.2;0.3;0.0
92;2021-02-09;1274;1343;0;45559;5376;0;3.3;0.4;0.0
92;2021-02-10;1293;1324;0;46852;6700;0;3.4;0.5;0.0
92;2021-02-11;1858;2355;0;48710;9055;0;3.5;0.7;0.0
92;2021-02-12;1594;1564;0;50304;10619;0;3.7;0.8;0.0
92;2021-02-13;202;250;0;50506;10869;0;3.7;0.8;0.0
92;2021-02-14;47;39;0;50553;10908;0;3.7;0.8;0.0
92;2021-02-15;629;2037;0;51182;12945;0;3.7;0.9;0.0
92;2021-02-16;832;2678;0;52014;15623;0;3.8;1.1;0.0
92;2021-02-17;660;1999;0;52674;17622;0;3.8;1.3;0.0
92;2021-02-18;1467;3655;0;54141;21277;0;3.9;1.5;0.0
92;2021-02-19;1630;2783;0;55771;24060;0;4.1;1.8;0.0
92;2021-02-20;222;613;0;55993;24673;0;4.1;1.8;0.0
92;2021-02-21;50;90;0;56043;24763;0;4.1;1.8;0.0
92;2021-02-22;605;1523;0;56648;26286;0;4.1;1.9;0.0
92;2021-02-23;781;1604;0;57429;27890;0;4.2;2.0;0.0
92;2021-02-24;766;1496;0;58195;29386;0;4.2;2.1;0.0
92;2021-02-25;1195;2279;0;59390;31665;0;4.3;2.3;0.0
92;2021-02-26;1733;1693;0;61123;33358;0;4.5;2.4;0.0
92;2021-02-27;614;266;0;61737;33624;0;4.5;2.4;0.0
92;2021-02-28;107;77;0;61844;33701;0;4.5;2.5;0.0
92;2021-03-01;1292;1334;0;63136;35035;0;4.6;2.6;0.0
92;2021-03-02;2155;1569;0;65291;36604;0;4.8;2.7;0.0
92;2021-03-03;2940;1453;0;68231;38057;0;5.0;2.8;0.0
92;2021-03-04;3945;1703;0;72176;39760;0;5.3;2.9;0.0
92;2021-03-05;5429;1910;0;77605;41670;0;5.7;3.0;0.0
92;2021-03-06;6767;499;0;84372;42169;0;6.1;3.1;0.0
92;2021-03-07;4270;493;0;88642;42662;0;6.5;3.1;0.0
92;2021-03-08;2753;1175;0;91395;43837;0;6.7;3.2;0.0
92;2021-03-09;3696;1262;0;95091;45099;0;6.9;3.3;0.0
92;2021-03-10;3990;1142;0;99081;46241;0;7.2;3.4;0.0
92;2021-03-11;5307;1530;0;104388;47771;0;7.6;3.5;0.0
92;2021-03-12;7053;1642;0;111441;49413;0;8.1;3.6;0.0
92;2021-03-13;5919;342;0;117360;49755;0;8.5;3.6;0.0
92;2021-03-14;2037;128;0;119397;49883;0;8.7;3.6;0.0
92;2021-03-15;4354;700;0;123751;50583;0;9.0;3.7;0.0
92;2021-03-16;3928;680;0;127679;51263;0;9.3;3.7;0.0
92;2021-03-17;4273;525;0;131952;51788;0;9.6;3.8;0.0
92;2021-03-18;4496;825;0;136448;52613;0;9.9;3.8;0.0
92;2021-03-19;6492;796;0;142940;53409;0;10.4;3.9;0.0
92;2021-03-20;3263;180;0;146203;53589;0;10.7;3.9;0.0
92;2021-03-21;628;147;0;146831;53736;0;10.7;3.9;0.0
92;2021-03-22;4920;634;0;151751;54370;0;11.1;4.0;0.0
92;2021-03-23;6619;991;0;158370;55361;0;11.5;4.0;0.0
92;2021-03-24;6911;855;0;165281;56216;0;12.0;4.1;0.0
92;2021-03-25;8948;796;0;174229;57012;0;12.7;4.2;0.0
92;2021-03-26;8982;1051;0;183211;58063;0;13.3;4.2;0.0
92;2021-03-27;3881;343;0;187092;58406;0;13.6;4.3;0.0
92;2021-03-28;899;73;0;187991;58479;0;13.7;4.3;0.0
92;2021-03-29;5139;1251;0;193130;59730;0;14.1;4.4;0.0
92;2021-03-30;7121;1812;0;200251;61542;0;14.6;4.5;0.0
92;2021-03-31;6085;2368;0;206336;63910;0;15.0;4.7;0.0
92;2021-04-01;6543;4020;0;212879;67930;0;15.5;4.9;0.0
92;2021-04-02;6038;3888;0;218917;71818;0;15.9;5.2;0.0
92;2021-04-03;1616;2051;0;220533;73869;0;16.1;5.4;0.0
92;2021-04-04;745;1161;0;221278;75030;0;16.1;5.5;0.0
92;2021-04-05;990;315;0;222268;75345;0;16.2;5.5;0.0
92;2021-04-06;4205;2386;0;226473;77731;0;16.5;5.7;0.0
92;2021-04-07;5392;3305;0;231865;81036;0;16.9;5.9;0.0
92;2021-04-08;6251;3399;0;238116;84435;0;17.3;6.2;0.0
92;2021-04-09;8056;3411;0;246172;87846;0;17.9;6.4;0.0
92;2021-04-10;3242;1903;0;249414;89749;0;18.2;6.5;0.0
92;2021-04-11;618;1020;0;250032;90769;0;18.2;6.6;0.0
92;2021-04-12;4382;2994;0;254414;93763;0;18.5;6.8;0.0
92;2021-04-13;5210;4730;0;259624;98493;0;18.9;7.2;0.0
92;2021-04-14;5492;4427;0;265116;102920;0;19.3;7.5;0.0
92;2021-04-15;5727;4411;0;270843;107331;0;19.7;7.8;0.0
92;2021-04-16;5975;4383;0;276818;111714;0;20.2;8.1;0.0
92;2021-04-17;2727;1863;0;279545;113577;0;20.4;8.3;0.0
92;2021-04-18;722;483;0;280267;114060;0;20.4;8.3;0.0
92;2021-04-19;3668;3542;0;283935;117602;0;20.7;8.6;0.0
92;2021-04-20;4975;4377;0;288910;121979;0;21.0;8.9;0.0
92;2021-04-21;5202;4817;0;294112;126796;0;21.4;9.2;0.0
92;2021-04-22;5211;5497;0;299323;132293;0;21.8;9.6;0.0
92;2021-04-23;5773;4966;0;305096;137259;0;22.2;10.0;0.0
92;2021-04-24;5304;2583;0;310400;139842;0;22.6;10.2;0.0
92;2021-04-25;2139;569;0;312539;140411;0;22.8;10.2;0.0
92;2021-04-26;4570;3966;0;317109;144377;0;23.1;10.5;0.0
92;2021-04-27;6999;5619;0;324108;149996;0;23.6;10.9;0.0
92;2021-04-28;8222;4967;0;332330;154963;0;24.2;11.3;0.0
92;2021-04-29;8828;5091;0;341158;160054;0;24.9;11.7;0.0
92;2021-04-30;9803;4983;0;350961;165037;0;25.6;12.0;0.0
92;2021-05-01;2355;665;0;353316;165702;0;25.7;12.1;0.0
92;2021-05-02;1325;489;0;354641;166191;0;25.8;12.1;0.0
92;2021-05-03;7630;4968;0;362271;171159;0;26.4;12.5;0.0
92;2021-05-04;10203;4946;0;372474;176105;0;27.1;12.8;0.0
92;2021-05-05;9852;5426;0;382326;181531;0;27.9;13.2;0.0
92;2021-05-06;10986;5226;0;393312;186757;0;28.7;13.6;0.0
92;2021-05-07;9884;5614;0;403196;192371;0;29.4;14.0;0.0
92;2021-05-08;7396;2351;0;410592;194722;0;29.9;14.2;0.0
92;2021-05-09;4246;1134;0;414838;195856;0;30.2;14.3;0.0
92;2021-05-10;10465;4529;0;425303;200385;0;31.0;14.6;0.0
92;2021-05-11;13459;6172;0;438762;206557;0;32.0;15.0;0.0
92;2021-05-12;13798;5098;0;452560;211655;0;33.0;15.4;0.0
92;2021-05-13;9707;1330;0;462267;212985;0;33.7;15.5;0.0
92;2021-05-14;12842;3095;0;475109;216080;0;34.6;15.7;0.0
92;2021-05-15;9426;1708;0;484535;217788;0;35.3;15.9;0.0
92;2021-05-16;5083;620;0;489618;218408;0;35.7;15.9;0.0
92;2021-05-17;11974;2731;0;501592;221139;0;36.5;16.1;0.0
92;2021-05-18;16589;3253;0;518181;224392;0;37.7;16.3;0.0
92;2021-05-19;16175;4296;0;534356;228688;0;38.9;16.7;0.0
92;2021-05-20;17030;4499;0;551386;233187;0;40.2;17.0;0.0
92;2021-05-21;15124;3953;0;566510;237140;0;41.3;17.3;0.0
92;2021-05-22;10626;1946;0;577136;239086;0;42.0;17.4;0.0
92;2021-05-23;5384;750;0;582520;239836;0;42.4;17.5;0.0
92;2021-05-24;8066;1143;0;590586;240979;0;43.0;17.6;0.0
92;2021-05-25;13632;4900;0;604218;245879;0;44.0;17.9;0.0
92;2021-05-26;12768;5221;0;616986;251100;0;44.9;18.3;0.0
92;2021-05-27;13596;6486;0;630582;257586;0;45.9;18.8;0.0
92;2021-05-28;12623;6759;0;643205;264345;0;46.9;19.3;0.0
92;2021-05-29;8430;3175;0;651635;267520;0;47.5;19.5;0.0
92;2021-05-30;4024;898;0;655659;268418;0;47.8;19.6;0.0
92;2021-05-31;12469;6067;0;668128;274485;0;48.7;20.0;0.0
92;2021-06-01;12715;8240;0;680843;282725;0;49.6;20.6;0.0
92;2021-06-02;13719;7200;0;694562;289925;0;50.6;21.1;0.0
92;2021-06-03;14026;7959;0;708588;297884;0;51.6;21.7;0.0
92;2021-06-04;12244;8681;0;720832;306565;0;52.5;22.3;0.0
92;2021-06-05;8009;6772;0;728841;313337;0;53.1;22.8;0.0
92;2021-06-06;4698;2129;0;733539;315466;0;53.4;23.0;0.0
92;2021-06-07;10229;8109;0;743768;323575;0;54.2;23.6;0.0
92;2021-06-08;11192;10079;0;754960;333654;0;55.0;24.3;0.0
92;2021-06-09;10781;9998;0;765741;343652;0;55.8;25.0;0.0
92;2021-06-10;11178;11751;0;776919;355403;0;56.6;25.9;0.0
92;2021-06-11;8579;11500;0;785498;366903;0;57.2;26.7;0.0
92;2021-06-12;7241;5940;0;792739;372843;0;57.7;27.2;0.0
92;2021-06-13;3802;3047;0;796541;375890;0;58.0;27.4;0.0
92;2021-06-14;5282;11603;0;801823;387493;0;58.4;28.2;0.0
92;2021-06-15;6838;13285;0;808661;400778;0;58.9;29.2;0.0
92;2021-06-16;6855;12285;0;815516;413063;0;59.4;30.1;0.0
92;2021-06-17;7284;13323;0;822800;426386;0;59.9;31.1;0.0
92;2021-06-18;7217;14447;0;830017;440833;0;60.5;32.1;0.0
92;2021-06-19;4727;9512;0;834744;450345;0;60.8;32.8;0.0
92;2021-06-20;2062;5355;0;836806;455700;0;61.0;33.2;0.0
92;2021-06-21;4577;12580;0;841383;468280;0;61.3;34.1;0.0
92;2021-06-22;5574;16345;0;846957;484625;0;61.7;35.3;0.0
92;2021-06-23;5456;15376;0;852413;500001;0;62.1;36.4;0.0
92;2021-06-24;6065;14435;0;858478;514436;0;62.5;37.5;0.0
92;2021-06-25;4993;16399;0;863471;530835;0;62.9;38.7;0.0
92;2021-06-26;4211;11550;0;867682;542385;0;63.2;39.5;0.0
92;2021-06-27;1599;6283;0;869281;548668;0;63.3;40.0;0.0
92;2021-06-28;3595;13173;0;872876;561841;0;63.6;40.9;0.0
92;2021-06-29;4498;17593;0;877374;579434;0;63.9;42.2;0.0
92;2021-06-30;4668;16152;0;882042;595586;0;64.3;43.4;0.0
92;2021-07-01;5937;16130;0;887979;611716;0;64.7;44.6;0.0
92;2021-07-02;5471;16338;0;893450;628054;0;65.1;45.8;0.0
92;2021-07-03;3556;11894;0;897006;639948;0;65.3;46.6;0.0
92;2021-07-04;1383;5277;0;898389;645225;0;65.4;47.0;0.0
92;2021-07-05;4631;12819;0;903020;658044;0;65.8;47.9;0.0
92;2021-07-06;5310;15680;0;908330;673724;0;66.2;49.1;0.0
92;2021-07-07;4929;12818;0;913259;686542;0;66.5;50.0;0.0
92;2021-07-08;5589;14417;0;918848;700959;0;66.9;51.1;0.0
92;2021-07-09;5913;15321;0;924761;716280;0;67.4;52.2;0.0
92;2021-07-10;3913;10199;0;928674;726479;0;67.6;52.9;0.0
92;2021-07-11;1725;4248;0;930399;730727;0;67.8;53.2;0.0
92;2021-07-12;4528;15101;0;934927;745828;0;68.1;54.3;0.0
92;2021-07-13;8015;16879;0;942942;762707;0;68.7;55.6;0.0
92;2021-07-14;4755;5573;0;947697;768280;0;69.0;56.0;0.0
92;2021-07-15;9156;16118;0;956853;784398;0;69.7;57.1;0.0
92;2021-07-16;9084;14381;0;965937;798779;0;70.4;58.2;0.0
92;2021-07-17;6135;8535;0;972072;807314;0;70.8;58.8;0.0
92;2021-07-18;2358;3642;0;974430;810956;0;71.0;59.1;0.0
92;2021-07-19;6443;12710;0;980873;823666;0;71.5;60.0;0.0
92;2021-07-20;9235;13300;0;990108;836966;0;72.1;61.0;0.0
92;2021-07-21;9453;11774;0;999561;848740;0;72.8;61.8;0.0
92;2021-07-22;10472;12605;0;1010033;861345;0;73.6;62.7;0.0
92;2021-07-23;9801;11259;0;1019834;872604;0;74.3;63.6;0.0
92;2021-07-24;5882;6817;0;1025716;879421;0;74.7;64.1;0.0
92;2021-07-25;2627;2502;0;1028343;881923;0;74.9;64.2;0.0
92;2021-07-26;8125;9215;0;1036468;891138;0;75.5;64.9;0.0
92;2021-07-27;9662;9555;0;1046130;900693;0;76.2;65.6;0.0
92;2021-07-28;9402;8289;0;1055532;908982;0;76.9;66.2;0.0
92;2021-07-29;9031;8498;0;1064563;917480;0;77.5;66.8;0.0
92;2021-07-30;8215;8379;0;1072778;925859;0;78.1;67.4;0.0
92;2021-07-31;4932;4863;0;1077710;930722;0;78.5;67.8;0.0
92;2021-08-01;2110;1697;0;1079820;932419;0;78.7;67.9;0.0
92;2021-08-02;5358;5549;0;1085178;937968;0;79.0;68.3;0.0
92;2021-08-03;5653;6784;0;1090831;944752;0;79.5;68.8;0.0
92;2021-08-04;5303;5635;0;1096134;950387;0;79.8;69.2;0.0
92;2021-08-05;4726;6179;0;1100860;956566;0;80.2;69.7;0.0
92;2021-08-06;4932;6741;0;1105792;963307;0;80.6;70.2;0.0
92;2021-08-07;2813;4252;0;1108605;967559;0;80.8;70.5;0.0
92;2021-08-08;1048;1532;0;1109653;969091;0;80.8;70.6;0.0
92;2021-08-09;3614;5405;0;1113267;974496;0;81.1;71.0;0.0
92;2021-08-10;4189;6745;0;1117456;981241;0;81.4;71.5;0.0
92;2021-08-11;3550;5607;0;1121006;986848;0;81.7;71.9;0.0
92;2021-08-12;3499;6200;0;1124505;993048;0;81.9;72.3;0.0
92;2021-08-13;3115;5730;0;1127620;998778;0;82.1;72.8;0.0
92;2021-08-14;1906;4089;0;1129526;1002867;0;82.3;73.1;0.0
92;2021-08-15;573;935;0;1130099;1003802;0;82.3;73.1;0.0
92;2021-08-16;2545;6232;0;1132644;1010034;0;82.5;73.6;0.0
92;2021-08-17;2941;7571;0;1135585;1017605;0;82.7;74.1;0.0
92;2021-08-18;2496;6040;0;1138081;1023645;0;82.9;74.6;0.0
92;2021-08-19;2549;6131;0;1140630;1029776;0;83.1;75.0;0.0
92;2021-08-20;2323;5883;0;1142953;1035659;0;83.3;75.4;0.0
92;2021-08-21;1362;4292;0;1144315;1039951;0;83.4;75.8;0.0
92;2021-08-22;420;1683;0;1144735;1041634;0;83.4;75.9;0.0
92;2021-08-23;2327;6971;0;1147062;1048605;0;83.6;76.4;0.0
92;2021-08-24;2819;8295;0;1149881;1056900;0;83.8;77.0;0.0
92;2021-08-25;2700;7260;0;1152581;1064160;0;84.0;77.5;0.0
92;2021-08-26;2702;6878;0;1155283;1071038;0;84.2;78.0;0.0
92;2021-08-27;2640;6820;0;1157923;1077858;0;84.3;78.5;0.0
92;2021-08-28;1565;4478;0;1159488;1082336;0;84.5;78.8;0.0
92;2021-08-29;339;979;0;1159827;1083315;0;84.5;78.9;0.0
92;2021-08-30;2136;5334;198;1161963;1088649;198;84.6;79.3;0.0
92;2021-08-31;2726;6418;446;1164689;1095067;644;84.8;79.8;0.0
92;2021-09-01;3144;5634;855;1167833;1100701;1499;85.1;80.2;0.1
92;2021-09-02;2458;4769;846;1170291;1105470;2345;85.2;80.5;0.2
92;2021-09-03;2376;4734;1028;1172667;1110204;3373;85.4;80.9;0.2
92;2021-09-04;2049;4031;360;1174716;1114235;3733;85.6;81.2;0.3
92;2021-09-05;412;760;108;1175128;1114995;3841;85.6;81.2;0.3
92;2021-09-06;1178;2667;930;1176306;1117662;4771;85.7;81.4;0.3
92;2021-09-07;1412;2803;918;1177718;1120465;5689;85.8;81.6;0.4
92;2021-09-08;1902;3187;897;1179620;1123652;6586;85.9;81.9;0.5
92;2021-09-09;1103;2382;744;1180723;1126034;7330;86.0;82.0;0.5
92;2021-09-10;1635;3021;1155;1182358;1129055;8485;86.1;82.2;0.6
92;2021-09-11;1406;2552;261;1183764;1131607;8746;86.2;82.4;0.6
92;2021-09-12;212;435;51;1183976;1132042;8797;86.2;82.5;0.6
92;2021-09-13;1185;1937;1148;1185161;1133979;9945;86.3;82.6;0.7
92;2021-09-14;1102;2084;1333;1186263;1136063;11278;86.4;82.8;0.8
92;2021-09-15;1516;3212;1316;1187779;1139275;12594;86.5;83.0;0.9
92;2021-09-16;1017;1884;1208;1188796;1141159;13802;86.6;83.1;1.0
92;2021-09-17;1352;2745;1245;1190148;1143904;15047;86.7;83.3;1.1
92;2021-09-18;871;2134;322;1191019;1146038;15369;86.8;83.5;1.1
92;2021-09-19;142;284;22;1191161;1146322;15391;86.8;83.5;1.1
92;2021-09-20;746;1658;1175;1191907;1147980;16566;86.8;83.6;1.2
92;2021-09-21;729;1674;1358;1192636;1149654;17924;86.9;83.7;1.3
92;2021-09-22;1010;3467;1105;1193646;1153121;19029;87.0;84.0;1.4
92;2021-09-23;716;1695;1121;1194362;1154816;20150;87.0;84.1;1.5
92;2021-09-24;1019;2578;1083;1195381;1157394;21233;87.1;84.3;1.5
92;2021-09-25;638;2080;287;1196019;1159474;21520;87.1;84.5;1.6
92;2021-09-26;103;264;29;1196122;1159738;21549;87.1;84.5;1.6
92;2021-09-27;668;1444;991;1196790;1161182;22540;87.2;84.6;1.6
92;2021-09-28;690;1374;1040;1197480;1162556;23580;87.2;84.7;1.7
92;2021-09-29;983;2463;1165;1198463;1165019;24745;87.3;84.9;1.8
92;2021-09-30;807;1248;1113;1199270;1166267;25858;87.4;85.0;1.9
92;2021-10-01;1243;1910;1432;1200513;1168177;27290;87.5;85.1;2.0
92;2021-10-02;847;1579;412;1201360;1169756;27702;87.5;85.2;2.0
92;2021-10-03;98;206;46;1201458;1169962;27748;87.5;85.2;2.0
92;2021-10-04;707;1072;1364;1202165;1171034;29112;87.6;85.3;2.1
92;2021-10-05;663;1133;1663;1202828;1172167;30775;87.6;85.4;2.2
92;2021-10-06;949;1709;1933;1203777;1173876;32708;87.7;85.5;2.4
92;2021-10-07;524;896;1482;1204301;1174772;34190;87.7;85.6;2.5
92;2021-10-08;1035;1746;2138;1205336;1176518;36328;87.8;85.7;2.6
92;2021-10-09;686;1229;674;1206022;1177747;37002;87.9;85.8;2.7
92;2021-10-10;129;190;35;1206151;1177937;37037;87.9;85.8;2.7
92;2021-10-11;596;901;1453;1206747;1178838;38490;87.9;85.9;2.8
92;2021-10-12;698;1006;1771;1207445;1179844;40261;88.0;85.9;2.9
92;2021-10-13;891;1373;2344;1208336;1181217;42605;88.0;86.0;3.1
92;2021-10-14;559;844;1724;1208895;1182061;44329;88.1;86.1;3.2
92;2021-10-15;871;1359;2414;1209766;1183420;46743;88.1;86.2;3.4
92;2021-10-16;693;1062;955;1210459;1184482;47698;88.2;86.3;3.5
92;2021-10-17;78;150;74;1210537;1184632;47772;88.2;86.3;3.5
92;2021-10-18;479;728;1557;1211016;1185360;49329;88.2;86.3;3.6
92;2021-10-19;314;705;2081;1211330;1186065;51410;88.2;86.4;3.7
92;2021-10-20;409;938;2780;1211739;1187003;54190;88.3;86.5;3.9
92;2021-10-21;233;620;2019;1211972;1187623;56209;88.3;86.5;4.1
92;2021-10-22;383;1077;2749;1212355;1188700;58958;88.3;86.6;4.3
92;2021-10-23;280;796;1029;1212635;1189496;59987;88.3;86.6;4.4
92;2021-10-24;33;76;94;1212668;1189572;60081;88.3;86.7;4.4
92;2021-10-25;303;547;1953;1212971;1190119;62034;88.4;86.7;4.5
92;2021-10-26;306;631;2297;1213277;1190750;64331;88.4;86.7;4.7
92;2021-10-27;333;834;3183;1213610;1191584;67514;88.4;86.8;4.9
92;2021-10-28;218;460;2167;1213828;1192044;69681;88.4;86.8;5.1
92;2021-10-29;311;773;3027;1214139;1192817;72708;88.4;86.9;5.3
92;2021-10-30;212;610;1153;1214351;1193427;73861;88.5;86.9;5.4
92;2021-10-31;22;81;71;1214373;1193508;73932;88.5;86.9;5.4
92;2021-11-01;85;96;128;1214458;1193604;74060;88.5;86.9;5.4
92;2021-11-02;288;709;2072;1214746;1194313;76132;88.5;87.0;5.5
92;2021-11-03;290;770;2620;1215036;1195083;78752;88.5;87.1;5.7
92;2021-11-04;238;552;2316;1215274;1195635;81068;88.5;87.1;5.9
92;2021-11-05;309;702;2942;1215583;1196337;84010;88.5;87.1;6.1
92;2021-11-06;196;499;1025;1215779;1196836;85035;88.6;87.2;6.2
92;2021-11-07;26;92;89;1215805;1196928;85124;88.6;87.2;6.2
92;2021-11-08;158;485;2729;1215963;1197413;87853;88.6;87.2;6.4
92;2021-11-09;214;534;3548;1216177;1197947;91401;88.6;87.3;6.7
92;2021-11-10;335;663;4317;1216512;1198610;95718;88.6;87.3;7.0
92;2021-11-11;69;115;509;1216581;1198725;96227;88.6;87.3;7.0
92;2021-11-12;245;538;4112;1216826;1199263;100339;88.6;87.4;7.3
92;2021-11-13;204;301;1541;1217030;1199564;101880;88.7;87.4;7.4
92;2021-11-14;33;51;148;1217063;1199615;102028;88.7;87.4;7.4
92;2021-11-15;208;361;3609;1217271;1199976;105637;88.7;87.4;7.7
92;2021-11-16;223;382;3701;1217494;1200358;109338;88.7;87.4;8.0
92;2021-11-17;325;497;3936;1217819;1200855;113274;88.7;87.5;8.3
92;2021-11-18;231;416;4131;1218050;1201271;117405;88.7;87.5;8.6
92;2021-11-19;374;520;5248;1218424;1201791;122653;88.8;87.5;8.9
92;2021-11-20;240;360;1870;1218664;1202151;124523;88.8;87.6;9.1
92;2021-11-21;25;60;229;1218689;1202211;124752;88.8;87.6;9.1
92;2021-11-22;205;317;3738;1218894;1202528;128490;88.8;87.6;9.4
92;2021-11-23;256;339;4414;1219150;1202867;132904;88.8;87.6;9.7
92;2021-11-24;351;496;4885;1219501;1203363;137789;88.8;87.7;10.0
92;2021-11-25;244;339;6188;1219745;1203702;143977;88.9;87.7;10.5
92;2021-11-26;313;512;10406;1220058;1204214;154383;88.9;87.7;11.2
92;2021-11-27;224;293;6164;1220282;1204507;160547;88.9;87.7;11.7
92;2021-11-28;52;112;3888;1220334;1204619;164435;88.9;87.8;12.0
92;2021-11-29;188;314;9525;1220522;1204933;173960;88.9;87.8;12.7
92;2021-11-30;236;362;12950;1220758;1205295;186910;88.9;87.8;13.6
92;2021-12-01;227;391;14293;1220985;1205686;201203;88.9;87.8;14.7
92;2021-12-02;192;308;15235;1221177;1205994;216438;89.0;87.9;15.8
92;2021-12-03;235;417;18293;1221412;1206411;234731;89.0;87.9;17.1
92;2021-12-04;174;325;11360;1221586;1206736;246091;89.0;87.9;17.9
92;2021-12-05;67;93;4070;1221653;1206829;250161;89.0;87.9;18.2
92;2021-12-06;157;335;13791;1221810;1207164;263952;89.0;87.9;19.2
92;2021-12-07;204;365;17993;1222014;1207529;281945;89.0;88.0;20.5
92;2021-12-08;257;489;17210;1222271;1208018;299155;89.0;88.0;21.8
92;2021-12-09;225;388;18574;1222496;1208406;317729;89.1;88.0;23.1
92;2021-12-10;249;484;20739;1222745;1208890;338468;89.1;88.1;24.7
92;2021-12-11;209;369;13399;1222954;1209259;351867;89.1;88.1;25.6
92;2021-12-12;58;110;5808;1223012;1209369;357675;89.1;88.1;26.1
92;2021-12-13;182;385;17157;1223194;1209754;374832;89.1;88.1;27.3
92;2021-12-14;248;401;21515;1223442;1210155;396347;89.1;88.2;28.9
92;2021-12-15;293;493;19568;1223735;1210648;415915;89.1;88.2;30.3
92;2021-12-16;281;441;21739;1224016;1211089;437654;89.2;88.2;31.9
92;2021-12-17;313;541;22397;1224329;1211630;460051;89.2;88.3;33.5
92;2021-12-18;211;289;12607;1224540;1211919;472658;89.2;88.3;34.4
92;2021-12-19;134;157;7411;1224674;1212076;480069;89.2;88.3;35.0
93;2020-12-27;7;3;0;7;3;0;0.0;0.0;0.0
93;2020-12-28;2;0;0;9;3;0;0.0;0.0;0.0
93;2020-12-29;0;0;0;9;3;0;0.0;0.0;0.0
93;2020-12-30;27;1;0;36;4;0;0.0;0.0;0.0
93;2020-12-31;7;0;0;43;4;0;0.0;0.0;0.0
93;2021-01-01;15;0;0;58;4;0;0.0;0.0;0.0
93;2021-01-02;5;0;0;63;4;0;0.0;0.0;0.0
93;2021-01-03;6;0;0;69;4;0;0.0;0.0;0.0
93;2021-01-04;18;1;0;87;5;0;0.0;0.0;0.0
93;2021-01-05;95;2;0;182;7;0;0.0;0.0;0.0
93;2021-01-06;138;3;0;320;10;0;0.0;0.0;0.0
93;2021-01-07;363;5;0;683;15;0;0.1;0.0;0.0
93;2021-01-08;503;4;0;1186;19;0;0.1;0.0;0.0
93;2021-01-09;43;0;0;1229;19;0;0.1;0.0;0.0
93;2021-01-10;57;0;0;1286;19;0;0.1;0.0;0.0
93;2021-01-11;508;4;0;1794;23;0;0.1;0.0;0.0
93;2021-01-12;734;6;0;2528;29;0;0.2;0.0;0.0
93;2021-01-13;713;10;0;3241;39;0;0.2;0.0;0.0
93;2021-01-14;661;15;0;3902;54;0;0.3;0.0;0.0
93;2021-01-15;570;7;0;4472;61;0;0.3;0.0;0.0
93;2021-01-16;125;3;0;4597;64;0;0.3;0.0;0.0
93;2021-01-17;62;2;0;4659;66;0;0.3;0.0;0.0
93;2021-01-18;974;19;0;5633;85;0;0.4;0.0;0.0
93;2021-01-19;1287;16;0;6920;101;0;0.5;0.0;0.0
93;2021-01-20;1335;23;0;8255;124;0;0.6;0.0;0.0
93;2021-01-21;1614;37;0;9869;161;0;0.7;0.0;0.0
93;2021-01-22;1207;27;0;11076;188;0;0.8;0.0;0.0
93;2021-01-23;576;6;0;11652;194;0;0.9;0.0;0.0
93;2021-01-24;56;0;0;11708;194;0;0.9;0.0;0.0
93;2021-01-25;851;10;0;12559;204;0;0.9;0.0;0.0
93;2021-01-26;1016;30;0;13575;234;0;1.0;0.0;0.0
93;2021-01-27;1694;75;0;15269;309;0;1.1;0.0;0.0
93;2021-01-28;1827;144;0;17096;453;0;1.3;0.0;0.0
93;2021-01-29;1376;171;0;18472;624;0;1.4;0.0;0.0
93;2021-01-30;695;29;0;19167;653;0;1.4;0.0;0.0
93;2021-01-31;24;4;0;19191;657;0;1.4;0.0;0.0
93;2021-02-01;748;111;0;19939;768;0;1.5;0.1;0.0
93;2021-02-02;791;232;0;20730;1000;0;1.5;0.1;0.0
93;2021-02-03;861;317;0;21591;1317;0;1.6;0.1;0.0
93;2021-02-04;710;382;0;22301;1699;0;1.6;0.1;0.0
93;2021-02-05;652;332;0;22953;2031;0;1.7;0.1;0.0
93;2021-02-06;509;52;0;23462;2083;0;1.7;0.2;0.0
93;2021-02-07;18;23;0;23480;2106;0;1.7;0.2;0.0
93;2021-02-08;678;512;0;24158;2618;0;1.8;0.2;0.0
93;2021-02-09;650;629;0;24808;3247;0;1.8;0.2;0.0
93;2021-02-10;740;760;0;25548;4007;0;1.9;0.3;0.0
93;2021-02-11;984;1003;0;26532;5010;0;1.9;0.4;0.0
93;2021-02-12;933;689;0;27465;5699;0;2.0;0.4;0.0
93;2021-02-13;321;248;0;27786;5947;0;2.0;0.4;0.0
93;2021-02-14;21;68;0;27807;6015;0;2.0;0.4;0.0
93;2021-02-15;423;918;0;28230;6933;0;2.1;0.5;0.0
93;2021-02-16;517;1166;0;28747;8099;0;2.1;0.6;0.0
93;2021-02-17;579;1428;0;29326;9527;0;2.2;0.7;0.0
93;2021-02-18;1017;1704;0;30343;11231;0;2.2;0.8;0.0
93;2021-02-19;939;1427;0;31282;12658;0;2.3;0.9;0.0
93;2021-02-20;233;545;0;31515;13203;0;2.3;1.0;0.0
93;2021-02-21;23;45;0;31538;13248;0;2.3;1.0;0.0
93;2021-02-22;539;903;0;32077;14151;0;2.4;1.0;0.0
93;2021-02-23;522;847;0;32599;14998;0;2.4;1.1;0.0
93;2021-02-24;610;951;0;33209;15949;0;2.4;1.2;0.0
93;2021-02-25;928;999;0;34137;16948;0;2.5;1.2;0.0
93;2021-02-26;1133;820;0;35270;17768;0;2.6;1.3;0.0
93;2021-02-27;520;463;0;35790;18231;0;2.6;1.3;0.0
93;2021-02-28;83;49;0;35873;18280;0;2.6;1.3;0.0
93;2021-03-01;979;722;0;36852;19002;0;2.7;1.4;0.0
93;2021-03-02;1410;822;0;38262;19824;0;2.8;1.5;0.0
93;2021-03-03;1698;842;0;39960;20666;0;2.9;1.5;0.0
93;2021-03-04;2584;918;0;42544;21584;0;3.1;1.6;0.0
93;2021-03-05;3559;833;0;46103;22417;0;3.4;1.6;0.0
93;2021-03-06;4108;495;0;50211;22912;0;3.7;1.7;0.0
93;2021-03-07;3202;287;0;53413;23199;0;3.9;1.7;0.0
93;2021-03-08;2024;895;0;55437;24094;0;4.1;1.8;0.0
93;2021-03-09;2744;736;0;58181;24830;0;4.3;1.8;0.0
93;2021-03-10;2849;829;0;61030;25659;0;4.5;1.9;0.0
93;2021-03-11;3640;1068;0;64670;26727;0;4.7;2.0;0.0
93;2021-03-12;4165;1123;0;68835;27850;0;5.0;2.0;0.0
93;2021-03-13;3738;506;0;72573;28356;0;5.3;2.1;0.0
93;2021-03-14;1124;104;0;73697;28460;0;5.4;2.1;0.0
93;2021-03-15;3012;554;0;76709;29014;0;5.6;2.1;0.0
93;2021-03-16;2647;493;0;79356;29507;0;5.8;2.2;0.0
93;2021-03-17;2244;559;0;81600;30066;0;6.0;2.2;0.0
93;2021-03-18;2769;645;0;84369;30711;0;6.2;2.3;0.0
93;2021-03-19;3342;597;0;87711;31308;0;6.4;2.3;0.0
93;2021-03-20;2765;280;0;90476;31588;0;6.6;2.3;0.0
93;2021-03-21;789;197;0;91265;31785;0;6.7;2.3;0.0
93;2021-03-22;3391;571;0;94656;32356;0;6.9;2.4;0.0
93;2021-03-23;4287;725;0;98943;33081;0;7.3;2.4;0.0
93;2021-03-24;4023;679;0;102966;33760;0;7.6;2.5;0.0
93;2021-03-25;5426;792;0;108392;34552;0;7.9;2.5;0.0
93;2021-03-26;5289;816;0;113681;35368;0;8.3;2.6;0.0
93;2021-03-27;3769;297;0;117450;35665;0;8.6;2.6;0.0
93;2021-03-28;834;63;0;118284;35728;0;8.7;2.6;0.0
93;2021-03-29;3531;939;0;121815;36667;0;8.9;2.7;0.0
93;2021-03-30;4387;1242;0;126202;37909;0;9.3;2.8;0.0
93;2021-03-31;3939;1281;0;130141;39190;0;9.5;2.9;0.0
93;2021-04-01;4229;2693;0;134370;41883;0;9.9;3.1;0.0
93;2021-04-02;3492;2858;0;137862;44741;0;10.1;3.3;0.0
93;2021-04-03;2258;1798;0;140120;46539;0;10.3;3.4;0.0
93;2021-04-04;811;230;0;140931;46769;0;10.3;3.4;0.0
93;2021-04-05;811;122;0;141742;46891;0;10.4;3.4;0.0
93;2021-04-06;3742;2034;0;145484;48925;0;10.7;3.6;0.0
93;2021-04-07;4016;1929;0;149500;50854;0;11.0;3.7;0.0
93;2021-04-08;4842;2386;0;154342;53240;0;11.3;3.9;0.0
93;2021-04-09;5258;2700;0;159600;55940;0;11.7;4.1;0.0
93;2021-04-10;3220;2074;0;162820;58014;0;11.9;4.3;0.0
93;2021-04-11;778;591;0;163598;58605;0;12.0;4.3;0.0
93;2021-04-12;3725;2239;0;167323;60844;0;12.3;4.5;0.0
93;2021-04-13;4015;3198;0;171338;64042;0;12.6;4.7;0.0
93;2021-04-14;3763;2157;0;175101;66199;0;12.8;4.9;0.0
93;2021-04-15;4099;2727;0;179200;68926;0;13.1;5.1;0.0
93;2021-04-16;3757;2522;0;182957;71448;0;13.4;5.2;0.0
93;2021-04-17;2549;1963;0;185506;73411;0;13.6;5.4;0.0
93;2021-04-18;468;513;0;185974;73924;0;13.6;5.4;0.0
93;2021-04-19;2897;2414;0;188871;76338;0;13.8;5.6;0.0
93;2021-04-20;3241;2886;0;192112;79224;0;14.1;5.8;0.0
93;2021-04-21;3050;2610;0;195162;81834;0;14.3;6.0;0.0
93;2021-04-22;3528;3680;0;198690;85514;0;14.6;6.3;0.0
93;2021-04-23;3740;3076;0;202430;88590;0;14.8;6.5;0.0
93;2021-04-24;3628;2680;0;206058;91270;0;15.1;6.7;0.0
93;2021-04-25;1409;738;0;207467;92008;0;15.2;6.7;0.0
93;2021-04-26;3625;2788;0;211092;94796;0;15.5;7.0;0.0
93;2021-04-27;5110;3164;0;216202;97960;0;15.9;7.2;0.0
93;2021-04-28;4692;3068;0;220894;101028;0;16.2;7.4;0.0
93;2021-04-29;6044;3076;0;226938;104104;0;16.6;7.6;0.0
93;2021-04-30;6569;3064;0;233507;107168;0;17.1;7.9;0.0
93;2021-05-01;3017;917;0;236524;108085;0;17.3;7.9;0.0
93;2021-05-02;952;751;0;237476;108836;0;17.4;8.0;0.0
93;2021-05-03;6045;4474;0;243521;113310;0;17.9;8.3;0.0
93;2021-05-04;6072;4289;0;249593;117599;0;18.3;8.6;0.0
93;2021-05-05;6047;3605;0;255640;121204;0;18.7;8.9;0.0
93;2021-05-06;6856;3994;0;262496;125198;0;19.2;9.2;0.0
93;2021-05-07;5702;4339;0;268198;129537;0;19.7;9.5;0.0
93;2021-05-08;5453;2151;0;273651;131688;0;20.1;9.7;0.0
93;2021-05-09;3654;1386;0;277305;133074;0;20.3;9.8;0.0
93;2021-05-10;7196;3556;0;284501;136630;0;20.9;10.0;0.0
93;2021-05-11;7578;4168;0;292079;140798;0;21.4;10.3;0.0
93;2021-05-12;7220;3216;0;299299;144014;0;21.9;10.6;0.0
93;2021-05-13;6073;1140;0;305372;145154;0;22.4;10.6;0.0
93;2021-05-14;8564;3013;0;313936;148167;0;23.0;10.9;0.0
93;2021-05-15;8549;2260;0;322485;150427;0;23.6;11.0;0.0
93;2021-05-16;4200;673;0;326685;151100;0;24.0;11.1;0.0
93;2021-05-17;8219;1903;0;334904;153003;0;24.6;11.2;0.0
93;2021-05-18;9134;2016;0;344038;155019;0;25.2;11.4;0.0
93;2021-05-19;8628;3037;0;352666;158056;0;25.9;11.6;0.0
93;2021-05-20;10020;3322;0;362686;161378;0;26.6;11.8;0.0
93;2021-05-21;9817;2745;0;372503;164123;0;27.3;12.0;0.0
93;2021-05-22;9212;1987;0;381715;166110;0;28.0;12.2;0.0
93;2021-05-23;5687;898;0;387402;167008;0;28.4;12.2;0.0
93;2021-05-24;7582;1442;0;394984;168450;0;29.0;12.4;0.0
93;2021-05-25;8242;4091;0;403226;172541;0;29.6;12.7;0.0
93;2021-05-26;8048;3410;0;411274;175951;0;30.2;12.9;0.0
93;2021-05-27;9331;3717;0;420605;179668;0;30.8;13.2;0.0
93;2021-05-28;9247;4700;0;429852;184368;0;31.5;13.5;0.0
93;2021-05-29;7837;3277;0;437689;187645;0;32.1;13.8;0.0
93;2021-05-30;5315;1224;0;443004;188869;0;32.5;13.8;0.0
93;2021-05-31;7080;4269;0;450084;193138;0;33.0;14.2;0.0
93;2021-06-01;8618;5181;0;458702;198319;0;33.6;14.5;0.0
93;2021-06-02;8017;4202;0;466719;202521;0;34.2;14.9;0.0
93;2021-06-03;8364;4473;0;475083;206994;0;34.8;15.2;0.0
93;2021-06-04;8680;5818;0;483763;212812;0;35.5;15.6;0.0
93;2021-06-05;7056;5073;0;490819;217885;0;36.0;16.0;0.0
93;2021-06-06;5212;1544;0;496031;219429;0;36.4;16.1;0.0
93;2021-06-07;7089;5811;0;503120;225240;0;36.9;16.5;0.0
93;2021-06-08;7861;6114;0;510981;231354;0;37.5;17.0;0.0
93;2021-06-09;7913;6204;0;518894;237558;0;38.1;17.4;0.0
93;2021-06-10;7114;8200;0;526008;245758;0;38.6;18.0;0.0
93;2021-06-11;7044;7601;0;533052;253359;0;39.1;18.6;0.0
93;2021-06-12;7332;5222;0;540384;258581;0;39.6;19.0;0.0
93;2021-06-13;4581;2119;0;544965;260700;0;40.0;19.1;0.0
93;2021-06-14;4764;7446;0;549729;268146;0;40.3;19.7;0.0
93;2021-06-15;5786;7975;0;555515;276121;0;40.7;20.2;0.0
93;2021-06-16;5708;7305;0;561223;283426;0;41.2;20.8;0.0
93;2021-06-17;5145;7349;0;566368;290775;0;41.5;21.3;0.0
93;2021-06-18;6091;9534;0;572459;300309;0;42.0;22.0;0.0
93;2021-06-19;5510;8283;0;577969;308592;0;42.4;22.6;0.0
93;2021-06-20;3128;4755;0;581097;313347;0;42.6;23.0;0.0
93;2021-06-21;3624;8302;0;584721;321649;0;42.9;23.6;0.0
93;2021-06-22;4064;9136;0;588785;330785;0;43.2;24.3;0.0
93;2021-06-23;4140;8735;0;592925;339520;0;43.5;24.9;0.0
93;2021-06-24;3911;8318;0;596836;347838;0;43.8;25.5;0.0
93;2021-06-25;4541;10775;0;601377;358613;0;44.1;26.3;0.0
93;2021-06-26;4100;10489;0;605477;369102;0;44.4;27.1;0.0
93;2021-06-27;2344;5147;0;607821;374249;0;44.6;27.4;0.0
93;2021-06-28;3405;9450;0;611226;383699;0;44.8;28.1;0.0
93;2021-06-29;3736;9532;0;614962;393231;0;45.1;28.8;0.0
93;2021-06-30;3869;9264;0;618831;402495;0;45.4;29.5;0.0
93;2021-07-01;4860;9411;0;623691;411906;0;45.7;30.2;0.0
93;2021-07-02;5061;10499;0;628752;422405;0;46.1;31.0;0.0
93;2021-07-03;4457;10421;0;633209;432826;0;46.4;31.7;0.0
93;2021-07-04;2380;6118;0;635589;438944;0;46.6;32.2;0.0
93;2021-07-05;4202;8616;0;639791;447560;0;46.9;32.8;0.0
93;2021-07-06;4474;9582;1;644265;457142;1;47.2;33.5;0.0
93;2021-07-07;4762;9724;0;649027;466866;1;47.6;34.2;0.0
93;2021-07-08;4742;9365;0;653769;476231;1;47.9;34.9;0.0
93;2021-07-09;5444;11101;0;659213;487332;1;48.3;35.7;0.0
93;2021-07-10;4788;10969;0;664001;498301;1;48.7;36.5;0.0
93;2021-07-11;2623;6515;0;666624;504816;1;48.9;37.0;0.0
93;2021-07-12;4799;10039;0;671423;514855;1;49.2;37.8;0.0
93;2021-07-13;8759;11828;0;680182;526683;1;49.9;38.6;0.0
93;2021-07-14;7005;5787;0;687187;532470;1;50.4;39.0;0.0
93;2021-07-15;9869;12385;1;697056;544855;2;51.1;40.0;0.0
93;2021-07-16;10472;11763;0;707528;556618;2;51.9;40.8;0.0
93;2021-07-17;8540;11150;0;716068;567768;2;52.5;41.6;0.0
93;2021-07-18;4804;6242;0;720872;574010;2;52.9;42.1;0.0
93;2021-07-19;7569;9493;0;728441;583503;2;53.4;42.8;0.0
93;2021-07-20;9909;9682;0;738350;593185;2;54.1;43.5;0.0
93;2021-07-21;11058;9665;0;749408;602850;2;55.0;44.2;0.0
93;2021-07-22;11230;8568;0;760638;611418;2;55.8;44.8;0.0
93;2021-07-23;11859;9828;0;772497;621246;2;56.6;45.6;0.0
93;2021-07-24;9593;8780;0;782090;630026;2;57.4;46.2;0.0
93;2021-07-25;5382;4777;0;787472;634803;2;57.7;46.6;0.0
93;2021-07-26;9637;7356;0;797109;642159;2;58.5;47.1;0.0
93;2021-07-27;11659;7272;1;808768;649431;3;59.3;47.6;0.0
93;2021-07-28;11607;7663;0;820375;657094;3;60.2;48.2;0.0
93;2021-07-29;10795;6721;0;831170;663815;3;60.9;48.7;0.0
93;2021-07-30;11012;7433;0;842182;671248;3;61.8;49.2;0.0
93;2021-07-31;8245;6409;0;850427;677657;3;62.4;49.7;0.0
93;2021-08-01;4531;3224;0;854958;680881;3;62.7;49.9;0.0
93;2021-08-02;7535;5511;0;862493;686392;3;63.2;50.3;0.0
93;2021-08-03;6705;6162;0;869198;692554;3;63.7;50.8;0.0
93;2021-08-04;6749;6570;0;875947;699124;3;64.2;51.3;0.0
93;2021-08-05;5538;6150;0;881485;705274;3;64.6;51.7;0.0
93;2021-08-06;6201;7340;0;887686;712614;3;65.1;52.3;0.0
93;2021-08-07;5103;6854;0;892789;719468;3;65.5;52.8;0.0
93;2021-08-08;2629;3728;0;895418;723196;3;65.7;53.0;0.0
93;2021-08-09;5558;6828;0;900976;730024;3;66.1;53.5;0.0
93;2021-08-10;5904;7632;0;906880;737656;3;66.5;54.1;0.0
93;2021-08-11;5615;7979;0;912495;745635;3;66.9;54.7;0.0
93;2021-08-12;5057;7656;0;917552;753291;3;67.3;55.2;0.0
93;2021-08-13;4754;7483;0;922306;760774;3;67.6;55.8;0.0
93;2021-08-14;3742;7306;0;926048;768080;3;67.9;56.3;0.0
93;2021-08-15;1440;2237;0;927488;770317;3;68.0;56.5;0.0
93;2021-08-16;4291;8899;0;931779;779216;3;68.3;57.1;0.0
93;2021-08-17;4775;9050;0;936554;788266;3;68.7;57.8;0.0
93;2021-08-18;4341;9128;0;940895;797394;3;69.0;58.5;0.0
93;2021-08-19;3717;7932;0;944612;805326;3;69.3;59.1;0.0
93;2021-08-20;3909;8945;0;948521;814271;3;69.6;59.7;0.0
93;2021-08-21;3027;8229;0;951548;822500;3;69.8;60.3;0.0
93;2021-08-22;1350;4213;0;952898;826713;3;69.9;60.6;0.0
93;2021-08-23;3439;8111;0;956337;834824;3;70.1;61.2;0.0
93;2021-08-24;3597;7726;0;959934;842550;3;70.4;61.8;0.0
93;2021-08-25;3486;7700;0;963420;850250;3;70.6;62.3;0.0
93;2021-08-26;3112;6466;0;966532;856716;3;70.9;62.8;0.0
93;2021-08-27;3362;7702;0;969894;864418;3;71.1;63.4;0.0
93;2021-08-28;2739;7130;0;972633;871548;3;71.3;63.9;0.0
93;2021-08-29;1235;3200;0;973868;874748;3;71.4;64.1;0.0
93;2021-08-30;2642;6684;94;976510;881432;97;71.6;64.6;0.0
93;2021-08-31;2761;6672;162;979271;888104;259;71.8;65.1;0.0
93;2021-09-01;3578;6101;323;982849;894205;582;72.1;65.6;0.0
93;2021-09-02;2710;4773;297;985559;898978;879;72.3;65.9;0.1
93;2021-09-03;2675;5841;330;988234;904819;1209;72.5;66.4;0.1
93;2021-09-04;2857;5981;243;991091;910800;1452;72.7;66.8;0.1
93;2021-09-05;945;2049;87;992036;912849;1539;72.7;66.9;0.1
93;2021-09-06;1658;3850;312;993694;916699;1851;72.9;67.2;0.1
93;2021-09-07;1750;3656;252;995444;920355;2103;73.0;67.5;0.2
93;2021-09-08;2186;3994;332;997630;924349;2435;73.2;67.8;0.2
93;2021-09-09;1883;3318;364;999513;927667;2799;73.3;68.0;0.2
93;2021-09-10;2672;3984;376;1002185;931651;3175;73.5;68.3;0.2
93;2021-09-11;2013;4628;188;1004198;936279;3363;73.6;68.7;0.2
93;2021-09-12;632;1581;74;1004830;937860;3437;73.7;68.8;0.3
93;2021-09-13;1954;2971;459;1006784;940831;3896;73.8;69.0;0.3
93;2021-09-14;1894;2783;618;1008678;943614;4514;74.0;69.2;0.3
93;2021-09-15;1923;3096;588;1010601;946710;5102;74.1;69.4;0.4
93;2021-09-16;1604;2317;489;1012205;949027;5591;74.2;69.6;0.4
93;2021-09-17;1864;3187;542;1014069;952214;6133;74.4;69.8;0.4
93;2021-09-18;1373;3766;359;1015442;955980;6492;74.5;70.1;0.5
93;2021-09-19;382;1241;97;1015824;957221;6589;74.5;70.2;0.5
93;2021-09-20;1197;1933;447;1017021;959154;7036;74.6;70.3;0.5
93;2021-09-21;1009;1847;449;1018030;961001;7485;74.7;70.5;0.5
93;2021-09-22;1249;2771;550;1019279;963772;8035;74.7;70.7;0.6
93;2021-09-23;1002;1668;513;1020281;965440;8548;74.8;70.8;0.6
93;2021-09-24;1297;2566;631;1021578;968006;9179;74.9;71.0;0.7
93;2021-09-25;1151;3389;264;1022729;971395;9443;75.0;71.2;0.7
93;2021-09-26;295;1038;81;1023024;972433;9524;75.0;71.3;0.7
93;2021-09-27;860;1582;467;1023884;974015;9991;75.1;71.4;0.7
93;2021-09-28;896;1370;498;1024780;975385;10489;75.1;71.5;0.8
93;2021-09-29;1134;2181;599;1025914;977566;11088;75.2;71.7;0.8
93;2021-09-30;877;1572;635;1026791;979138;11723;75.3;71.8;0.9
93;2021-10-01;2080;2020;663;1028871;981158;12386;75.4;71.9;0.9
93;2021-10-02;1381;2081;363;1030252;983239;12749;75.5;72.1;0.9
93;2021-10-03;237;494;97;1030489;983733;12846;75.6;72.1;0.9
93;2021-10-04;1072;1488;706;1031561;985221;13552;75.6;72.2;1.0
93;2021-10-05;890;1353;563;1032451;986574;14115;75.7;72.3;1.0
93;2021-10-06;1110;1718;937;1033561;988292;15052;75.8;72.5;1.1
93;2021-10-07;881;1535;937;1034442;989827;15989;75.9;72.6;1.2
93;2021-10-08;1132;1843;972;1035574;991670;16961;75.9;72.7;1.2
93;2021-10-09;1261;2017;612;1036835;993687;17573;76.0;72.9;1.3
93;2021-10-10;259;423;110;1037094;994110;17683;76.1;72.9;1.3
93;2021-10-11;927;1442;851;1038021;995552;18534;76.1;73.0;1.4
93;2021-10-12;775;1241;951;1038796;996793;19485;76.2;73.1;1.4
93;2021-10-13;1024;1539;1118;1039820;998332;20603;76.3;73.2;1.5
93;2021-10-14;848;1327;1059;1040668;999659;21662;76.3;73.3;1.6
93;2021-10-15;1125;1616;1201;1041793;1001275;22863;76.4;73.4;1.7
93;2021-10-16;1071;1561;686;1042864;1002836;23549;76.5;73.5;1.7
93;2021-10-17;213;303;164;1043077;1003139;23713;76.5;73.6;1.7
93;2021-10-18;734;1193;938;1043811;1004332;24651;76.5;73.6;1.8
93;2021-10-19;704;1119;917;1044515;1005451;25568;76.6;73.7;1.9
93;2021-10-20;719;1076;1425;1045234;1006527;26993;76.6;73.8;2.0
93;2021-10-21;551;972;1277;1045785;1007499;28270;76.7;73.9;2.1
93;2021-10-22;791;1291;1373;1046576;1008790;29643;76.7;74.0;2.2
93;2021-10-23;813;1265;961;1047389;1010055;30604;76.8;74.1;2.2
93;2021-10-24;164;247;165;1047553;1010302;30769;76.8;74.1;2.3
93;2021-10-25;528;912;1110;1048081;1011214;31879;76.9;74.2;2.3
93;2021-10-26;497;821;1117;1048578;1012035;32996;76.9;74.2;2.4
93;2021-10-27;646;1009;1566;1049224;1013044;34562;76.9;74.3;2.5
93;2021-10-28;568;934;1433;1049792;1013978;35995;77.0;74.4;2.6
93;2021-10-29;602;1039;1468;1050394;1015017;37463;77.0;74.4;2.7
93;2021-10-30;612;1235;1046;1051006;1016252;38509;77.1;74.5;2.8
93;2021-10-31;153;244;177;1051159;1016496;38686;77.1;74.5;2.8
93;2021-11-01;238;204;90;1051397;1016700;38776;77.1;74.6;2.8
93;2021-11-02;613;883;1057;1052010;1017583;39833;77.1;74.6;2.9
93;2021-11-03;551;1021;1320;1052561;1018604;41153;77.2;74.7;3.0
93;2021-11-04;506;843;1278;1053067;1019447;42431;77.2;74.8;3.1
93;2021-11-05;549;946;1345;1053616;1020393;43776;77.3;74.8;3.2
93;2021-11-06;559;970;957;1054175;1021363;44733;77.3;74.9;3.3
93;2021-11-07;91;221;174;1054266;1021584;44907;77.3;74.9;3.3
93;2021-11-08;399;730;1529;1054665;1022314;46436;77.3;75.0;3.4
93;2021-11-09;423;870;1928;1055088;1023184;48364;77.4;75.0;3.5
93;2021-11-10;603;1005;2525;1055691;1024189;50889;77.4;75.1;3.7
93;2021-11-11;169;244;483;1055860;1024433;51372;77.4;75.1;3.8
93;2021-11-12;576;914;2727;1056436;1025347;54099;77.5;75.2;4.0
93;2021-11-13;550;805;1511;1056986;1026152;55610;77.5;75.2;4.1
93;2021-11-14;94;202;287;1057080;1026354;55897;77.5;75.3;4.1
93;2021-11-15;424;761;2509;1057504;1027115;58406;77.5;75.3;4.3
93;2021-11-16;474;722;2694;1057978;1027837;61100;77.6;75.4;4.5
93;2021-11-17;525;867;2341;1058503;1028704;63441;77.6;75.4;4.7
93;2021-11-18;426;692;2318;1058929;1029396;65759;77.7;75.5;4.8
93;2021-11-19;525;865;2925;1059454;1030261;68684;77.7;75.5;5.0
93;2021-11-20;699;1016;2086;1060153;1031277;70770;77.7;75.6;5.2
93;2021-11-21;106;234;385;1060259;1031511;71155;77.7;75.6;5.2
93;2021-11-22;397;605;2822;1060656;1032116;73977;77.8;75.7;5.4
93;2021-11-23;454;754;2928;1061110;1032870;76905;77.8;75.7;5.6
93;2021-11-24;555;846;2890;1061665;1033716;79795;77.9;75.8;5.9
93;2021-11-25;440;693;3995;1062105;1034409;83790;77.9;75.9;6.1
93;2021-11-26;525;870;6376;1062630;1035279;90166;77.9;75.9;6.6
93;2021-11-27;548;819;5518;1063178;1036098;95684;78.0;76.0;7.0
93;2021-11-28;162;267;2208;1063340;1036365;97892;78.0;76.0;7.2
93;2021-11-29;349;634;6771;1063689;1036999;104663;78.0;76.0;7.7
93;2021-11-30;382;662;8288;1064071;1037661;112951;78.0;76.1;8.3
93;2021-12-01;423;781;8261;1064494;1038442;121212;78.1;76.1;8.9
93;2021-12-02;385;636;8048;1064879;1039078;129260;78.1;76.2;9.5
93;2021-12-03;413;783;9995;1065292;1039861;139255;78.1;76.3;10.2
93;2021-12-04;414;784;7589;1065706;1040645;146844;78.1;76.3;10.8
93;2021-12-05;157;278;3324;1065863;1040923;150168;78.2;76.3;11.0
93;2021-12-06;372;690;8744;1066235;1041613;158912;78.2;76.4;11.7
93;2021-12-07;413;767;9981;1066648;1042380;168893;78.2;76.4;12.4
93;2021-12-08;462;834;10234;1067110;1043214;179127;78.3;76.5;13.1
93;2021-12-09;428;710;9508;1067538;1043924;188635;78.3;76.6;13.8
93;2021-12-10;499;822;12529;1068037;1044746;201164;78.3;76.6;14.8
93;2021-12-11;457;845;9642;1068494;1045591;210806;78.4;76.7;15.5
93;2021-12-12;215;347;5549;1068709;1045938;216355;78.4;76.7;15.9
93;2021-12-13;419;730;10182;1069128;1046668;226537;78.4;76.8;16.6
93;2021-12-14;474;706;12073;1069602;1047374;238610;78.4;76.8;17.5
93;2021-12-15;473;730;11530;1070075;1048104;250140;78.5;76.9;18.3
93;2021-12-16;432;704;10877;1070507;1048808;261017;78.5;76.9;19.1
93;2021-12-17;520;769;13229;1071027;1049577;274246;78.5;77.0;20.1
93;2021-12-18;543;721;10949;1071570;1050298;285195;78.6;77.0;20.9
93;2021-12-19;282;314;6245;1071852;1050612;291440;78.6;77.0;21.4
94;2020-12-27;13;0;0;13;0;0;0.0;0.0;0.0
94;2020-12-28;9;1;0;22;1;0;0.0;0.0;0.0
94;2020-12-29;3;0;0;25;1;0;0.0;0.0;0.0
94;2020-12-30;10;0;0;35;1;0;0.0;0.0;0.0
94;2020-12-31;13;2;0;48;3;0;0.0;0.0;0.0
94;2021-01-01;14;0;0;62;3;0;0.0;0.0;0.0
94;2021-01-02;10;0;0;72;3;0;0.0;0.0;0.0
94;2021-01-03;12;0;0;84;3;0;0.0;0.0;0.0
94;2021-01-04;65;1;0;149;4;0;0.0;0.0;0.0
94;2021-01-05;262;2;0;411;6;0;0.0;0.0;0.0
94;2021-01-06;376;6;0;787;12;0;0.1;0.0;0.0
94;2021-01-07;728;7;0;1515;19;0;0.1;0.0;0.0
94;2021-01-08;946;10;0;2461;29;0;0.2;0.0;0.0
94;2021-01-09;132;0;0;2593;29;0;0.2;0.0;0.0
94;2021-01-10;100;0;0;2693;29;0;0.2;0.0;0.0
94;2021-01-11;1043;12;0;3736;41;0;0.3;0.0;0.0
94;2021-01-12;1297;17;0;5033;58;0;0.4;0.0;0.0
94;2021-01-13;1312;17;0;6345;75;0;0.5;0.0;0.0
94;2021-01-14;1361;23;0;7706;98;0;0.6;0.0;0.0
94;2021-01-15;1094;20;0;8800;118;0;0.7;0.0;0.0
94;2021-01-16;270;2;0;9070;120;0;0.8;0.0;0.0
94;2021-01-17;134;3;0;9204;123;0;0.8;0.0;0.0
94;2021-01-18;1443;27;0;10647;150;0;0.9;0.0;0.0
94;2021-01-19;1873;23;0;12520;173;0;1.1;0.0;0.0
94;2021-01-20;2165;29;0;14685;202;0;1.2;0.0;0.0
94;2021-01-21;2957;31;0;17642;233;0;1.5;0.0;0.0
94;2021-01-22;2116;19;0;19758;252;0;1.7;0.0;0.0
94;2021-01-23;745;5;0;20503;257;0;1.7;0.0;0.0
94;2021-01-24;272;1;0;20775;258;0;1.8;0.0;0.0
94;2021-01-25;1307;28;0;22082;286;0;1.9;0.0;0.0
94;2021-01-26;1540;27;0;23622;313;0;2.0;0.0;0.0
94;2021-01-27;1953;77;0;25575;390;0;2.2;0.0;0.0
94;2021-01-28;1924;148;0;27499;538;0;2.3;0.0;0.0
94;2021-01-29;1530;190;0;29029;728;0;2.4;0.1;0.0
94;2021-01-30;661;13;0;29690;741;0;2.5;0.1;0.0
94;2021-01-31;126;12;0;29816;753;0;2.5;0.1;0.0
94;2021-02-01;915;239;0;30731;992;0;2.6;0.1;0.0
94;2021-02-02;969;319;0;31700;1311;0;2.7;0.1;0.0
94;2021-02-03;854;395;0;32554;1706;0;2.7;0.1;0.0
94;2021-02-04;998;526;0;33552;2232;0;2.8;0.2;0.0
94;2021-02-05;989;570;0;34541;2802;0;2.9;0.2;0.0
94;2021-02-06;467;71;0;35008;2873;0;3.0;0.2;0.0
94;2021-02-07;115;13;0;35123;2886;0;3.0;0.2;0.0
94;2021-02-08;698;664;0;35821;3550;0;3.0;0.3;0.0
94;2021-02-09;1075;1135;0;36896;4685;0;3.1;0.4;0.0
94;2021-02-10;1105;1229;0;38001;5914;0;3.2;0.5;0.0
94;2021-02-11;1465;1857;0;39466;7771;0;3.3;0.7;0.0
94;2021-02-12;1371;1528;0;40837;9299;0;3.4;0.8;0.0
94;2021-02-13;300;244;0;41137;9543;0;3.5;0.8;0.0
94;2021-02-14;46;82;0;41183;9625;0;3.5;0.8;0.0
94;2021-02-15;679;1518;0;41862;11143;0;3.5;0.9;0.0
94;2021-02-16;693;2247;0;42555;13390;0;3.6;1.1;0.0
94;2021-02-17;642;1575;0;43197;14965;0;3.6;1.3;0.0
94;2021-02-18;942;1895;0;44139;16860;0;3.7;1.4;0.0
94;2021-02-19;920;1571;0;45059;18431;0;3.8;1.6;0.0
94;2021-02-20;180;859;0;45239;19290;0;3.8;1.6;0.0
94;2021-02-21;43;148;0;45282;19438;0;3.8;1.6;0.0
94;2021-02-22;482;1284;0;45764;20722;0;3.9;1.7;0.0
94;2021-02-23;641;1436;0;46405;22158;0;3.9;1.9;0.0
94;2021-02-24;656;1058;0;47061;23216;0;4.0;2.0;0.0
94;2021-02-25;1152;1645;0;48213;24861;0;4.1;2.1;0.0
94;2021-02-26;1311;1214;0;49524;26075;0;4.2;2.2;0.0
94;2021-02-27;594;595;0;50118;26670;0;4.2;2.2;0.0
94;2021-02-28;87;82;0;50205;26752;0;4.2;2.3;0.0
94;2021-03-01;948;999;0;51153;27751;0;4.3;2.3;0.0
94;2021-03-02;1603;1127;0;52756;28878;0;4.4;2.4;0.0
94;2021-03-03;2012;1126;0;54768;30004;0;4.6;2.5;0.0
94;2021-03-04;3024;1265;0;57792;31269;0;4.9;2.6;0.0
94;2021-03-05;4120;1428;0;61912;32697;0;5.2;2.8;0.0
94;2021-03-06;5153;639;0;67065;33336;0;5.7;2.8;0.0
94;2021-03-07;3928;526;0;70993;33862;0;6.0;2.9;0.0
94;2021-03-08;1857;891;0;72850;34753;0;6.1;2.9;0.0
94;2021-03-09;2719;1070;0;75569;35823;0;6.4;3.0;0.0
94;2021-03-10;3193;1127;0;78762;36950;0;6.6;3.1;0.0
94;2021-03-11;4128;1101;0;82890;38051;0;7.0;3.2;0.0
94;2021-03-12;4780;1002;0;87670;39053;0;7.4;3.3;0.0
94;2021-03-13;4443;454;0;92113;39507;0;7.8;3.3;0.0
94;2021-03-14;2158;151;0;94271;39658;0;7.9;3.3;0.0
94;2021-03-15;3311;734;0;97582;40392;0;8.2;3.4;0.0
94;2021-03-16;2807;501;0;100389;40893;0;8.5;3.4;0.0
94;2021-03-17;2896;447;0;103285;41340;0;8.7;3.5;0.0
94;2021-03-18;3396;463;0;106681;41803;0;9.0;3.5;0.0
94;2021-03-19;4444;645;0;111125;42448;0;9.4;3.6;0.0
94;2021-03-20;3697;316;0;114822;42764;0;9.7;3.6;0.0
94;2021-03-21;1164;290;0;115986;43054;0;9.8;3.6;0.0
94;2021-03-22;3425;644;0;119411;43698;0;10.1;3.7;0.0
94;2021-03-23;4742;743;0;124153;44441;0;10.5;3.7;0.0
94;2021-03-24;4924;673;0;129077;45114;0;10.9;3.8;0.0
94;2021-03-25;6583;780;0;135660;45894;0;11.4;3.9;0.0
94;2021-03-26;6335;809;0;141995;46703;0;12.0;3.9;0.0
94;2021-03-27;4514;314;0;146509;47017;0;12.4;4.0;0.0
94;2021-03-28;1499;94;0;148008;47111;0;12.5;4.0;0.0
94;2021-03-29;4101;1146;0;152109;48257;0;12.8;4.1;0.0
94;2021-03-30;5223;1411;0;157332;49668;0;13.3;4.2;0.0
94;2021-03-31;4769;1744;0;162101;51412;0;13.7;4.3;0.0
94;2021-04-01;5720;2355;0;167821;53767;0;14.2;4.5;0.0
94;2021-04-02;5245;2484;0;173066;56251;0;14.6;4.7;0.0
94;2021-04-03;2932;2437;0;175998;58688;0;14.8;4.9;0.0
94;2021-04-04;992;704;0;176990;59392;0;14.9;5.0;0.0
94;2021-04-05;779;189;0;177769;59581;0;15.0;5.0;0.0
94;2021-04-06;3574;2367;0;181343;61948;0;15.3;5.2;0.0
94;2021-04-07;3981;2224;0;185324;64172;0;15.6;5.4;0.0
94;2021-04-08;5007;2156;0;190331;66328;0;16.0;5.6;0.0
94;2021-04-09;5940;2594;0;196271;68922;0;16.6;5.8;0.0
94;2021-04-10;3239;3130;0;199510;72052;0;16.8;6.1;0.0
94;2021-04-11;1015;1593;0;200525;73645;0;16.9;6.2;0.0
94;2021-04-12;3551;2385;0;204076;76030;0;17.2;6.4;0.0
94;2021-04-13;4372;3305;0;208448;79335;0;17.6;6.7;0.0
94;2021-04-14;3809;2838;0;212257;82173;0;17.9;6.9;0.0
94;2021-04-15;4585;3231;0;216842;85404;0;18.3;7.2;0.0
94;2021-04-16;4844;3035;0;221686;88439;0;18.7;7.5;0.0
94;2021-04-17;2777;2591;0;224463;91030;0;18.9;7.7;0.0
94;2021-04-18;943;891;0;225406;91921;0;19.0;7.8;0.0
94;2021-04-19;3070;2619;0;228476;94540;0;19.3;8.0;0.0
94;2021-04-20;3321;3017;0;231797;97557;0;19.5;8.2;0.0
94;2021-04-21;3295;3323;0;235092;100880;0;19.8;8.5;0.0
94;2021-04-22;3914;3778;0;239006;104658;0;20.2;8.8;0.0
94;2021-04-23;4277;3909;0;243283;108567;0;20.5;9.2;0.0
94;2021-04-24;4325;3225;0;247608;111792;0;20.9;9.4;0.0
94;2021-04-25;2235;1100;0;249843;112892;0;21.1;9.5;0.0
94;2021-04-26;3933;3178;0;253776;116070;0;21.4;9.8;0.0
94;2021-04-27;5136;3480;0;258912;119550;0;21.8;10.1;0.0
94;2021-04-28;5174;3744;0;264086;123294;0;22.3;10.4;0.0
94;2021-04-29;6246;3873;0;270332;127167;0;22.8;10.7;0.0
94;2021-04-30;6420;3948;0;276752;131115;0;23.3;11.1;0.0
94;2021-05-01;4000;895;0;280752;132010;0;23.7;11.1;0.0
94;2021-05-02;2269;1137;0;283021;133147;0;23.9;11.2;0.0
94;2021-05-03;5765;5110;0;288786;138257;0;24.4;11.7;0.0
94;2021-05-04;6113;3773;0;294899;142030;0;24.9;12.0;0.0
94;2021-05-05;6196;3632;0;301095;145662;0;25.4;12.3;0.0
94;2021-05-06;6995;3939;0;308090;149601;0;26.0;12.6;0.0
94;2021-05-07;6506;4442;0;314596;154043;0;26.5;13.0;0.0
94;2021-05-08;5297;2444;0;319893;156487;0;27.0;13.2;0.0
94;2021-05-09;3846;1817;0;323739;158304;0;27.3;13.3;0.0
94;2021-05-10;7137;3307;0;330876;161611;0;27.9;13.6;0.0
94;2021-05-11;8453;4074;0;339329;165685;0;28.6;14.0;0.0
94;2021-05-12;9179;3791;0;348508;169476;0;29.4;14.3;0.0
94;2021-05-13;7985;1323;0;356493;170799;0;30.1;14.4;0.0
94;2021-05-14;9483;3231;0;365976;174030;0;30.9;14.7;0.0
94;2021-05-15;8323;2171;0;374299;176201;0;31.6;14.9;0.0
94;2021-05-16;3944;773;0;378243;176974;0;31.9;14.9;0.0
94;2021-05-17;9424;2234;0;387667;179208;0;32.7;15.1;0.0
94;2021-05-18;9887;2410;0;397554;181618;0;33.5;15.3;0.0
94;2021-05-19;9830;3465;0;407384;185083;0;34.4;15.6;0.0
94;2021-05-20;10365;3847;0;417749;188930;0;35.2;15.9;0.0
94;2021-05-21;10164;3022;0;427913;191952;0;36.1;16.2;0.0
94;2021-05-22;8790;1875;0;436703;193827;0;36.8;16.3;0.0
94;2021-05-23;4027;611;0;440730;194438;0;37.2;16.4;0.0
94;2021-05-24;7388;1106;0;448118;195544;0;37.8;16.5;0.0
94;2021-05-25;8258;3917;0;456376;199461;0;38.5;16.8;0.0
94;2021-05-26;8365;3336;0;464741;202797;0;39.2;17.1;0.0
94;2021-05-27;8661;4542;0;473402;207339;0;39.9;17.5;0.0
94;2021-05-28;8669;5002;0;482071;212341;0;40.7;17.9;0.0
94;2021-05-29;7858;3358;0;489929;215699;0;41.3;18.2;0.0
94;2021-05-30;3525;805;0;493454;216504;0;41.6;18.3;0.0
94;2021-05-31;8365;4127;0;501819;220631;0;42.3;18.6;0.0
94;2021-06-01;9005;5115;0;510824;225746;0;43.1;19.0;0.0
94;2021-06-02;8343;4716;0;519167;230462;0;43.8;19.4;0.0
94;2021-06-03;8777;5798;0;527944;236260;0;44.5;19.9;0.0
94;2021-06-04;9098;6596;0;537042;242856;0;45.3;20.5;0.0
94;2021-06-05;7068;5980;0;544110;248836;0;45.9;21.0;0.0
94;2021-06-06;3061;1711;0;547171;250547;0;46.1;21.1;0.0
94;2021-06-07;7338;5815;0;554509;256362;0;46.8;21.6;0.0
94;2021-06-08;7658;6333;0;562167;262695;0;47.4;22.2;0.0
94;2021-06-09;7462;6954;0;569629;269649;0;48.0;22.7;0.0
94;2021-06-10;7671;9769;0;577300;279418;0;48.7;23.6;0.0
94;2021-06-11;7109;7898;0;584409;287316;0;49.3;24.2;0.0
94;2021-06-12;8233;6345;0;592642;293661;0;50.0;24.8;0.0
94;2021-06-13;2735;2652;0;595377;296313;0;50.2;25.0;0.0
94;2021-06-14;5887;7900;0;601264;304213;0;50.7;25.7;0.0
94;2021-06-15;6681;8541;0;607945;312754;0;51.3;26.4;0.0
94;2021-06-16;6266;8025;0;614211;320779;0;51.8;27.1;0.0
94;2021-06-17;5907;8359;0;620118;329138;0;52.3;27.8;0.0
94;2021-06-18;5811;10718;0;625929;339856;0;52.8;28.7;0.0
94;2021-06-19;5162;8550;0;631091;348406;0;53.2;29.4;0.0
94;2021-06-20;1598;3492;0;632689;351898;0;53.4;29.7;0.0
94;2021-06-21;4416;9915;0;637105;361813;0;53.7;30.5;0.0
94;2021-06-22;4505;10096;0;641610;371909;0;54.1;31.4;0.0
94;2021-06-23;4214;10312;0;645824;382221;0;54.5;32.2;0.0
94;2021-06-24;4605;9606;0;650429;391827;0;54.8;33.0;0.0
94;2021-06-25;4177;12644;0;654606;404471;0;55.2;34.1;0.0
94;2021-06-26;3319;10676;0;657925;415147;0;55.5;35.0;0.0
94;2021-06-27;1074;4023;0;658999;419170;0;55.6;35.3;0.0
94;2021-06-28;3337;10395;0;662336;429565;0;55.9;36.2;0.0
94;2021-06-29;3808;11133;0;666144;440698;0;56.2;37.2;0.0
94;2021-06-30;4017;10329;0;670161;451027;0;56.5;38.0;0.0
94;2021-07-01;4672;10176;0;674833;461203;0;56.9;38.9;0.0
94;2021-07-02;4529;10983;0;679362;472186;0;57.3;39.8;0.0
94;2021-07-03;3523;10473;0;682885;482659;0;57.6;40.7;0.0
94;2021-07-04;1430;4102;0;684315;486761;0;57.7;41.0;0.0
94;2021-07-05;3808;9738;0;688123;496499;0;58.0;41.9;0.0
94;2021-07-06;4119;9762;0;692242;506261;0;58.4;42.7;0.0
94;2021-07-07;4309;10016;0;696551;516277;0;58.7;43.5;0.0
94;2021-07-08;4635;9430;0;701186;525707;0;59.1;44.3;0.0
94;2021-07-09;4740;10839;0;705926;536546;0;59.5;45.2;0.0
94;2021-07-10;3837;9667;0;709763;546213;0;59.9;46.1;0.0
94;2021-07-11;1533;3746;0;711296;549959;0;60.0;46.4;0.0
94;2021-07-12;3677;10810;0;714973;560769;0;60.3;47.3;0.0
94;2021-07-13;6239;11621;0;721212;572390;0;60.8;48.3;0.0
94;2021-07-14;4517;5167;0;725729;577557;0;61.2;48.7;0.0
94;2021-07-15;7209;11917;0;732938;589474;0;61.8;49.7;0.0
94;2021-07-16;7772;11134;0;740710;600608;0;62.5;50.6;0.0
94;2021-07-17;5962;10127;0;746672;610735;0;63.0;51.5;0.0
94;2021-07-18;2805;3377;0;749477;614112;0;63.2;51.8;0.0
94;2021-07-19;6533;9816;0;756010;623928;0;63.8;52.6;0.0
94;2021-07-20;8113;9877;0;764123;633805;0;64.4;53.4;0.0
94;2021-07-21;8723;9285;0;772846;643090;0;65.2;54.2;0.0
94;2021-07-22;9522;9058;1;782368;652148;1;66.0;55.0;0.0
94;2021-07-23;9069;9441;0;791437;661589;1;66.7;55.8;0.0
94;2021-07-24;7020;8201;0;798457;669790;1;67.3;56.5;0.0
94;2021-07-25;2489;2654;0;800946;672444;1;67.5;56.7;0.0
94;2021-07-26;7410;7963;0;808356;680407;1;68.2;57.4;0.0
94;2021-07-27;8539;7266;0;816895;687673;1;68.9;58.0;0.0
94;2021-07-28;8672;6785;0;825567;694458;1;69.6;58.6;0.0
94;2021-07-29;8698;6604;0;834265;701062;1;70.4;59.1;0.0
94;2021-07-30;7776;6774;0;842041;707836;1;71.0;59.7;0.0
94;2021-07-31;6353;5916;0;848394;713752;1;71.5;60.2;0.0
94;2021-08-01;2640;1709;0;851034;715461;1;71.8;60.3;0.0
94;2021-08-02;6328;5556;0;857362;721017;1;72.3;60.8;0.0
94;2021-08-03;6099;5521;0;863461;726538;1;72.8;61.3;0.0
94;2021-08-04;5817;5261;0;869278;731799;1;73.3;61.7;0.0
94;2021-08-05;5710;5681;0;874988;737480;1;73.8;62.2;0.0
94;2021-08-06;5315;5753;0;880303;743233;1;74.2;62.7;0.0
94;2021-08-07;4025;4474;0;884328;747707;1;74.6;63.1;0.0
94;2021-08-08;1288;1705;0;885616;749412;1;74.7;63.2;0.0
94;2021-08-09;4506;6264;0;890122;755676;1;75.1;63.7;0.0
94;2021-08-10;4892;6092;0;895014;761768;1;75.5;64.2;0.0
94;2021-08-11;3904;5740;0;898918;767508;1;75.8;64.7;0.0
94;2021-08-12;3993;6252;0;902911;773760;1;76.1;65.2;0.0
94;2021-08-13;3371;5540;0;906282;779300;1;76.4;65.7;0.0
94;2021-08-14;2582;4869;0;908864;784169;1;76.6;66.1;0.0
94;2021-08-15;558;917;0;909422;785086;1;76.7;66.2;0.0
94;2021-08-16;3188;6950;0;912610;792036;1;77.0;66.8;0.0
94;2021-08-17;3132;6909;0;915742;798945;1;77.2;67.4;0.0
94;2021-08-18;2948;6418;0;918690;805363;1;77.5;67.9;0.0
94;2021-08-19;2934;6428;0;921624;811791;1;77.7;68.5;0.0
94;2021-08-20;2791;6568;0;924415;818359;1;78.0;69.0;0.0
94;2021-08-21;2180;5553;0;926595;823912;1;78.1;69.5;0.0
94;2021-08-22;714;2355;0;927309;826267;1;78.2;69.7;0.0
94;2021-08-23;2558;7069;0;929867;833336;1;78.4;70.3;0.0
94;2021-08-24;2836;6975;0;932703;840311;1;78.7;70.9;0.0
94;2021-08-25;2470;6101;0;935173;846412;1;78.9;71.4;0.0
94;2021-08-26;2345;5936;0;937518;852348;1;79.1;71.9;0.0
94;2021-08-27;2393;6279;0;939911;858627;1;79.3;72.4;0.0
94;2021-08-28;2106;5720;0;942017;864347;1;79.4;72.9;0.0
94;2021-08-29;697;1901;0;942714;866248;1;79.5;73.0;0.0
94;2021-08-30;2432;6598;170;945146;872846;171;79.7;73.6;0.0
94;2021-08-31;2388;6443;262;947534;879289;433;79.9;74.1;0.0
94;2021-09-01;2494;4870;561;950028;884159;994;80.1;74.6;0.1
94;2021-09-02;1957;4121;597;951985;888280;1591;80.3;74.9;0.1
94;2021-09-03;1950;4601;623;953935;892881;2214;80.4;75.3;0.2
94;2021-09-04;2118;4530;283;956053;897411;2497;80.6;75.7;0.2
94;2021-09-05;618;1032;156;956671;898443;2653;80.7;75.8;0.2
94;2021-09-06;1437;2996;664;958108;901439;3317;80.8;76.0;0.3
94;2021-09-07;1270;2805;600;959378;904244;3917;80.9;76.3;0.3
94;2021-09-08;1460;2873;496;960838;907117;4413;81.0;76.5;0.4
94;2021-09-09;1168;2421;641;962006;909538;5054;81.1;76.7;0.4
94;2021-09-10;1591;3017;742;963597;912555;5796;81.3;77.0;0.5
94;2021-09-11;1569;3692;258;965166;916247;6054;81.4;77.3;0.5
94;2021-09-12;383;924;92;965549;917171;6146;81.4;77.3;0.5
94;2021-09-13;1193;2092;680;966742;919263;6826;81.5;77.5;0.6
94;2021-09-14;1256;2072;1033;967998;921335;7859;81.6;77.7;0.7
94;2021-09-15;1308;2714;931;969306;924049;8790;81.7;77.9;0.7
94;2021-09-16;994;1778;1102;970300;925827;9892;81.8;78.1;0.8
94;2021-09-17;1184;2293;888;971484;928120;10780;81.9;78.3;0.9
94;2021-09-18;1072;3185;332;972556;931305;11112;82.0;78.5;0.9
94;2021-09-19;264;744;164;972820;932049;11276;82.0;78.6;1.0
94;2021-09-20;812;1644;768;973632;933693;12044;82.1;78.7;1.0
94;2021-09-21;898;1621;954;974530;935314;12998;82.2;78.9;1.1
94;2021-09-22;912;2196;706;975442;937510;13704;82.3;79.1;1.2
94;2021-09-23;765;1453;851;976207;938963;14555;82.3;79.2;1.2
94;2021-09-24;978;1898;821;977185;940861;15376;82.4;79.3;1.3
94;2021-09-25;926;2795;370;978111;943656;15746;82.5;79.6;1.3
94;2021-09-26;231;619;93;978342;944275;15839;82.5;79.6;1.3
94;2021-09-27;633;1368;758;978975;945643;16597;82.6;79.7;1.4
94;2021-09-28;685;1273;872;979660;946916;17469;82.6;79.8;1.5
94;2021-09-29;804;1559;693;980464;948475;18162;82.7;80.0;1.5
94;2021-09-30;943;1135;1013;981407;949610;19175;82.8;80.1;1.6
94;2021-10-01;1310;1600;978;982717;951210;20153;82.9;80.2;1.7
94;2021-10-02;1019;2000;446;983736;953210;20599;83.0;80.4;1.7
94;2021-10-03;215;431;101;983951;953641;20700;83.0;80.4;1.7
94;2021-10-04;655;1035;979;984606;954676;21679;83.0;80.5;1.8
94;2021-10-05;663;1065;935;985269;955741;22614;83.1;80.6;1.9
94;2021-10-06;690;1221;1007;985959;956962;23621;83.1;80.7;2.0
94;2021-10-07;612;992;1282;986571;957954;24903;83.2;80.8;2.1
94;2021-10-08;959;1445;1346;987530;959399;26249;83.3;80.9;2.2
94;2021-10-09;823;1496;634;988353;960895;26883;83.3;81.0;2.3
94;2021-10-10;188;359;241;988541;961254;27124;83.4;81.1;2.3
94;2021-10-11;580;940;1185;989121;962194;28309;83.4;81.1;2.4
94;2021-10-12;632;1085;1345;989753;963279;29654;83.5;81.2;2.5
94;2021-10-13;736;1064;1180;990489;964343;30834;83.5;81.3;2.6
94;2021-10-14;636;1021;1530;991125;965364;32364;83.6;81.4;2.7
94;2021-10-15;866;1274;1622;991991;966638;33986;83.7;81.5;2.9
94;2021-10-16;809;1244;882;992800;967882;34868;83.7;81.6;2.9
94;2021-10-17;172;282;186;992972;968164;35054;83.7;81.6;3.0
94;2021-10-18;483;801;1531;993455;968965;36585;83.8;81.7;3.1
94;2021-10-19;343;706;1523;993798;969671;38108;83.8;81.8;3.2
94;2021-10-20;399;817;1663;994197;970488;39771;83.8;81.8;3.4
94;2021-10-21;342;782;1850;994539;971270;41621;83.9;81.9;3.5
94;2021-10-22;425;1104;1996;994964;972374;43617;83.9;82.0;3.7
94;2021-10-23;459;999;1240;995423;973373;44857;83.9;82.1;3.8
94;2021-10-24;95;184;294;995518;973557;45151;83.9;82.1;3.8
94;2021-10-25;313;550;1608;995831;974107;46759;84.0;82.1;3.9
94;2021-10-26;304;551;1806;996135;974658;48565;84.0;82.2;4.1
94;2021-10-27;307;625;1596;996442;975283;50161;84.0;82.2;4.2
94;2021-10-28;312;582;1936;996754;975865;52097;84.1;82.3;4.4
94;2021-10-29;315;683;1887;997069;976548;53984;84.1;82.3;4.6
94;2021-10-30;303;644;1159;997372;977192;55143;84.1;82.4;4.7
94;2021-10-31;65;150;255;997437;977342;55398;84.1;82.4;4.7
94;2021-11-01;76;85;66;997513;977427;55464;84.1;82.4;4.7
94;2021-11-02;299;678;1831;997812;978105;57295;84.1;82.5;4.8
94;2021-11-03;290;589;1766;998102;978694;59061;84.2;82.5;5.0
94;2021-11-04;295;577;2206;998397;979271;61267;84.2;82.6;5.2
94;2021-11-05;299;595;2185;998696;979866;63452;84.2;82.6;5.4
94;2021-11-06;309;652;1429;999005;980518;64881;84.2;82.7;5.5
94;2021-11-07;73;152;450;999078;980670;65331;84.2;82.7;5.5
94;2021-11-08;186;498;2058;999264;981168;67389;84.3;82.7;5.7
94;2021-11-09;249;588;2903;999513;981756;70292;84.3;82.8;5.9
94;2021-11-10;342;603;2998;999855;982359;73290;84.3;82.8;6.2
94;2021-11-11;25;89;211;999880;982448;73501;84.3;82.8;6.2
94;2021-11-12;326;630;3326;1000206;983078;76827;84.3;82.9;6.5
94;2021-11-13;328;553;1931;1000534;983631;78758;84.4;82.9;6.6
94;2021-11-14;59;125;380;1000593;983756;79138;84.4;83.0;6.7
94;2021-11-15;180;346;2627;1000773;984102;81765;84.4;83.0;6.9
94;2021-11-16;246;386;3397;1001019;984488;85162;84.4;83.0;7.2
94;2021-11-17;329;495;2918;1001348;984983;88080;84.4;83.1;7.4
94;2021-11-18;291;401;3443;1001639;985384;91523;84.5;83.1;7.7
94;2021-11-19;353;486;3808;1001992;985870;95331;84.5;83.1;8.0
94;2021-11-20;422;556;2267;1002414;986426;97598;84.5;83.2;8.2
94;2021-11-21;71;80;427;1002485;986506;98025;84.5;83.2;8.3
94;2021-11-22;208;319;2854;1002693;986825;100879;84.6;83.2;8.5
94;2021-11-23;248;328;3552;1002941;987153;104431;84.6;83.2;8.8
94;2021-11-24;349;424;3480;1003290;987577;107911;84.6;83.3;9.1
94;2021-11-25;287;356;4701;1003577;987933;112612;84.6;83.3;9.5
94;2021-11-26;344;443;6704;1003921;988376;119316;84.7;83.3;10.1
94;2021-11-27;320;428;5485;1004241;988804;124801;84.7;83.4;10.5
94;2021-11-28;64;89;1930;1004305;988893;126731;84.7;83.4;10.7
94;2021-11-29;153;275;6031;1004458;989168;132762;84.7;83.4;11.2
94;2021-11-30;246;368;9262;1004704;989536;142024;84.7;83.4;12.0
94;2021-12-01;250;431;9543;1004954;989967;151567;84.7;83.5;12.8
94;2021-12-02;217;260;10306;1005171;990227;161873;84.8;83.5;13.7
94;2021-12-03;227;418;11118;1005398;990645;172991;84.8;83.5;14.6
94;2021-12-04;212;418;8609;1005610;991063;181600;84.8;83.6;15.3
94;2021-12-05;69;102;2868;1005679;991165;184468;84.8;83.6;15.6
94;2021-12-06;174;337;9873;1005853;991502;194341;84.8;83.6;16.4
94;2021-12-07;247;392;12907;1006100;991894;207248;84.8;83.6;17.5
94;2021-12-08;246;392;11708;1006346;992286;218956;84.9;83.7;18.5
94;2021-12-09;265;380;13100;1006611;992666;232056;84.9;83.7;19.6
94;2021-12-10;249;479;13639;1006860;993145;245695;84.9;83.7;20.7
94;2021-12-11;252;458;10854;1007112;993603;256549;84.9;83.8;21.6
94;2021-12-12;93;123;5169;1007205;993726;261718;84.9;83.8;22.1
94;2021-12-13;198;327;11695;1007403;994053;273413;85.0;83.8;23.1
94;2021-12-14;256;398;14755;1007659;994451;288168;85.0;83.9;24.3
94;2021-12-15;316;503;13273;1007975;994954;301441;85.0;83.9;25.4
94;2021-12-16;300;451;14928;1008275;995405;316369;85.0;83.9;26.7
94;2021-12-17;312;487;15160;1008587;995892;331529;85.1;84.0;28.0
94;2021-12-18;296;446;11613;1008883;996338;343142;85.1;84.0;28.9
94;2021-12-19;156;136;6205;1009039;996474;349347;85.1;84.0;29.5
95;2020-12-27;8;0;0;8;0;0;0.0;0.0;0.0
95;2020-12-28;5;0;0;13;0;0;0.0;0.0;0.0
95;2020-12-29;2;0;0;15;0;0;0.0;0.0;0.0
95;2020-12-30;3;0;0;18;0;0;0.0;0.0;0.0
95;2020-12-31;5;0;0;23;0;0;0.0;0.0;0.0
95;2021-01-01;1;0;0;24;0;0;0.0;0.0;0.0
95;2021-01-02;14;0;0;38;0;0;0.0;0.0;0.0
95;2021-01-03;3;0;0;41;0;0;0.0;0.0;0.0
95;2021-01-04;62;0;0;103;0;0;0.0;0.0;0.0
95;2021-01-05;304;1;0;407;1;0;0.0;0.0;0.0
95;2021-01-06;207;1;0;614;2;0;0.1;0.0;0.0
95;2021-01-07;253;3;0;867;5;0;0.1;0.0;0.0
95;2021-01-08;433;3;0;1300;8;0;0.1;0.0;0.0
95;2021-01-09;279;0;0;1579;8;0;0.2;0.0;0.0
95;2021-01-10;334;2;0;1913;10;0;0.2;0.0;0.0
95;2021-01-11;577;13;0;2490;23;0;0.2;0.0;0.0
95;2021-01-12;846;6;0;3336;29;0;0.3;0.0;0.0
95;2021-01-13;862;16;0;4198;45;0;0.4;0.0;0.0
95;2021-01-14;891;15;0;5089;60;0;0.5;0.0;0.0
95;2021-01-15;870;16;0;5959;76;0;0.6;0.0;0.0
95;2021-01-16;303;4;0;6262;80;0;0.6;0.0;0.0
95;2021-01-17;138;1;0;6400;81;0;0.6;0.0;0.0
95;2021-01-18;1309;10;0;7709;91;0;0.8;0.0;0.0
95;2021-01-19;1542;15;0;9251;106;0;0.9;0.0;0.0
95;2021-01-20;1912;11;0;11163;117;0;1.1;0.0;0.0
95;2021-01-21;1859;10;0;13022;127;0;1.3;0.0;0.0
95;2021-01-22;1496;13;0;14518;140;0;1.4;0.0;0.0
95;2021-01-23;564;1;0;15082;141;0;1.5;0.0;0.0
95;2021-01-24;160;0;0;15242;141;0;1.5;0.0;0.0
95;2021-01-25;809;42;0;16051;183;0;1.6;0.0;0.0
95;2021-01-26;1017;152;0;17068;335;0;1.7;0.0;0.0
95;2021-01-27;1277;141;0;18345;476;0;1.8;0.0;0.0
95;2021-01-28;1574;65;0;19919;541;0;1.9;0.1;0.0
95;2021-01-29;1192;193;0;21111;734;0;2.1;0.1;0.0
95;2021-01-30;450;5;0;21561;739;0;2.1;0.1;0.0
95;2021-01-31;170;2;0;21731;741;0;2.1;0.1;0.0
95;2021-02-01;497;253;0;22228;994;0;2.2;0.1;0.0
95;2021-02-02;552;253;0;22780;1247;0;2.2;0.1;0.0
95;2021-02-03;597;461;0;23377;1708;0;2.3;0.2;0.0
95;2021-02-04;949;408;0;24326;2116;0;2.4;0.2;0.0
95;2021-02-05;656;370;0;24982;2486;0;2.4;0.2;0.0
95;2021-02-06;352;232;0;25334;2718;0;2.5;0.3;0.0
95;2021-02-07;126;311;0;25460;3029;0;2.5;0.3;0.0
95;2021-02-08;694;426;0;26154;3455;0;2.5;0.3;0.0
95;2021-02-09;1003;1039;0;27157;4494;0;2.6;0.4;0.0
95;2021-02-10;1143;1374;0;28300;5868;0;2.8;0.6;0.0
95;2021-02-11;1294;1269;0;29594;7137;0;2.9;0.7;0.0
95;2021-02-12;1007;1062;0;30601;8199;0;3.0;0.8;0.0
95;2021-02-13;332;328;0;30933;8527;0;3.0;0.8;0.0
95;2021-02-14;41;102;0;30974;8629;0;3.0;0.8;0.0
95;2021-02-15;365;1063;0;31339;9692;0;3.1;0.9;0.0
95;2021-02-16;502;1056;0;31841;10748;0;3.1;1.0;0.0
95;2021-02-17;589;1142;0;32430;11890;0;3.2;1.2;0.0
95;2021-02-18;728;1659;0;33158;13549;0;3.2;1.3;0.0
95;2021-02-19;770;1331;0;33928;14880;0;3.3;1.4;0.0
95;2021-02-20;287;497;0;34215;15377;0;3.3;1.5;0.0
95;2021-02-21;116;238;0;34331;15615;0;3.3;1.5;0.0
95;2021-02-22;312;944;0;34643;16559;0;3.4;1.6;0.0
95;2021-02-23;355;790;0;34998;17349;0;3.4;1.7;0.0
95;2021-02-24;358;887;0;35356;18236;0;3.4;1.8;0.0
95;2021-02-25;724;1152;0;36080;19388;0;3.5;1.9;0.0
95;2021-02-26;1080;887;0;37160;20275;0;3.6;2.0;0.0
95;2021-02-27;384;412;0;37544;20687;0;3.7;2.0;0.0
95;2021-02-28;51;171;0;37595;20858;0;3.7;2.0;0.0
95;2021-03-01;782;544;0;38377;21402;0;3.7;2.1;0.0
95;2021-03-02;1333;842;0;39710;22244;0;3.9;2.2;0.0
95;2021-03-03;1571;916;0;41281;23160;0;4.0;2.3;0.0
95;2021-03-04;3063;1180;0;44344;24340;0;4.3;2.4;0.0
95;2021-03-05;3465;1062;0;47809;25402;0;4.7;2.5;0.0
95;2021-03-06;3743;489;0;51552;25891;0;5.0;2.5;0.0
95;2021-03-07;3658;328;0;55210;26219;0;5.4;2.6;0.0
95;2021-03-08;1442;805;0;56652;27024;0;5.5;2.6;0.0
95;2021-03-09;2525;538;0;59177;27562;0;5.8;2.7;0.0
95;2021-03-10;2502;858;0;61679;28420;0;6.0;2.8;0.0
95;2021-03-11;3209;1139;0;64888;29559;0;6.3;2.9;0.0
95;2021-03-12;3688;877;0;68576;30436;0;6.7;3.0;0.0
95;2021-03-13;3411;431;0;71987;30867;0;7.0;3.0;0.0
95;2021-03-14;1616;241;0;73603;31108;0;7.2;3.0;0.0
95;2021-03-15;2281;355;0;75884;31463;0;7.4;3.1;0.0
95;2021-03-16;1657;413;0;77541;31876;0;7.5;3.1;0.0
95;2021-03-17;2078;411;0;79619;32287;0;7.7;3.1;0.0
95;2021-03-18;2591;398;0;82210;32685;0;8.0;3.2;0.0
95;2021-03-19;3393;374;0;85603;33059;0;8.3;3.2;0.0
95;2021-03-20;2657;213;0;88260;33272;0;8.6;3.2;0.0
95;2021-03-21;948;212;0;89208;33484;0;8.7;3.3;0.0
95;2021-03-22;2821;326;0;92029;33810;0;9.0;3.3;0.0
95;2021-03-23;3524;459;0;95553;34269;0;9.3;3.3;0.0
95;2021-03-24;3620;494;0;99173;34763;0;9.7;3.4;0.0
95;2021-03-25;5559;651;0;104732;35414;0;10.2;3.4;0.0
95;2021-03-26;5425;673;0;110157;36087;0;10.7;3.5;0.0
95;2021-03-27;3329;219;0;113486;36306;0;11.0;3.5;0.0
95;2021-03-28;1052;72;0;114538;36378;0;11.1;3.5;0.0
95;2021-03-29;2806;587;0;117344;36965;0;11.4;3.6;0.0
95;2021-03-30;3921;1192;0;121265;38157;0;11.8;3.7;0.0
95;2021-03-31;3806;1575;0;125071;39732;0;12.2;3.9;0.0
95;2021-04-01;4910;2202;0;129981;41934;0;12.7;4.1;0.0
95;2021-04-02;3643;2587;0;133624;44521;0;13.0;4.3;0.0
95;2021-04-03;2104;2269;0;135728;46790;0;13.2;4.6;0.0
95;2021-04-04;885;950;0;136613;47740;0;13.3;4.6;0.0
95;2021-04-05;696;88;0;137309;47828;0;13.4;4.7;0.0
95;2021-04-06;2310;1464;0;139619;49292;0;13.6;4.8;0.0
95;2021-04-07;4448;1983;0;144067;51275;0;14.0;5.0;0.0
95;2021-04-08;4968;2274;0;149035;53549;0;14.5;5.2;0.0
95;2021-04-09;5763;2194;0;154798;55743;0;15.1;5.4;0.0
95;2021-04-10;3697;1413;0;158495;57156;0;15.4;5.6;0.0
95;2021-04-11;1137;800;0;159632;57956;0;15.5;5.6;0.0
95;2021-04-12;3084;1610;0;162716;59566;0;15.8;5.8;0.0
95;2021-04-13;3371;1865;0;166087;61431;0;16.2;6.0;0.0
95;2021-04-14;3175;2008;0;169262;63439;0;16.5;6.2;0.0
95;2021-04-15;4142;2948;0;173404;66387;0;16.9;6.5;0.0
95;2021-04-16;4340;2826;0;177744;69213;0;17.3;6.7;0.0
95;2021-04-17;2489;1786;0;180233;70999;0;17.5;6.9;0.0
95;2021-04-18;1056;745;0;181289;71744;0;17.6;7.0;0.0
95;2021-04-19;2543;2194;0;183832;73938;0;17.9;7.2;0.0
95;2021-04-20;2512;2398;0;186344;76336;0;18.1;7.4;0.0
95;2021-04-21;3971;2523;0;190315;78859;0;18.5;7.7;0.0
95;2021-04-22;3556;4071;0;193871;82930;0;18.9;8.1;0.0
95;2021-04-23;3274;3383;0;197145;86313;0;19.2;8.4;0.0
95;2021-04-24;3621;2371;0;200766;88684;0;19.5;8.6;0.0
95;2021-04-25;1860;1034;0;202626;89718;0;19.7;8.7;0.0
95;2021-04-26;3037;2489;0;205663;92207;0;20.0;9.0;0.0
95;2021-04-27;4178;2333;0;209841;94540;0;20.4;9.2;0.0
95;2021-04-28;4212;2826;0;214053;97366;0;20.8;9.5;0.0
95;2021-04-29;6087;4108;0;220140;101474;0;21.4;9.9;0.0
95;2021-04-30;6633;3066;0;226773;104540;0;22.1;10.2;0.0
95;2021-05-01;2465;894;0;229238;105434;0;22.3;10.3;0.0
95;2021-05-02;1939;948;0;231177;106382;0;22.5;10.4;0.0
95;2021-05-03;4885;2707;0;236062;109089;0;23.0;10.6;0.0
95;2021-05-04;5966;2986;0;242028;112075;0;23.6;10.9;0.0
95;2021-05-05;5213;3756;0;247241;115831;0;24.1;11.3;0.0
95;2021-05-06;7208;4528;0;254449;120359;0;24.8;11.7;0.0
95;2021-05-07;5619;4662;0;260068;125021;0;25.3;12.2;0.0
95;2021-05-08;4997;1726;0;265065;126747;0;25.8;12.3;0.0
95;2021-05-09;2578;1415;0;267643;128162;0;26.0;12.5;0.0
95;2021-05-10;8022;3048;0;275665;131210;0;26.8;12.8;0.0
95;2021-05-11;7463;3558;0;283128;134768;0;27.6;13.1;0.0
95;2021-05-12;8290;3249;0;291418;138017;0;28.4;13.4;0.0
95;2021-05-13;6411;1153;0;297829;139170;0;29.0;13.5;0.0
95;2021-05-14;6631;2060;0;304460;141230;0;29.6;13.7;0.0
95;2021-05-15;4654;1243;0;309114;142473;0;30.1;13.9;0.0
95;2021-05-16;3900;743;0;313014;143216;0;30.5;13.9;0.0
95;2021-05-17;6265;1380;0;319279;144596;0;31.1;14.1;0.0
95;2021-05-18;8070;1777;0;327349;146373;0;31.9;14.2;0.0
95;2021-05-19;8312;2659;0;335661;149032;0;32.7;14.5;0.0
95;2021-05-20;10184;2474;0;345845;151506;0;33.7;14.7;0.0
95;2021-05-21;9038;2512;0;354883;154018;0;34.5;15.0;0.0
95;2021-05-22;7832;1513;0;362715;155531;0;35.3;15.1;0.0
95;2021-05-23;3563;868;0;366278;156399;0;35.6;15.2;0.0
95;2021-05-24;2977;604;0;369255;157003;0;35.9;15.3;0.0
95;2021-05-25;6730;2339;0;375985;159342;0;36.6;15.5;0.0
95;2021-05-26;7789;3049;0;383774;162391;0;37.4;15.8;0.0
95;2021-05-27;8831;4361;0;392605;166752;0;38.2;16.2;0.0
95;2021-05-28;6967;4527;0;399572;171279;0;38.9;16.7;0.0
95;2021-05-29;4943;2895;0;404515;174174;0;39.4;17.0;0.0
95;2021-05-30;2944;1296;0;407459;175470;0;39.7;17.1;0.0
95;2021-05-31;5229;3365;0;412688;178835;0;40.2;17.4;0.0
95;2021-06-01;7417;4113;0;420105;182948;0;40.9;17.8;0.0
95;2021-06-02;7387;4479;0;427492;187427;0;41.6;18.2;0.0
95;2021-06-03;7286;6029;0;434778;193456;0;42.3;18.8;0.0
95;2021-06-04;7657;4759;0;442435;198215;0;43.1;19.3;0.0
95;2021-06-05;6570;3893;0;449005;202108;0;43.7;19.7;0.0
95;2021-06-06;3242;1412;0;452247;203520;0;44.0;19.8;0.0
95;2021-06-07;5105;4636;0;457352;208156;0;44.5;20.3;0.0
95;2021-06-08;5888;5523;0;463240;213679;0;45.1;20.8;0.0
95;2021-06-09;5830;6267;0;469070;219946;0;45.7;21.4;0.0
95;2021-06-10;5992;7247;0;475062;227193;0;46.2;22.1;0.0
95;2021-06-11;6129;6427;0;481191;233620;0;46.8;22.7;0.0
95;2021-06-12;5201;4201;0;486392;237821;0;47.3;23.1;0.0
95;2021-06-13;1826;2764;0;488218;240585;0;47.5;23.4;0.0
95;2021-06-14;4018;5852;0;492236;246437;0;47.9;24.0;0.0
95;2021-06-15;4233;7675;0;496469;254112;0;48.3;24.7;0.0
95;2021-06-16;4982;7250;0;501451;261362;0;48.8;25.4;0.0
95;2021-06-17;5717;7695;0;507168;269057;0;49.4;26.2;0.0
95;2021-06-18;5152;7724;0;512320;276781;0;49.9;26.9;0.0
95;2021-06-19;4333;7757;0;516653;284538;0;50.3;27.7;0.0
95;2021-06-20;1238;2985;0;517891;287523;0;50.4;28.0;0.0
95;2021-06-21;2964;7067;0;520855;294590;0;50.7;28.7;0.0
95;2021-06-22;4209;8443;0;525064;303033;0;51.1;29.5;0.0
95;2021-06-23;4136;9897;0;529200;312930;0;51.5;30.5;0.0
95;2021-06-24;4273;9445;0;533473;322375;0;51.9;31.4;0.0
95;2021-06-25;4291;9676;0;537764;332051;0;52.3;32.3;0.0
95;2021-06-26;3625;7830;0;541389;339881;0;52.7;33.1;0.0
95;2021-06-27;835;3434;0;542224;343315;0;52.8;33.4;0.0
95;2021-06-28;2407;8096;0;544631;351411;0;53.0;34.2;0.0
95;2021-06-29;2462;8122;0;547093;359533;0;53.2;35.0;0.0
95;2021-06-30;3652;9391;0;550745;368924;0;53.6;35.9;0.0
95;2021-07-01;4296;9987;0;555041;378911;0;54.0;36.9;0.0
95;2021-07-02;4212;9655;0;559253;388566;0;54.4;37.8;0.0
95;2021-07-03;3305;8290;0;562558;396856;0;54.8;38.6;0.0
95;2021-07-04;1045;3068;0;563603;399924;0;54.9;38.9;0.0
95;2021-07-05;2700;4945;0;566303;404869;0;55.1;39.4;0.0
95;2021-07-06;2939;7574;0;569242;412443;0;55.4;40.1;0.0
95;2021-07-07;3993;9015;0;573235;421458;0;55.8;41.0;0.0
95;2021-07-08;4806;9209;0;578041;430667;0;56.3;41.9;0.0
95;2021-07-09;4707;9649;0;582748;440316;0;56.7;42.9;0.0
95;2021-07-10;3458;7000;0;586206;447316;0;57.1;43.5;0.0
95;2021-07-11;1302;2949;0;587508;450265;0;57.2;43.8;0.0
95;2021-07-12;3241;8632;0;590749;458897;0;57.5;44.7;0.0
95;2021-07-13;6031;9777;0;596780;468674;0;58.1;45.6;0.0
95;2021-07-14;4983;5345;0;601763;474019;0;58.6;46.1;0.0
95;2021-07-15;7667;11319;0;609430;485338;0;59.3;47.2;0.0
95;2021-07-16;8559;11130;0;617989;496468;0;60.1;48.3;0.0
95;2021-07-17;5537;7463;0;623526;503931;0;60.7;49.0;0.0
95;2021-07-18;3305;2590;0;626831;506521;0;61.0;49.3;0.0
95;2021-07-19;5444;6553;0;632275;513074;0;61.5;49.9;0.0
95;2021-07-20;7047;8095;0;639322;521169;0;62.2;50.7;0.0
95;2021-07-21;9205;8876;0;648527;530045;0;63.1;51.6;0.0
95;2021-07-22;10001;9186;0;658528;539231;0;64.1;52.5;0.0
95;2021-07-23;10514;9642;0;669042;548873;0;65.1;53.4;0.0
95;2021-07-24;5626;6220;0;674668;555093;0;65.7;54.0;0.0
95;2021-07-25;2593;2250;0;677261;557343;0;65.9;54.2;0.0
95;2021-07-26;5477;4751;0;682738;562094;0;66.5;54.7;0.0
95;2021-07-27;8617;6948;0;691355;569042;0;67.3;55.4;0.0
95;2021-07-28;9484;7279;0;700839;576321;0;68.2;56.1;0.0
95;2021-07-29;8536;5845;0;709375;582166;0;69.0;56.7;0.0
95;2021-07-30;8491;7155;0;717866;589321;0;69.9;57.4;0.0
95;2021-07-31;4511;3684;0;722377;593005;0;70.3;57.7;0.0
95;2021-08-01;2023;1316;0;724400;594321;0;70.5;57.8;0.0
95;2021-08-02;4835;3955;0;729235;598276;0;71.0;58.2;0.0
95;2021-08-03;5848;5410;0;735083;603686;0;71.5;58.8;0.0
95;2021-08-04;5950;5501;0;741033;609187;0;72.1;59.3;0.0
95;2021-08-05;5856;5155;0;746889;614342;0;72.7;59.8;0.0
95;2021-08-06;5837;6435;0;752726;620777;0;73.3;60.4;0.0
95;2021-08-07;2780;3388;0;755506;624165;0;73.5;60.8;0.0
95;2021-08-08;1179;1894;0;756685;626059;0;73.6;60.9;0.0
95;2021-08-09;4027;4973;0;760712;631032;0;74.0;61.4;0.0
95;2021-08-10;4882;5581;0;765594;636613;0;74.5;62.0;0.0
95;2021-08-11;4633;6138;0;770227;642751;0;75.0;62.6;0.0
95;2021-08-12;4440;6359;0;774667;649110;0;75.4;63.2;0.0
95;2021-08-13;3538;5242;0;778205;654352;0;75.7;63.7;0.0
95;2021-08-14;3065;3740;0;781270;658092;0;76.0;64.1;0.0
95;2021-08-15;409;569;0;781679;658661;0;76.1;64.1;0.0
95;2021-08-16;2752;6037;0;784431;664698;0;76.3;64.7;0.0
95;2021-08-17;3229;6889;0;787660;671587;0;76.7;65.4;0.0
95;2021-08-18;3640;7523;0;791300;679110;0;77.0;66.1;0.0
95;2021-08-19;3119;6272;0;794419;685382;0;77.3;66.7;0.0
95;2021-08-20;3234;7312;0;797653;692694;0;77.6;67.4;0.0
95;2021-08-21;2297;4237;0;799950;696931;0;77.9;67.8;0.0
95;2021-08-22;607;1878;0;800557;698809;0;77.9;68.0;0.0
95;2021-08-23;2320;5969;0;802877;704778;0;78.1;68.6;0.0
95;2021-08-24;2607;6334;0;805484;711112;0;78.4;69.2;0.0
95;2021-08-25;3285;7470;1;808769;718582;1;78.7;69.9;0.0
95;2021-08-26;2621;6597;0;811390;725179;1;79.0;70.6;0.0
95;2021-08-27;2964;7597;0;814354;732776;1;79.3;71.3;0.0
95;2021-08-28;2405;5008;0;816759;737784;1;79.5;71.8;0.0
95;2021-08-29;533;1378;0;817292;739162;1;79.5;71.9;0.0
95;2021-08-30;2422;5699;83;819714;744861;84;79.8;72.5;0.0
95;2021-08-31;2393;5711;207;822107;750572;291;80.0;73.1;0.0
95;2021-09-01;2846;5295;444;824953;755867;735;80.3;73.6;0.1
95;2021-09-02;1886;3915;416;826839;759782;1151;80.5;73.9;0.1
95;2021-09-03;2140;4804;473;828979;764586;1624;80.7;74.4;0.2
95;2021-09-04;2246;4736;218;831225;769322;1842;80.9;74.9;0.2
95;2021-09-05;427;700;24;831652;770022;1866;80.9;74.9;0.2
95;2021-09-06;1268;2895;408;832920;772917;2274;81.1;75.2;0.2
95;2021-09-07;1372;2895;342;834292;775812;2616;81.2;75.5;0.3
95;2021-09-08;1590;3366;363;835882;779178;2979;81.4;75.8;0.3
95;2021-09-09;1198;2794;448;837080;781972;3427;81.5;76.1;0.3
95;2021-09-10;1597;3078;499;838677;785050;3926;81.6;76.4;0.4
95;2021-09-11;1420;3230;246;840097;788280;4172;81.8;76.7;0.4
95;2021-09-12;285;550;105;840382;788830;4277;81.8;76.8;0.4
95;2021-09-13;1178;2184;442;841560;791014;4719;81.9;77.0;0.5
95;2021-09-14;1197;2137;610;842757;793151;5329;82.0;77.2;0.5
95;2021-09-15;1396;3249;771;844153;796400;6100;82.2;77.5;0.6
95;2021-09-16;882;1718;599;845035;798118;6699;82.2;77.7;0.7
95;2021-09-17;1193;2711;672;846228;800829;7371;82.4;77.9;0.7
95;2021-09-18;1186;3618;242;847414;804447;7613;82.5;78.3;0.7
95;2021-09-19;231;542;48;847645;804989;7661;82.5;78.3;0.7
95;2021-09-20;697;1398;589;848342;806387;8250;82.6;78.5;0.8
95;2021-09-21;776;1622;942;849118;808009;9192;82.6;78.6;0.9
95;2021-09-22;934;2739;625;850052;810748;9817;82.7;78.9;1.0
95;2021-09-23;769;1223;688;850821;811971;10505;82.8;79.0;1.0
95;2021-09-24;793;2003;702;851614;813974;11207;82.9;79.2;1.1
95;2021-09-25;1004;3230;337;852618;817204;11544;83.0;79.5;1.1
95;2021-09-26;115;310;31;852733;817514;11575;83.0;79.6;1.1
95;2021-09-27;616;1159;503;853349;818673;12078;83.1;79.7;1.2
95;2021-09-28;680;1271;841;854029;819944;12919;83.1;79.8;1.3
95;2021-09-29;806;1762;665;854835;821706;13584;83.2;80.0;1.3
95;2021-09-30;792;1121;841;855627;822827;14425;83.3;80.1;1.4
95;2021-10-01;1265;1390;843;856892;824217;15268;83.4;80.2;1.5
95;2021-10-02;1266;2106;573;858158;826323;15841;83.5;80.4;1.5
95;2021-10-03;140;244;30;858298;826567;15871;83.5;80.4;1.5
95;2021-10-04;612;886;506;858910;827453;16377;83.6;80.5;1.6
95;2021-10-05;726;1070;880;859636;828523;17257;83.7;80.6;1.7
95;2021-10-06;780;1276;930;860416;829799;18187;83.7;80.8;1.8
95;2021-10-07;541;860;836;860957;830659;19023;83.8;80.8;1.9
95;2021-10-08;880;1347;1170;861837;832006;20193;83.9;81.0;2.0
95;2021-10-09;921;1576;671;862758;833582;20864;84.0;81.1;2.0
95;2021-10-10;151;236;47;862909;833818;20911;84.0;81.2;2.0
95;2021-10-11;481;677;707;863390;834495;21618;84.0;81.2;2.1
95;2021-10-12;534;893;984;863924;835388;22602;84.1;81.3;2.2
95;2021-10-13;793;1131;1102;864717;836519;23704;84.2;81.4;2.3
95;2021-10-14;554;1058;1052;865271;837577;24756;84.2;81.5;2.4
95;2021-10-15;911;1066;1328;866182;838643;26084;84.3;81.6;2.5
95;2021-10-16;838;1237;875;867020;839880;26959;84.4;81.7;2.6
95;2021-10-17;100;198;123;867120;840078;27082;84.4;81.8;2.6
95;2021-10-18;435;623;519;867555;840701;27601;84.4;81.8;2.7
95;2021-10-19;528;811;1225;868083;841512;28826;84.5;81.9;2.8
95;2021-10-20;510;824;1202;868593;842336;30028;84.5;82.0;2.9
95;2021-10-21;374;663;1235;868967;842999;31263;84.6;82.0;3.0
95;2021-10-22;573;1083;1383;869540;844082;32646;84.6;82.2;3.2
95;2021-10-23;617;1103;998;870157;845185;33644;84.7;82.3;3.3
95;2021-10-24;84;148;89;870241;845333;33733;84.7;82.3;3.3
95;2021-10-25;324;489;614;870565;845822;34347;84.7;82.3;3.3
95;2021-10-26;459;642;1310;871024;846464;35657;84.8;82.4;3.5
95;2021-10-27;464;733;1555;871488;847197;37212;84.8;82.5;3.6
95;2021-10-28;405;707;1527;871893;847904;38739;84.9;82.5;3.8
95;2021-10-29;499;758;1518;872392;848662;40257;84.9;82.6;3.9
95;2021-10-30;444;786;1038;872836;849448;41295;85.0;82.7;4.0
95;2021-10-31;87;154;56;872923;849602;41351;85.0;82.7;4.0
95;2021-11-01;163;146;127;873086;849748;41478;85.0;82.7;4.0
95;2021-11-02;453;671;1172;873539;850419;42650;85.0;82.8;4.2
95;2021-11-03;424;670;1341;873963;851089;43991;85.1;82.8;4.3
95;2021-11-04;352;567;1466;874315;851656;45457;85.1;82.9;4.4
95;2021-11-05;418;725;1612;874733;852381;47069;85.1;83.0;4.6
95;2021-11-06;447;838;1167;875180;853219;48236;85.2;83.0;4.7
95;2021-11-07;70;158;115;875250;853377;48351;85.2;83.1;4.7
95;2021-11-08;214;417;1045;875464;853794;49396;85.2;83.1;4.8
95;2021-11-09;385;666;2279;875849;854460;51675;85.2;83.2;5.0
95;2021-11-10;427;703;2695;876276;855163;54370;85.3;83.2;5.3
95;2021-11-11;148;185;684;876424;855348;55054;85.3;83.3;5.4
95;2021-11-12;477;834;3017;876901;856182;58071;85.3;83.3;5.7
95;2021-11-13;427;728;1480;877328;856910;59551;85.4;83.4;5.8
95;2021-11-14;99;132;158;877427;857042;59709;85.4;83.4;5.8
95;2021-11-15;234;398;1445;877661;857440;61154;85.4;83.5;6.0
95;2021-11-16;395;600;2942;878056;858040;64096;85.5;83.5;6.2
95;2021-11-17;391;610;2655;878447;858650;66751;85.5;83.6;6.5
95;2021-11-18;339;503;2608;878786;859153;69359;85.5;83.6;6.8
95;2021-11-19;496;743;3470;879282;859896;72829;85.6;83.7;7.1
95;2021-11-20;495;709;1608;879777;860605;74437;85.6;83.8;7.2
95;2021-11-21;70;193;331;879847;860798;74768;85.6;83.8;7.3
95;2021-11-22;249;387;1809;880096;861185;76577;85.7;83.8;7.5
95;2021-11-23;399;514;3205;880495;861699;79782;85.7;83.9;7.8
95;2021-11-24;440;624;2996;880935;862323;82778;85.7;83.9;8.1
95;2021-11-25;401;480;3485;881336;862803;86263;85.8;84.0;8.4
95;2021-11-26;451;617;5952;881787;863420;92215;85.8;84.0;9.0
95;2021-11-27;397;601;4713;882184;864021;96928;85.9;84.1;9.4
95;2021-11-28;146;170;1266;882330;864191;98194;85.9;84.1;9.6
95;2021-11-29;186;311;3826;882516;864502;102020;85.9;84.1;9.9
95;2021-11-30;283;515;7851;882799;865017;109871;85.9;84.2;10.7
95;2021-12-01;361;556;8606;883160;865573;118477;86.0;84.2;11.5
95;2021-12-02;292;418;10243;883452;865991;128720;86.0;84.3;12.5
95;2021-12-03;404;593;11105;883856;866584;139825;86.0;84.3;13.6
95;2021-12-04;323;550;7728;884179;867134;147553;86.1;84.4;14.4
95;2021-12-05;111;205;3177;884290;867339;150730;86.1;84.4;14.7
95;2021-12-06;180;380;5946;884470;867719;156676;86.1;84.5;15.2
95;2021-12-07;302;511;10910;884772;868230;167586;86.1;84.5;16.3
95;2021-12-08;389;569;10375;885161;868799;177961;86.2;84.6;17.3
95;2021-12-09;328;497;11855;885489;869296;189816;86.2;84.6;18.5
95;2021-12-10;402;590;14374;885891;869886;204190;86.2;84.7;19.9
95;2021-12-11;305;561;9638;886196;870447;213828;86.3;84.7;20.8
95;2021-12-12;174;195;4680;886370;870642;218508;86.3;84.7;21.3
95;2021-12-13;261;441;8018;886631;871083;226526;86.3;84.8;22.0
95;2021-12-14;375;564;12331;887006;871647;238857;86.3;84.8;23.2
95;2021-12-15;397;570;11259;887403;872217;250116;86.4;84.9;24.3
95;2021-12-16;360;511;12762;887763;872728;262878;86.4;84.9;25.6
95;2021-12-17;453;567;14070;888216;873295;276948;86.5;85.0;27.0
95;2021-12-18;376;506;9939;888592;873801;286887;86.5;85.0;27.9
95;2021-12-19;269;270;5118;888861;874071;292005;86.5;85.1;28.4
